IPEDS Unique ID,Institution,Alias,Address,City,State,ZIP code,Longitude,Latitude,Control,Offers graduate program,HBCU,Locale,Carnegie Classification 2021: Basic,Carnegie Classification 2021: Graduate Instructional Program,Carnegie Classification 2021: Enrollment Profile,Carnegie Classification 2021: Size and Setting,Grand total,Grand total men,Grand total women,Nonresident alien total,Nonresident alien men,Nonresident alien women,Total enrolled graduate students,Exclusively distance education,Some distance education,No distance education,Grand total (MS),Grand total men (MS),Grand total women (MS),Nonresident alien total (MS),Nonresident alien men (MS),Nonresident alien women (MS),Grand total (DR),Grand total men (DR),Grand total women (DR),Nonresident alien total (DR),Nonresident alien men (DR),Nonresident alien women (DR),Congressional District (118th)
100654,Alabama A & M University,AAMU,4900 Meridian Street,Normal,AL,35762,-86.568502,34.783368,Public,Graduate degree or certificate offering,Yes,City: Midsize,Master's Colleges & Universities: Larger Programs,Research Doctoral: Professional-dominant,High undergraduate,"Four-year, medium, highly residential",1099,345,754,50,24,26,1099,525,487,87,251,71,180,8,4,4,7,2,5,4,1,3,AL05
100663,University of Alabama at Birmingham,UAB,Administration Bldg Suite 1070,Birmingham,AL,35294-0110,-86.799345,33.505697,Public,Graduate degree or certificate offering,No,City: Midsize,Doctoral Universities: Very High Research Activity,"Research Doctoral: Comprehensive programs, with medical/veterinary school",Majority undergraduate,"Four-year, large, primarily nonresidential",10652,3631,7021,826,477,349,10652,4262,2054,4336,2433,794,1639,239,132,107,149,70,79,25,14,11,AL07
100690,Amridge University,Southern Christian University  Regions University,1200 Taylor Rd,Montgomery,AL,36117-3553,-86.17401,32.362609,Private not-for-profit,Graduate degree or certificate offering,No,City: Midsize,Master's Colleges & Universities: Small Programs,Research Doctoral: Professional-dominant,Majority graduate,"Four-year, very small, primarily nonresidential",714,327,387,0,0,0,714,714,0,0,107,46,61,0,0,0,12,8,4,0,0,0,AL02
100706,University of Alabama in Huntsville,UAH  University of Alabama Huntsville,301 Sparkman Dr,Huntsville,AL,35899,-86.640449,34.724557,Public,Graduate degree or certificate offering,No,City: Midsize,Doctoral Universities: Very High Research Activity,Research Doctoral: STEM-dominant,High undergraduate,"Four-year, medium, primarily residential",2432,1135,1297,201,134,67,2432,1347,838,247,516,224,292,41,25,16,40,28,12,22,16,6,AL05
100724,Alabama State University, ,915 S Jackson Street,Montgomery,AL,36104-0271,-86.295677,32.364317,Public,Graduate degree or certificate offering,Yes,City: Midsize,Doctoral/Professional Universities,Research Doctoral: Professional-dominant,Very high undergraduate,"Four-year, medium, highly residential",564,182,382,8,6,2,564,322,201,41,105,28,77,0,0,0,14,7,7,1,1,0,AL07
100751,The University of Alabama, ,739 University Blvd,Tuscaloosa,AL,35487-0100,-87.545978,33.211875,Public,Graduate degree or certificate offering,No,City: Small,Doctoral Universities: Very High Research Activity,"Research Doctoral: Comprehensive programs, no medical/veterinary school",High undergraduate,"Four-year, large, primarily residential",7381,2731,4650,701,424,277,7381,3158,2738,1485,1859,694,1165,74,36,38,203,104,99,62,39,23,AL07
100812,Athens State University, ,300 N Beaty St,Athens,AL,35611,-86.964698,34.806793,Public,Graduate degree or certificate offering,No,Town: Fringe,Baccalaureate Colleges: Diverse Fields,"Postbaccalaureate: Education-dominant, with Arts & Sciences",Very high undergraduate,"Four-year, small, primarily nonresidential",271,113,158,0,0,0,271,270,0,1,78,32,46,0,0,0,0,0,0,0,0,0,AL05
100830,Auburn University at Montgomery,AUM||Auburn University at Montgomery|Auburn Montgomery,7440 East Drive,Montgomery,AL,36117-3596,-86.177544,32.36736,Public,Graduate degree or certificate offering,No,City: Midsize,Master's Colleges & Universities: Larger Programs,Postbaccalaureate: Comprehensive programs,High undergraduate,"Four-year, medium, primarily residential",1087,405,682,149,108,41,1087,476,444,167,277,108,169,63,42,21,0,0,0,0,0,0,AL02
100858,Auburn University, , ,Auburn,AL,36849,-85.488258,32.599378,Public,Graduate degree or certificate offering,No,City: Small,Doctoral Universities: Very High Research Activity,"Research Doctoral: Comprehensive programs, with medical/veterinary school",High undergraduate,"Four-year, large, primarily nonresidential",7118,3291,3827,1263,751,512,7118,2051,542,4525,1295,636,659,237,134,103,251,133,118,98,68,30,AL03
101116,South University-Montgomery, ,5355 Vaughn Rd,Montgomery,AL,36116,-86.216488,32.342684,Private for-profit,Graduate degree or certificate offering,No,City: Midsize,Baccalaureate Colleges: Diverse Fields,"Postbaccalaureate: Business-dominant, with Arts & Sciences",High undergraduate,"Four-year, very small, primarily nonresidential",92,27,65,0,0,0,92,66,15,11,25,7,18,0,0,0,0,0,0,0,0,0,AL02
101189,Faulkner University,Faulkner,5345 Atlanta Hwy,Montgomery,AL,36109-3390,-86.21641,32.384181,Private not-for-profit,Graduate degree or certificate offering,No,City: Midsize,Master's Colleges & Universities: Larger Programs,Research Doctoral: Humanities/social sciences-dominant,Majority undergraduate,"Four-year, small, primarily residential",1126,444,682,1,1,0,1126,826,112,188,433,134,299,0,0,0,0,0,0,0,0,0,AL02
101365,Herzing University-Birmingham, ,280 West Valley Ave,Birmingham,AL,35209,-86.832465,33.468466,Private not-for-profit,Graduate degree or certificate offering,No,Suburb: Large,Special Focus Four-Year: Other Health Professions Schools,Postbaccalaureate: Single program-Business,Very high undergraduate,"Four-year, very small, primarily nonresidential",19,4,15,0,0,0,19,19,0,0,7,2,5,0,0,0,0,0,0,0,0,0,AL07
101435,Huntingdon College, ,1500 East Fairview Avenue,Montgomery,AL,36106-2148,-86.284366,32.351034,Private not-for-profit,Graduate degree or certificate offering,No,City: Midsize,Baccalaureate Colleges: Diverse Fields,Not classified (Exclusively Undergraduate),Exclusively undergraduate four-year,"Four-year, very small, highly residential",4,1,3,0,0,0,4,0,0,4,0,0,0,0,0,0,0,0,0,0,0,0,AL02
101453,Heritage Christian University, ,3625 Helton Dr,Florence,AL,35630-9977,-87.663051,34.856153,Private not-for-profit,Graduate degree or certificate offering,No,City: Small,Special Focus Four-Year: Faith-Related Institutions,Postbaccalaureate: Single program-Other,Majority undergraduate,"Four-year, very small, primarily nonresidential",51,48,3,1,1,0,51,46,3,2,2,1,1,0,0,0,0,0,0,0,0,0,AL05
101480,Jacksonville State University, ,700 Pelham Road North,Jacksonville,AL,36265,-85.765321,33.822938,Public,Graduate degree or certificate offering,No,Suburb: Small,Master's Colleges & Universities: Larger Programs,Postbaccalaureate: Comprehensive programs,High undergraduate,"Four-year, medium, primarily residential",1848,632,1216,36,18,18,1848,1269,517,62,456,153,303,16,5,11,0,0,0,0,0,0,AL03
101587,University of West Alabama,UWA,Station One,Livingston,AL,35470,-88.186329,32.588132,Public,Graduate degree or certificate offering,No,Rural: Remote,Master's Colleges & Universities: Larger Programs,Postbaccalaureate: Comprehensive programs,Majority graduate,"Four-year, medium, primarily residential",5811,1144,4667,40,18,22,5811,5673,129,9,1181,210,971,4,2,2,17,6,11,0,0,0,AL07
101693,University of Mobile,University of Mobile,5735 College Parkway,Mobile,AL,36613-2842,-88.128934,30.793247,Private not-for-profit,Graduate degree or certificate offering,No,Rural: Fringe,Master's Colleges & Universities: Small Programs,"Postbaccalaureate: Other-dominant, with Arts & Sciences",High undergraduate,"Four-year, small, highly residential",290,92,198,29,24,5,290,145,43,102,85,20,65,5,2,3,7,0,7,0,0,0,AL01
101709,University of Montevallo, ,Station 6001,Montevallo,AL,35115-6000,-86.865099,33.10625,Public,Graduate degree or certificate offering,No,Suburb: Large,Master's Colleges & Universities: Medium Programs,"Postbaccalaureate: Education-dominant, with Arts & Sciences",Very high undergraduate,"Four-year, small, highly residential",484,105,379,5,2,3,484,130,339,15,109,27,82,1,0,1,0,0,0,0,0,0,AL06
101879,University of North Alabama,UNA,One Harrison Plaza,Florence,AL,35632-0001,-87.681361,34.806738,Public,Graduate degree or certificate offering,No,City: Small,Master's Colleges & Universities: Larger Programs,"Postbaccalaureate: Business-dominant, with Arts & Sciences",High undergraduate,"Four-year, medium, primarily residential",2854,1024,1830,81,31,50,2854,2491,305,58,561,188,373,31,13,18,0,0,0,0,0,0,AL04
101912,Oakwood University,OU,7000 Adventist Blvd NW,Huntsville,AL,35896,-86.652705,34.756344,Private not-for-profit,Graduate degree or certificate offering,Yes,City: Midsize,Baccalaureate Colleges: Arts & Sciences Focus,Postbaccalaureate: Single program-Other,Very high undergraduate,"Four-year, small, highly residential",100,41,59,4,1,3,100,59,34,7,12,5,7,1,0,1,0,0,0,0,0,0,AL05
102049,Samford University, ,800 Lakeshore Drive,Birmingham,AL,35229-2240,-86.791799,33.464128,Private not-for-profit,Graduate degree or certificate offering,No,Suburb: Large,Doctoral/Professional Universities,Research Doctoral: Single program-Education,Majority undergraduate,"Four-year, medium, highly residential",2476,829,1647,17,9,8,2476,316,1648,512,264,92,172,13,10,3,46,20,26,0,0,0,AL07
102094,University of South Alabama, ,307 N University Blvd,Mobile,AL,36688-0002,-88.178711,30.696033,Public,Graduate degree or certificate offering,No,City: Midsize,Doctoral Universities: High Research Activity,Research Doctoral: Professional-dominant,Majority undergraduate,"Four-year, large, primarily residential",6164,1183,4981,95,52,43,6164,4191,509,1464,1230,238,992,45,22,23,39,15,24,6,3,3,AL01
102234,Spring Hill College,Springhill|Springhill College|SHC|the Hill,4000 Dauphin St,Mobile,AL,36608-1791,-88.138199,30.694751,Private not-for-profit,Graduate degree or certificate offering,No,City: Midsize,Baccalaureate Colleges: Diverse Fields,"Postbaccalaureate: Business-dominant, with Arts & Sciences",Very high undergraduate,"Four-year, small, highly residential",189,110,79,3,3,0,189,128,37,24,42,23,19,2,2,0,0,0,0,0,0,0,AL01
102298,Talladega College, ,627 West Battle Street,Talladega,AL,35160,-86.112704,33.433472,Private not-for-profit,Graduate degree or certificate offering,Yes,Town: Distant,Baccalaureate Colleges: Diverse Fields,Postbaccalaureate: Single program-Other,Very high undergraduate,"Four-year, small, highly residential",18,8,10,2,1,1,18,18,0,0,4,1,3,0,0,0,0,0,0,0,0,0,AL03
102368,Troy University,TROY,University Avenue,Troy,AL,36082-0001,-85.957094,31.800672,Public,Graduate degree or certificate offering,No,Town: Remote,Master's Colleges & Universities: Larger Programs,Research Doctoral: Single program-Other,High undergraduate,"Four-year, large, primarily nonresidential",5513,2109,3404,74,33,41,5513,4036,628,849,1137,381,756,33,16,17,8,6,2,0,0,0,AL02
102377,Tuskegee University, ,"Kresge Center, 3rd Floor",Tuskegee,AL,36088-1920,-85.708492,32.4309,Private not-for-profit,Graduate degree or certificate offering,Yes,Town: Distant,Master's Colleges & Universities: Medium Programs,Research Doctoral: STEM-dominant,High undergraduate,"Four-year, small, highly residential",521,130,391,0,0,0,521,2,0,519,76,26,50,0,0,0,6,3,3,0,0,0,AL03
102395,United States Sports Academy,The Academy America's Sports University,One Academy Drive,Daphne,AL,36526-7055,-87.91163,30.639329,Private not-for-profit,Graduate degree or certificate offering,No,City: Small,Special Focus Four-Year: Other Special Focus Institutions,"Postbaccalaureate: Other-dominant, with Arts & Sciences",Majority graduate,"Four-year, very small, primarily nonresidential",275,191,84,0,0,0,275,275,0,0,34,20,14,1,0,1,0,0,0,0,0,0,AL01
102553,University of Alaska Anchorage,UAA,3211 Providence Drive,Anchorage,AK,99508,-149.82619,61.190163,Public,Graduate degree or certificate offering,No,City: Large,Master's Colleges & Universities: Larger Programs,Research Doctoral: Humanities/social sciences-dominant,Very high undergraduate,"Four-year, medium, primarily nonresidential",866,277,589,23,9,14,866,644,148,74,190,66,124,6,2,4,6,2,4,0,0,0,AK00
102614,University of Alaska Fairbanks,UAF,1731 South Chandalar Drive,Fairbanks,AK,99775,-147.823146,64.85756,Public,Graduate degree or certificate offering,No,Suburb: Small,Doctoral Universities: High Research Activity,"Research Doctoral: Comprehensive programs, no medical/veterinary school",High undergraduate,"Four-year, medium, primarily nonresidential",1198,480,718,86,52,34,1198,656,415,127,195,86,109,12,9,3,39,21,18,11,7,4,AK00
102632,University of Alaska Southeast, ,11066 Auke Lake Way,Juneau,AK,99801-8697,-134.638255,58.384846,Public,Graduate degree or certificate offering,No,Town: Remote,Master's Colleges & Universities: Medium Programs,"Postbaccalaureate: Education-dominant, with other professional programs",High undergraduate,"Four-year, very small, primarily nonresidential",370,95,275,11,2,9,370,215,137,18,122,35,87,4,2,2,0,0,0,0,0,0,AK00
102669,Alaska Pacific University, ,4101 University Dr,Anchorage,AK,99508,-149.804168,61.190968,Private not-for-profit,Graduate degree or certificate offering,No,City: Large,Baccalaureate Colleges: Diverse Fields,"Postbaccalaureate: Business-dominant, with Arts & Sciences",Majority undergraduate,"Four-year, very small, primarily residential",200,60,140,0,0,0,200,183,11,6,57,18,39,0,0,0,0,0,0,0,0,0,AK00
104090,Brookline College-Phoenix, ,"2445 W. Dunlap Ave., Ste. 100",Phoenix,AZ,85021,-112.112473,33.566102,Private for-profit,Graduate degree or certificate offering,No,City: Large,Special Focus Four-Year: Other Health Professions Schools,Postbaccalaureate: Single program-Other,Very high undergraduate,"Four-year, small, primarily nonresidential",54,15,39,0,0,0,54,54,0,0,14,5,9,0,0,0,0,0,0,0,0,0,AZ08
104151,Arizona State University Campus Immersion,ASU Tempe,University Drive and Mill Avenue,Tempe,AZ,85287,-111.934383,33.417721,Public,Graduate degree or certificate offering,No,City: Midsize,Doctoral Universities: Very High Research Activity,"Research Doctoral: Comprehensive programs, no medical/veterinary school",High undergraduate,"Four-year, large, primarily residential",13884,7146,6738,4452,2904,1548,13884,1072,6506,6306,3926,2108,1818,1533,1022,511,614,317,297,222,157,65,AZ04
104179,University of Arizona,The University of Arizona | UArizona | U of A | UofA | UA | University of AZ | Univ. of AZ | The Univ. of AZ,1401 E University,Tucson,AZ,85721-0066,-110.950815,32.232672,Public,Graduate degree or certificate offering,No,City: Large,Doctoral Universities: Very High Research Activity,"Research Doctoral: Comprehensive programs, with medical/veterinary school",High undergraduate,"Four-year, large, primarily nonresidential",11968,5344,6624,1444,806,638,11968,3766,2378,5824,2256,1021,1235,297,168,129,486,266,220,146,98,48,AZ07
104586,Embry-Riddle Aeronautical University-Prescott,Embry Riddle Aeronautical University-Prescott,3700 Willow Creek Road,Prescott,AZ,86301-3720,-112.449741,34.616766,Private not-for-profit,Graduate degree or certificate offering,No,Rural: Fringe,Baccalaureate Colleges: Diverse Fields,"Postbaccalaureate: Other-dominant, with Arts & Sciences",Very high undergraduate,"Four-year, small, primarily residential",53,35,18,17,13,4,53,2,17,34,14,4,10,3,1,2,0,0,0,0,0,0,AZ02
104665,The School of Architecture, ,6433 E. Doubletree Ranch Rd.,Paradise Valley,AZ,85253,-111.941953,33.566649,Private not-for-profit,Graduate degree or certificate offering,No,Suburb: Large,Special Focus Four-Year: Other Special Focus Institutions,Postbaccalaureate: Single program-Other,Exclusively graduate,Exclusively graduate/professional,15,8,7,0,0,0,15,2,0,13,7,2,5,0,0,0,0,0,0,0,0,0,AZ01
104717,Grand Canyon University,GCU,3300 W Camelback Rd,Phoenix,AZ,85017,-112.129929,33.513231,Private for-profit,Graduate degree or certificate offering,No,City: Large,Doctoral/Professional Universities,Research Doctoral: Professional-dominant,Majority undergraduate,"Four-year, large, primarily nonresidential",61923,14241,47682,461,214,247,61923,57692,3506,725,14378,3188,11190,124,48,76,829,195,634,4,2,2,AZ03
105330,Northern Arizona University,NAU,"1900 S Knoles Dr, Babbitt Administrative Center, Room 200",Flagstaff,AZ,86011-4092,-111.653724,35.188449,Public,Graduate degree or certificate offering,No,City: Small,Doctoral Universities: High Research Activity,"Research Doctoral: Comprehensive programs, no medical/veterinary school",High undergraduate,"Four-year, large, primarily residential",5305,1613,3692,205,117,88,5305,2459,1165,1681,1328,410,918,47,29,18,77,31,46,13,6,7,AZ02
105367,Ottawa University-Phoenix,OUAZ - Phoenix,9414 North 25th Avenue,Phoenix,AZ,85021,-112.113001,33.572173,Private not-for-profit,Graduate degree or certificate offering,No,City: Large,Master's Colleges & Universities: Medium Programs,"Postbaccalaureate: Other-dominant, with other professional programs",Majority graduate,"Four-year, very small, primarily nonresidential",832,361,471,0,0,0,832,172,660,0,168,68,100,0,0,0,0,0,0,0,0,0,AZ08
105589,Prescott College,Prescot College | Prescott University | Prescott University | Prescott | PC | Prescott Center for Alternative Education,220 Grove Ave,Prescott,AZ,86301,-112.477185,34.5452,Private not-for-profit,Graduate degree or certificate offering,No,City: Small,Master's Colleges & Universities: Medium Programs,Research Doctoral: Single program-Education,Majority undergraduate,"Four-year, very small, primarily residential",772,171,601,3,0,3,772,765,0,7,176,49,127,2,0,2,5,1,4,0,0,0,AZ02
106245,University of Arkansas at Little Rock,UA Little Rock|University of Arkansas-Little Rock|Arkansas Little Rock|,2801 S University Ave,Little Rock,AR,72204,-92.339778,34.723254,Public,Graduate degree or certificate offering,No,City: Midsize,Doctoral Universities: High Research Activity,Research Doctoral: STEM-dominant,Majority undergraduate,"Four-year, medium, primarily nonresidential",2891,1098,1793,313,183,130,2891,2122,162,607,416,142,274,62,30,32,50,24,26,25,17,8,AR02
106263,University of Arkansas for Medical Sciences,UAMS,4301 W Markham,Little Rock,AR,72205-7199,-92.322348,34.750152,Public,Graduate degree or certificate offering,No,City: Midsize,Special Focus Four-Year: Research Institutions,Research Doctoral: Professional-dominant,Majority graduate,"Four-year, small, primarily nonresidential",2265,802,1463,82,41,41,2265,343,1278,644,225,58,167,4,1,3,31,13,18,7,4,3,AR02
106397,University of Arkansas,University of Arkansas|Arkansas,Administration Bldg 425,Fayetteville,AR,72701,-94.176981,36.070009,Public,Graduate degree or certificate offering,No,City: Small,Doctoral Universities: Very High Research Activity,"Research Doctoral: Comprehensive programs, no medical/veterinary school",High undergraduate,"Four-year, large, primarily residential",5556,2684,2872,791,433,358,5556,2226,2524,806,1229,606,623,127,64,63,208,114,94,81,54,27,AR03
106412,University of Arkansas at Pine Bluff,UAPB,1200 N University Mail Slot 4789,Pine Bluff,AR,71601,-92.018683,34.244031,Public,Graduate degree or certificate offering,Yes,City: Small,Baccalaureate Colleges: Diverse Fields,"Postbaccalaureate: Education-dominant, with Arts & Sciences",Very high undergraduate,"Four-year, small, highly residential",200,97,103,21,15,6,200,27,158,15,34,8,26,2,1,1,0,0,0,0,0,0,AR04
106458,Arkansas State University,A-State,2105 E. Aggie Road,Jonesboro,AR,72401,-90.679988,35.842388,Public,Graduate degree or certificate offering,No,City: Small,Doctoral Universities: High Research Activity,Research Doctoral: Professional-dominant,High undergraduate,"Four-year, medium, primarily residential",8289,2570,5719,175,103,72,8289,7184,453,652,1850,584,1266,66,41,25,19,4,15,1,1,0,AR01
106467,Arkansas Tech University,ATU|Tech|Arkansas Tech,"Administration Bldg 200, 1509 N Boulder Ave",Russellville,AR,72801-2222,-93.13562,35.293237,Public,Graduate degree or certificate offering,No,Town: Remote,Master's Colleges & Universities: Larger Programs,Research Doctoral: Single program-Education,Very high undergraduate,"Four-year, medium, primarily residential",1012,350,662,36,24,12,1012,855,131,26,261,87,174,13,8,5,10,4,6,0,0,0,AR04
106485,University of Arkansas at Monticello,UAM,Highway 425 South,Monticello,AR,71656,-91.811153,33.590909,Public,Graduate degree or certificate offering,No,Town: Remote,Master's Colleges & Universities: Medium Programs,"Postbaccalaureate: Education-dominant, with Arts & Sciences",Very high undergraduate,"Four-year, small, primarily residential",545,165,380,3,2,1,545,363,142,40,155,57,98,2,2,0,0,0,0,0,0,0,AR04
106704,University of Central Arkansas, ,201 Donaghey Ave,Conway,AR,72035-0001,-92.457672,35.077945,Public,Graduate degree or certificate offering,No,City: Small,Doctoral/Professional Universities,Research Doctoral: Professional-dominant,High undergraduate,"Four-year, medium, primarily residential",2221,583,1638,77,39,38,2221,1104,739,378,536,156,380,34,17,17,15,2,13,0,0,0,AR02
107044,Harding University, ,915 E. Market Ave.,Searcy,AR,72149-5615,-91.726143,35.247386,Private not-for-profit,Graduate degree or certificate offering,No,Town: Distant,Doctoral/Professional Universities,Research Doctoral: Single program-Education,High undergraduate,"Four-year, medium, highly residential",1319,481,838,16,11,5,1319,508,292,519,298,112,186,9,5,4,8,6,2,0,0,0,AR02
107071,Henderson State University, ,1100 Henderson Street,Arkadelphia,AR,71999-0001,-93.059703,34.128155,Public,Graduate degree or certificate offering,No,Town: Distant,Master's Colleges & Universities: Medium Programs,"Postbaccalaureate: Education-dominant, with Arts & Sciences",Very high undergraduate,"Four-year, small, highly residential",715,189,526,4,2,2,715,527,158,30,177,47,130,3,2,1,0,0,0,0,0,0,AR04
107080,Hendrix College, ,1600 Washington Ave,Conway,AR,72032-3080,-92.443256,35.101565,Private not-for-profit,Graduate degree or certificate offering,No,City: Small,Baccalaureate Colleges: Arts & Sciences Focus,Postbaccalaureate: Single program-Business,Very high undergraduate,"Four-year, small, highly residential",14,8,6,0,0,0,14,0,0,14,11,7,4,0,0,0,0,0,0,0,0,0,AR02
107141,John Brown University, ,2000 W University St,Siloam Springs,AR,72761,-94.560283,36.189812,Private not-for-profit,Graduate degree or certificate offering,No,Town: Distant,Master's Colleges & Universities: Medium Programs,"Postbaccalaureate: Other-dominant, with other professional programs",High undergraduate,"Four-year, small, highly residential",754,244,510,13,6,7,754,393,316,45,166,58,108,1,0,1,0,0,0,0,0,0,AR03
107512,Ouachita Baptist University,OBU,410 Ouachita St,Arkadelphia,AR,71998-0001,-93.052471,34.126093,Private not-for-profit,Graduate degree or certificate offering,No,Town: Distant,Baccalaureate Colleges: Arts & Sciences Focus,Not classified (Exclusively Undergraduate),Very high undergraduate,"Four-year, small, highly residential",81,4,77,0,0,0,81,0,81,0,0,0,0,0,0,0,0,0,0,0,0,0,AR04
107877,Williams Baptist University, ,60 W Fulbright Avenue,Walnut Ridge,AR,72476,-90.940277,36.125676,Private not-for-profit,Graduate degree or certificate offering,No,Rural: Distant,Baccalaureate Colleges: Diverse Fields,Postbaccalaureate: Single program-Education,Very high undergraduate,"Four-year, very small, highly residential",32,12,20,0,0,0,32,32,0,0,8,3,5,0,0,0,0,0,0,0,0,0,AR01
107983,Southern Arkansas University Main Campus, ,100 E. University,Magnolia,AR,71753,-93.235922,33.291618,Public,Graduate degree or certificate offering,No,Town: Remote,Master's Colleges & Universities: Larger Programs,"Postbaccalaureate: Education-dominant, with Arts & Sciences",High undergraduate,"Four-year, medium, highly residential",1446,469,977,180,94,86,1446,1228,174,44,356,127,229,73,35,38,0,0,0,0,0,0,AR04
108092,University of Arkansas-Fort Smith,UA Fort Smith; UAFS,5210 Grand Ave,Fort Smith,AR,72913-3649,-94.373729,35.384184,Public,Graduate degree or certificate offering,No,City: Small,Baccalaureate Colleges: Diverse Fields,Postbaccalaureate: Single program-Other,Very high undergraduate,"Four-year, medium, primarily nonresidential",67,15,52,0,0,0,67,67,0,0,16,4,12,0,0,0,0,0,0,0,0,0,AR03
108232,Academy of Art University, ,79 New Montgomery,San Francisco,CA,94105,-122.400578,37.787943,Private for-profit,Graduate degree or certificate offering,No,City: Large,Master's Colleges & Universities: Larger Programs,"Postbaccalaureate: Other-dominant, with Arts & Sciences",Majority undergraduate,"Four-year, medium, primarily nonresidential",3684,1250,2434,1446,495,951,3684,2300,789,595,849,276,573,477,154,323,0,0,0,0,0,0,CA11
108269,Academy of Chinese Culture and Health Sciences,ACCHS,"1600 Broadway, Ste. 200",Oakland,CA,94612,-122.269839,37.805972,Private not-for-profit,Graduate degree or certificate offering,No,City: Large,Special Focus Four-Year: Other Health Professions Schools,Postbaccalaureate: Single program-Other,Exclusively graduate,Exclusively graduate/professional,121,30,91,0,0,0,121,0,121,0,10,1,9,0,0,0,6,2,4,0,0,0,CA12
108861,Berkeley School of Theology,BST,2606 Dwight Way,Berkeley,CA,94704-3029,-122.256149,37.865252,Private not-for-profit,Graduate degree or certificate offering,No,City: Midsize,Special Focus Four-Year: Faith-Related Institutions,Postbaccalaureate: Single program-Other,Exclusively graduate,Exclusively graduate/professional,54,35,19,8,7,1,54,47,0,7,18,11,7,1,1,0,0,0,0,0,0,0,CA12
108870,American Film Institute Conservatory,AFI Conservatory,2021 N Western Ave,Los Angeles,CA,90027-1625,-118.310018,34.10767,Private not-for-profit,Graduate degree or certificate offering,No,City: Large,"Special Focus Four-Year: Arts, Music & Design Schools",Postbaccalaureate: Single program-Other,Exclusively graduate,Exclusively graduate/professional,383,194,189,140,61,79,383,0,383,0,73,28,45,32,12,20,0,0,0,0,0,0,CA30
109086,American Conservatory Theater, ,415 Geary Street,San Francisco,CA,94102,-122.410265,37.786923,Private not-for-profit,Graduate degree or certificate offering,No,City: Large,"Special Focus Four-Year: Arts, Music & Design Schools",Postbaccalaureate: Single program-Other,Majority graduate,Exclusively graduate/professional,23,11,12,2,2,0,23,0,0,23,12,7,5,1,1,0,0,0,0,0,0,0,CA11
109651,Art Center College of Design, ,1700 Lida St,Pasadena,CA,91103,-118.185102,34.169031,Private not-for-profit,Graduate degree or certificate offering,No,City: Midsize,Master's Colleges & Universities: Small Programs,"Postbaccalaureate: Other-dominant, with Arts & Sciences",High undergraduate,"Four-year, small, primarily nonresidential",328,143,185,204,73,131,328,328,0,0,90,47,43,49,24,25,0,0,0,0,0,0,CA30
109785,Azusa Pacific University, ,901 E Alosta,Azusa,CA,91702-7000,-117.888375,34.130047,Private not-for-profit,Graduate degree or certificate offering,No,Suburb: Large,Doctoral Universities: High Research Activity,Research Doctoral: Professional-dominant,Majority undergraduate,"Four-year, medium, highly residential",5396,1451,3945,177,71,106,5396,5396,0,0,974,285,689,50,20,30,82,20,62,0,0,0,CA31
110060,Bethesda University,Bethesda University,730 N. Euclid St,Anaheim,CA,92801,-117.941323,33.842295,Private not-for-profit,Graduate degree or certificate offering,No,City: Large,Baccalaureate Colleges: Diverse Fields,"Postbaccalaureate: Business-dominant, with Arts & Sciences",Majority undergraduate,"Four-year, very small, primarily nonresidential",142,82,60,100,55,45,142,110,31,1,40,21,19,32,16,16,0,0,0,0,0,0,CA46
110097,Biola University, ,13800 Biola Ave,La Mirada,CA,90639-0001,-118.014374,33.906203,Private not-for-profit,Graduate degree or certificate offering,No,Suburb: Large,Doctoral/Professional Universities,Research Doctoral: Professional-dominant,Majority undergraduate,"Four-year, medium, highly residential",2478,1361,1117,397,224,173,2478,1868,506,104,427,225,202,30,16,14,35,9,26,2,1,1,CA38
110316,California Institute of Integral Studies,CIIS,1453 Mission Street,San Francisco,CA,94103,-122.416102,37.774924,Private not-for-profit,Graduate degree or certificate offering,No,City: Large,Doctoral/Professional Universities,Research Doctoral: Humanities/social sciences-dominant,Majority graduate,"Four-year, small, primarily nonresidential",1879,428,1451,296,39,257,1879,1879,0,0,277,64,213,24,7,17,53,16,37,4,1,3,CA11
110361,California Baptist University,CBU,8432 Magnolia Ave,Riverside,CA,92504-3297,-117.425619,33.929321,Private not-for-profit,Graduate degree or certificate offering,No,City: Large,Master's Colleges & Universities: Larger Programs,Research Doctoral: Professional-dominant,High undergraduate,"Four-year, medium, primarily residential",4411,1247,3164,205,98,107,4411,1222,1456,1733,1310,398,912,94,41,53,14,6,8,0,0,0,CA39
110370,California College of the Arts, ,1111 Eighth Street,San Francisco,CA,94107-2247,-122.399451,37.767485,Private not-for-profit,Graduate degree or certificate offering,No,City: Large,"Special Focus Four-Year: Arts, Music & Design Schools","Postbaccalaureate: Other-dominant, with Arts & Sciences",High undergraduate,"Four-year, small, highly residential",396,136,260,190,59,131,396,284,109,3,171,57,114,85,26,59,0,0,0,0,0,0,CA11
110398,University of California-Hastings College of Law,UC Hastings,200 McAllister Street,San Francisco,CA,94102-4978,-122.4157,37.781137,Public,Graduate degree or certificate offering,No,City: Large,Special Focus Four-Year: Law Schools,"Postbaccalaureate: Other-dominant, with other professional programs",Exclusively graduate,Exclusively graduate/professional,1034,403,631,28,8,20,1034,0,227,807,22,8,14,7,2,5,0,0,0,0,0,0,CA11
110404,California Institute of Technology,Caltech,1200 E California Blvd,Pasadena,CA,91125,-118.125878,34.137349,Private not-for-profit,Graduate degree or certificate offering,No,City: Midsize,Doctoral Universities: Very High Research Activity,Research Doctoral: STEM-dominant,Majority graduate,"Four-year, small, highly residential",1406,956,450,636,449,187,1406,852,327,227,116,71,45,56,38,18,184,126,58,85,60,25,CA28
110413,California Lutheran University, ,60 W Olsen Rd,Thousand Oaks,CA,91360-2787,-118.878924,34.224566,Private not-for-profit,Graduate degree or certificate offering,No,City: Midsize,Master's Colleges & Universities: Larger Programs,"Postbaccalaureate: Business-dominant, with Arts & Sciences",Majority undergraduate,"Four-year, medium, highly residential",1570,533,1037,248,137,111,1570,658,813,99,440,164,276,98,51,47,0,0,0,0,0,0,CA26
110422,California Polytechnic State University-San Luis Obispo,Cal Poly,1 Grand Ave.,San Luis Obispo,CA,93407,-120.657311,35.299513,Public,Graduate degree or certificate offering,No,Suburb: Small,Master's Colleges & Universities: Larger Programs,Postbaccalaureate: Comprehensive programs,Very high undergraduate,"Four-year, large, primarily residential",1182,597,585,45,35,10,1182,588,563,31,520,269,251,23,18,5,0,0,0,0,0,0,CA24
110468,Alliant International University-San Diego, ,10455 Pomerado Road,San Diego,CA,92131,-117.094398,32.897056,Private for-profit,Graduate degree or certificate offering,No,City: Large,Doctoral/Professional Universities,Research Doctoral: Professional-dominant,Majority graduate,"Four-year, small, primarily nonresidential",3898,983,2915,44,20,24,3898,3898,0,0,588,173,415,9,5,4,249,60,189,10,4,6,CA51
110486,California State University-Bakersfield,CSU Bakersfield,9001 Stockdale Hwy,Bakersfield,CA,93311-1099,-119.104711,35.350005,Public,Graduate degree or certificate offering,No,City: Large,Master's Colleges & Universities: Larger Programs,Research Doctoral: Single program-Education,High undergraduate,"Four-year, large, primarily nonresidential",2052,520,1532,53,15,38,2052,1958,85,9,481,114,367,19,6,13,0,0,0,0,0,0,CA20
110495,California State University-Stanislaus,Stanislaus State,One University Circle,Turlock,CA,95382-0299,-120.852511,37.52577,Public,Graduate degree or certificate offering,No,Suburb: Small,Master's Colleges & Universities: Larger Programs,Research Doctoral: Single program-Education,High undergraduate,"Four-year, medium, primarily nonresidential",1508,377,1131,33,6,27,1508,1161,340,7,347,98,249,7,2,5,0,0,0,0,0,0,CA05
110510,California State University-San Bernardino,Cal State San Bernardino,5500 University Parkway,San Bernardino,CA,92407-2393,-117.323801,34.182622,Public,Graduate degree or certificate offering,No,City: Midsize,Doctoral Universities: High Research Activity,Research Doctoral: Single program-Education,High undergraduate,"Four-year, large, primarily nonresidential",2863,978,1885,174,73,101,2863,2801,62,0,692,235,457,48,24,24,0,0,0,0,0,0,CA33
110529,California State Polytechnic University-Pomona, ,3801 W Temple Avenue,Pomona,CA,91768,-117.821476,34.057912,Public,Graduate degree or certificate offering,No,Suburb: Large,Master's Colleges & Universities: Larger Programs,Research Doctoral: Single program-Education,Very high undergraduate,"Four-year, large, primarily nonresidential",2465,1175,1290,235,107,128,2465,2373,92,0,444,196,248,64,25,39,0,0,0,0,0,0,CA35
110538,California State University-Chico, ,First and Normal Sts,Chico,CA,95929-0150,-121.844859,39.729712,Public,Graduate degree or certificate offering,No,City: Midsize,Master's Colleges & Universities: Larger Programs,Postbaccalaureate: Comprehensive programs,Very high undergraduate,"Four-year, large, primarily nonresidential",1236,356,880,64,29,35,1236,860,376,0,312,65,247,23,12,11,0,0,0,0,0,0,CA01
110547,California State University-Dominguez Hills,CSUDH,1000 E Victoria St,Carson,CA,90747-0005,-118.255917,33.864766,Public,Graduate degree or certificate offering,No,City: Small,Master's Colleges & Universities: Larger Programs,Postbaccalaureate: Comprehensive programs,High undergraduate,"Four-year, large, primarily nonresidential",3116,908,2208,136,54,82,3116,2318,791,7,760,214,546,45,23,22,0,0,0,0,0,0,CA44
110556,California State University-Fresno, ,5241 N Maple Ave,Fresno,CA,93740,-119.744569,36.811154,Public,Graduate degree or certificate offering,No,City: Large,Doctoral Universities: High Research Activity,Research Doctoral: Single program-Education,Very high undergraduate,"Four-year, large, primarily nonresidential",3129,1029,2100,231,105,126,3129,2271,855,3,848,284,564,80,35,45,0,0,0,0,0,0,CA20
110565,California State University-Fullerton,Cal State Fullerton,800 N State College Blvd,Fullerton,CA,92831-3599,-117.885446,33.881506,Public,Graduate degree or certificate offering,No,Suburb: Large,Doctoral Universities: High Research Activity,Research Doctoral: Single program-Education,Very high undergraduate,"Four-year, large, primarily nonresidential",5768,2185,3583,552,277,275,5768,5424,317,27,1575,639,936,260,137,123,0,0,0,0,0,0,CA45
110574,California State University-East Bay,Cal State East Bay,25800 Carlos Bee Blvd,Hayward,CA,94542,-122.054135,37.657694,Public,Graduate degree or certificate offering,No,Suburb: Large,Doctoral Universities: High Research Activity,Research Doctoral: Single program-Education,High undergraduate,"Four-year, large, primarily nonresidential",3642,1266,2376,612,222,390,3642,3456,185,1,1190,402,788,260,90,170,0,0,0,0,0,0,CA14
110583,California State University-Long Beach,Cal State Long Beach,1250 Bellflower Blvd,Long Beach,CA,90840-0115,-118.11204,33.782818,Public,Graduate degree or certificate offering,No,City: Large,Doctoral Universities: High Research Activity,Research Doctoral: Single program-Education,High undergraduate,"Four-year, large, primarily nonresidential",6709,2507,4202,488,239,249,6709,5016,1595,98,1629,620,1009,189,93,96,0,0,0,0,0,0,CA42
110592,California State University-Los Angeles,Cal State LA,5151 State University Dr,Los Angeles,CA,90032-8506,-118.168965,34.066927,Public,Graduate degree or certificate offering,No,City: Large,Master's Colleges & Universities: Larger Programs,Research Doctoral: Single program-Education,High undergraduate,"Four-year, large, primarily nonresidential",4438,1604,2834,395,158,237,4438,3719,678,41,1178,425,753,131,49,82,0,0,0,0,0,0,CA34
110608,California State University-Northridge,CSUN,18111 Nordhoff St,Northridge,CA,91330,-118.529319,34.240126,Public,Graduate degree or certificate offering,No,City: Large,Master's Colleges & Universities: Larger Programs,Research Doctoral: Single program-Education,High undergraduate,"Four-year, large, primarily nonresidential",6507,2170,4337,359,155,204,6507,4375,2028,104,1634,516,1118,114,47,67,0,0,0,0,0,0,CA32
110617,California State University-Sacramento,Sacramento State,6000 J St,Sacramento,CA,95819-2694,-121.423549,38.559415,Public,Graduate degree or certificate offering,No,City: Large,Master's Colleges & Universities: Larger Programs,Research Doctoral: Single program-Education,Very high undergraduate,"Four-year, large, primarily nonresidential",3557,1201,2356,301,133,168,3557,1665,1563,329,1023,331,692,109,52,57,0,0,0,0,0,0,CA07
110635,University of California-Berkeley,UC Berkeley,200 California Hall,Berkeley,CA,94720,-122.260463,37.871918,Public,Graduate degree or certificate offering,No,City: Midsize,Doctoral Universities: Very High Research Activity,"Research Doctoral: Comprehensive programs, no medical/veterinary school",Majority undergraduate,"Four-year, large, primarily residential",12524,6691,5833,3407,2084,1323,12524,6100,5654,770,2905,1574,1331,1001,567,434,794,502,292,231,177,54,CA12
110644,University of California-Davis,UC Davis,One Shields Avenue,Davis,CA,95616-8678,-121.749567,38.539667,Public,Graduate degree or certificate offering,No,Suburb: Small,Doctoral Universities: Very High Research Activity,"Research Doctoral: Comprehensive programs, with medical/veterinary school",High undergraduate,"Four-year, large, primarily residential",8347,3682,4665,1813,1032,781,8347,1257,6680,410,1225,557,668,357,195,162,472,243,229,157,87,70,CA04
110653,University of California-Irvine,UCI  UC Irvine,501 Aldrich Hall,Irvine,CA,92697,-117.841248,33.648434,Public,Graduate degree or certificate offering,No,City: Large,Doctoral Universities: Very High Research Activity,"Research Doctoral: Comprehensive programs, with medical/veterinary school",High undergraduate,"Four-year, large, primarily residential",7107,3572,3535,1888,1122,766,7107,4306,2510,291,1609,808,801,466,280,186,396,219,177,140,84,56,CA47
110662,University of California-Los Angeles,UCLA,405 Hilgard Ave,Los Angeles,CA,90095-1405,-118.442179,34.07178,Public,Graduate degree or certificate offering,No,City: Large,Doctoral Universities: Very High Research Activity,"Research Doctoral: Comprehensive programs, with medical/veterinary school",Majority undergraduate,"Four-year, large, highly residential",13528,6979,6549,3050,1839,1211,13528,3805,7306,2417,3137,1649,1488,803,496,307,696,378,318,245,167,78,CA36
110671,University of California-Riverside,UC Riverside,900 University Ave,Riverside,CA,92521,-117.32741,33.97246,Public,Graduate degree or certificate offering,No,City: Large,Doctoral Universities: Very High Research Activity,"Research Doctoral: Comprehensive programs, with medical/veterinary school",High undergraduate,"Four-year, large, primarily residential",3981,2151,1830,1350,818,532,3981,1247,2388,346,837,441,396,324,202,122,268,153,115,94,67,27,CA39
110680,University of California-San Diego,UCSD  UC San Diego,9500 Gilman Dr,La Jolla,CA,92093,-117.235866,32.877749,Public,Graduate degree or certificate offering,No,City: Large,Doctoral Universities: Very High Research Activity,"Research Doctoral: Comprehensive programs, with medical/veterinary school",High undergraduate,"Four-year, large, highly residential",8114,4666,3448,3209,2068,1141,8114,1361,6550,203,2170,1324,846,1116,719,397,508,312,196,212,152,60,CA50
110699,University of California-San Francisco,"UCSF  UC San Francisco  University of California at San Francisco  University of California, San Francisco",500 Parnassus Ave,San Francisco,CA,94143-0244,-122.458489,37.763737,Public,Graduate degree or certificate offering,No,City: Large,Special Focus Four-Year: Research Institutions,Research Doctoral: STEM-dominant,Exclusively graduate,Exclusively graduate/professional,3313,1191,2122,104,33,71,3313,106,2532,675,284,67,217,12,1,11,135,61,74,14,7,7,CA11
110705,University of California-Santa Barbara,UCSB  UC Santa Barbara,5221 Cheadle Hall,Santa Barbara,CA,93106,-119.846426,34.416297,Public,Graduate degree or certificate offering,No,Suburb: Midsize,Doctoral Universities: Very High Research Activity,"Research Doctoral: Comprehensive programs, no medical/veterinary school",High undergraduate,"Four-year, large, primarily residential",3073,1639,1434,931,575,356,3073,2758,310,5,511,250,261,128,78,50,287,164,123,88,60,28,CA24
110714,University of California-Santa Cruz,UC Santa Cruz,1156 High St,Santa Cruz,CA,95064-1011,-122.058801,36.995584,Public,Graduate degree or certificate offering,No,City: Small,Doctoral Universities: Very High Research Activity,Research Doctoral: STEM-dominant,High undergraduate,"Four-year, large, highly residential",2088,1099,989,556,319,237,2088,296,1262,530,428,218,210,137,75,62,160,83,77,28,17,11,CA19
110778,Sofia University,Institute of Transpersonal Psychology,1069 East Meadow Cr,Palo Alto,CA,94303,-122.10866,37.430325,Private for-profit,Graduate degree or certificate offering,No,City: Small,Special Focus Four-Year: Other Special Focus Institutions,Research Doctoral: Single program-Other,Majority graduate,"Four-year, very small, primarily nonresidential",2009,973,1036,1788,916,872,2009,1764,235,10,664,349,315,646,342,304,6,5,1,0,0,0,CA16
111045,Haven University, ,12761 Euclid St.,Garden Grove,CA,92840-1340,-117.939412,33.777392,Private not-for-profit,Graduate degree or certificate offering,No,Suburb: Large,Special Focus Four-Year: Faith-Related Institutions,Postbaccalaureate: Single program-Other,Majority undergraduate,"Four-year, very small, primarily nonresidential",40,22,18,22,9,13,40,0,0,40,0,0,0,0,0,0,0,0,0,0,0,0,CA45
111081,California Institute of the Arts,CalArts,24700 W McBean Pky,Valencia,CA,91355-2397,-118.566837,34.39327,Private not-for-profit,Graduate degree or certificate offering,No,Suburb: Large,Master's Colleges & Universities: Medium Programs,Research Doctoral: Single program-Other,Majority undergraduate,"Four-year, small, highly residential",438,176,262,161,38,123,438,0,0,438,161,63,98,54,12,42,2,2,0,1,1,0,CA27
111188,California State University Maritime Academy,California State University Maritime Academy,200 Maritime Academy Dr,Vallejo,CA,94590-8181,-122.231551,38.069061,Public,Graduate degree or certificate offering,No,City: Midsize,Baccalaureate Colleges: Diverse Fields,Postbaccalaureate: Single program-Business,Very high undergraduate,"Four-year, very small, highly residential",50,34,16,4,3,1,50,50,0,0,18,13,5,0,0,0,0,0,0,0,0,0,CA08
111391,California Western School of Law, ,225 Cedar St,San Diego,CA,92101-3046,-117.162416,32.722192,Private not-for-profit,Graduate degree or certificate offering,No,City: Large,Special Focus Four-Year: Law Schools,Postbaccalaureate: Single program-Other,Exclusively graduate,Exclusively graduate/professional,854,379,475,15,6,9,854,854,0,0,103,54,49,1,0,1,0,0,0,0,0,0,CA50
111948,Chapman University, ,One University Dr.,Orange,CA,92866,-117.852518,33.79302,Private not-for-profit,Graduate degree or certificate offering,No,City: Midsize,Doctoral Universities: High Research Activity,Research Doctoral: STEM-dominant,High undergraduate,"Four-year, medium, highly residential",2570,983,1587,224,106,118,2570,32,1503,1035,579,186,393,62,32,30,36,13,23,8,1,7,CA40
111966,Charles R Drew University of Medicine and Science,CDU,1731 E 120th St,Los Angeles,CA,90059,-118.242791,33.925658,Private not-for-profit,Graduate degree or certificate offering,No,Suburb: Large,Special Focus Four-Year: Other Health Professions Schools,"Postbaccalaureate: Other-dominant, with Arts & Sciences",Majority graduate,"Four-year, very small, primarily nonresidential",969,260,709,7,1,6,969,0,969,0,288,79,209,2,1,1,0,0,0,0,0,0,CA43
112075,Concordia University-Irvine,Concordia University Irvine,1530 Concordia West,Irvine,CA,92612-3203,-117.812305,33.653665,Private not-for-profit,Graduate degree or certificate offering,No,City: Large,Doctoral/Professional Universities,Research Doctoral: Single program-Education,Majority graduate,"Four-year, medium, highly residential",3485,1342,2143,66,44,22,3485,3485,0,0,1092,445,647,26,16,10,22,5,17,0,0,0,CA47
112084,San Diego Christian College, ,200 Riverview Parkway,Santee,CA,92071,-116.978112,32.842404,Private not-for-profit,Graduate degree or certificate offering,No,Suburb: Large,Master's Colleges & Universities: Small Programs,"Postbaccalaureate: Education-dominant, with other professional programs",Very high undergraduate,"Four-year, very small, primarily residential",80,30,50,0,0,0,80,80,0,0,46,10,36,0,0,0,0,0,0,0,0,0,CA48
112127,Church Divinity School of the Pacific,CDSP,2451 Ridge Road,Berkeley,CA,94709-1211,-122.261122,37.876184,Private not-for-profit,Graduate degree or certificate offering,No,City: Midsize,Special Focus Four-Year: Faith-Related Institutions,Postbaccalaureate: Single program-Other,Exclusively graduate,Exclusively graduate/professional,86,38,48,2,0,2,86,86,0,0,16,5,11,0,0,0,0,0,0,0,0,0,CA12
112251,Claremont Graduate University, ,150 E Tenth St,Claremont,CA,91711-6160,-117.713703,34.103585,Private not-for-profit,Graduate degree or certificate offering,No,Suburb: Large,Doctoral Universities: High Research Activity,"Research Doctoral: Comprehensive programs, no medical/veterinary school",Exclusively graduate,Exclusively graduate/professional,2168,907,1261,449,228,221,2168,824,696,648,427,183,244,102,55,47,123,60,63,39,26,13,CA28
112260,Claremont McKenna College, ,500 E 9th St,Claremont,CA,91711-6400,-117.711188,34.102154,Private not-for-profit,Graduate degree or certificate offering,No,Suburb: Large,Baccalaureate Colleges: Arts & Sciences Focus,Postbaccalaureate: Single program-Business,Very high undergraduate,"Four-year, small, highly residential",2,1,1,0,0,0,2,2,0,0,10,8,2,1,0,1,0,0,0,0,0,0,CA28
112394,University of Silicon Valley, ,191 Baypointe Parkway,San Jose,CA,95134,-121.94087,37.414049,Private for-profit,Graduate degree or certificate offering,No,City: Large,Baccalaureate Colleges: Diverse Fields,Postbaccalaureate: Single program-Business,Very high undergraduate,"Four-year, very small, primarily residential",13,8,5,1,0,1,13,13,0,0,6,3,3,1,0,1,0,0,0,0,0,0,CA17
112525,Western University of Health Sciences,WesternU,309 E 2nd St,Pomona,CA,91766-1854,-117.747732,34.058092,Private not-for-profit,Graduate degree or certificate offering,No,Suburb: Large,Special Focus Four-Year: Medical Schools & Centers,"Postbaccalaureate: Other-dominant, with Arts & Sciences",Exclusively graduate,Exclusively graduate/professional,4221,1592,2629,78,30,48,4221,28,271,3922,236,68,168,7,3,4,0,0,0,0,0,0,CA35
113537,Dell'Arte International School of Physical Theatre, ,131 H Street,Blue Lake,CA,95525-0816,-123.988808,40.880924,Private not-for-profit,No graduate offering,No,Rural: Fringe,"Special Focus Four-Year: Arts, Music & Design Schools",Postbaccalaureate: Single program-Other,Exclusively graduate,Exclusively graduate/professional,5,3,2,0,0,0,5,0,0,5,5,3,2,0,0,0,0,0,0,0,0,0,CA02
113582,Design Institute of San Diego, ,8555 Commerce Ave,San Diego,CA,92121,-117.167374,32.880926,Private for-profit,Graduate degree or certificate offering,No,City: Large,"Special Focus Four-Year: Arts, Music & Design Schools",Not classified (Exclusively Undergraduate),Very high undergraduate,"Four-year, very small, primarily nonresidential",10,0,10,0,0,0,10,0,0,10,0,0,0,0,0,0,0,0,0,0,0,0,CA51
113698,Dominican University of California,DUofC,50 Acacia Ave,San Rafael,CA,94901-2298,-122.512051,37.981279,Private not-for-profit,Graduate degree or certificate offering,No,City: Small,Master's Colleges & Universities: Medium Programs,"Postbaccalaureate: Other-dominant, with Arts & Sciences",High undergraduate,"Four-year, small, primarily residential",497,109,388,13,4,9,497,0,483,14,166,33,133,6,2,4,0,0,0,0,0,0,CA02
113704,Dominican School of Philosophy & Theology,The Dominican School|DSPT|St. Albert's College|College of St. Albert the Great,2301 Vine Street,Berkeley,CA,94708-1816,-122.264612,37.881099,Private not-for-profit,Graduate degree or certificate offering,No,City: Midsize,Master's Colleges & Universities: Small Programs,"Postbaccalaureate: Other-dominant, with Arts & Sciences",Exclusively graduate,Exclusively graduate/professional,76,65,11,5,5,0,76,14,50,12,22,21,1,2,2,0,0,0,0,0,0,0,CA12
114114,Emperor's College of Traditional Oriental Medicine,Emperor's College,"1807 Wilshire Blvd, Ste #200",Santa Monica,CA,90403,-118.485119,34.030438,Private for-profit,Graduate degree or certificate offering,No,City: Small,Special Focus Four-Year: Other Health Professions Schools,Postbaccalaureate: Single program-Other,Exclusively graduate,Exclusively graduate/professional,303,62,241,22,5,17,303,0,0,303,49,13,36,2,0,2,0,0,0,0,0,0,CA36
114123,Empire College, ,3035 Cleveland Ave,Santa Rosa,CA,95403-2126,-122.729337,38.468052,Private for-profit,Graduate degree or certificate offering,No,City: Midsize,Baccalaureate/Associate's Colleges: Mixed Baccalaureate/Associate's,Postbaccalaureate: Single program-Other,Majority undergraduate,"Four-year, small, primarily nonresidential",95,31,64,0,0,0,95,0,0,95,11,6,5,0,0,0,0,0,0,0,0,0,CA02
114354,FIDM-Fashion Institute of Design & Merchandising-Los Angeles,FIDM LA,919 S Grand Ave,Los Angeles,CA,90015-1421,-118.25993,34.044209,Private for-profit,Graduate degree or certificate offering,No,City: Large,Baccalaureate/Associate's Colleges: Mixed Baccalaureate/Associate's,Postbaccalaureate: Single program-Business,Very high undergraduate,"Four-year, small, primarily nonresidential",49,3,46,19,1,18,49,3,45,1,26,1,25,11,0,11,0,0,0,0,0,0,CA37
114549,Fielding Graduate University,Fielding|Fielding Institute|Fielding Graduate Institute,2020 De La Vina St,Santa Barbara,CA,93105-3538,-119.717161,34.42941,Private not-for-profit,Graduate degree or certificate offering,No,City: Small,Doctoral/Professional Universities,Research Doctoral: Professional-dominant,Exclusively graduate,Exclusively graduate/professional,1416,315,1101,9,3,6,1416,274,1098,44,132,28,104,2,0,2,123,31,92,2,1,1,CA24
114585,Five Branches University, ,200 7th Avenue,Santa Cruz,CA,95062,-121.998245,36.964348,Private for-profit,Graduate degree or certificate offering,No,Suburb: Midsize,Special Focus Four-Year: Other Health Professions Schools,Postbaccalaureate: Single program-Other,Exclusively graduate,Exclusively graduate/professional,488,117,371,62,21,41,488,260,228,0,42,9,33,6,3,3,0,0,0,0,0,0,CA19
114734,Franciscan School of Theology,FST,5998 Alcala Park,San Diego,CA,92110,-117.192073,32.770816,Private not-for-profit,Graduate degree or certificate offering,No,City: Large,Special Focus Four-Year: Faith-Related Institutions,Postbaccalaureate: Single program-Other,Exclusively graduate,Exclusively graduate/professional,66,34,32,1,0,1,66,0,0,66,9,3,6,0,0,0,0,0,0,0,0,0,CA51
114813,Fresno Pacific University, ,1717 S Chestnut Ave,Fresno,CA,93702-4709,-119.735199,36.726831,Private not-for-profit,Graduate degree or certificate offering,No,City: Large,Master's Colleges & Universities: Larger Programs,"Postbaccalaureate: Education-dominant, with Arts & Sciences",High undergraduate,"Four-year, medium, primarily nonresidential",1449,349,1100,9,6,3,1449,1449,0,0,271,81,190,4,4,0,0,0,0,0,0,0,CA21
114840,Fuller Theological Seminary, ,135 N Oakland Ave,Pasadena,CA,91182,-118.140261,34.14778,Private not-for-profit,Graduate degree or certificate offering,No,City: Midsize,Special Focus Four-Year: Faith-Related Institutions,Research Doctoral: Professional-dominant,Exclusively graduate,Exclusively graduate/professional,3433,1890,1543,806,559,247,3433,2306,669,458,419,206,213,50,24,26,35,23,12,4,3,1,CA28
115083,Golden Gate University, ,536 Mission Street,San Francisco,CA,94105-2968,-122.398969,37.789374,Private not-for-profit,Graduate degree or certificate offering,No,City: Large,Master's Colleges & Universities: Larger Programs,Research Doctoral: Professional-dominant,Majority graduate,"Four-year, small, primarily nonresidential",2474,1222,1252,165,62,103,2474,345,992,1137,493,233,260,103,30,73,10,5,5,6,2,4,CA11
115214,Graduate Theological Union,GTU,2400 Ridge Rd,Berkeley,CA,94709,-122.261847,37.87554,Private not-for-profit,Graduate degree or certificate offering,No,City: Midsize,Special Focus Four-Year: Faith-Related Institutions,Research Doctoral: Single program-Other,Exclusively graduate,Exclusively graduate/professional,235,123,112,66,40,26,235,6,44,185,16,10,6,3,3,0,20,12,8,8,3,5,CA12
115728,Holy Names University,Holy Names College,3500 Mountain Blvd,Oakland,CA,94619-1699,-122.187804,37.802276,Private not-for-profit,Graduate degree or certificate offering,No,City: Large,Master's Colleges & Universities: Small Programs,"Postbaccalaureate: Education-dominant, with Arts & Sciences",High undergraduate,"Four-year, very small, highly residential",400,82,318,15,3,12,400,305,95,0,90,20,70,2,1,1,0,0,0,0,0,0,CA12
115746,Pacifica Graduate Institute, ,249 Lambert Rd,Carpinteria,CA,93013,-119.580414,34.420881,Private for-profit,Graduate degree or certificate offering,No,Rural: Fringe,Special Focus Four-Year: Other Health Professions Schools,Research Doctoral: Professional-dominant,Exclusively graduate,Exclusively graduate/professional,980,274,706,19,5,14,980,0,0,980,141,37,104,6,1,5,74,17,57,2,1,1,CA24
115755,California State Polytechnic University-Humboldt, ,1 Harpst Street,Arcata,CA,95521-8299,-124.078293,40.877481,Public,Graduate degree or certificate offering,No,Town: Remote,Master's Colleges & Universities: Larger Programs,Postbaccalaureate: Comprehensive programs,Very high undergraduate,"Four-year, medium, primarily residential",675,216,459,12,7,5,675,364,309,2,195,68,127,6,2,4,0,0,0,0,0,0,CA02
115773,Humphreys University-Stockton and Modesto Campuses, ,6650 Inglewood Ave,Stockton,CA,95207-3896,-121.316918,38.011489,Private not-for-profit,Graduate degree or certificate offering,No,City: Large,Master's Colleges & Universities: Small Programs,"Postbaccalaureate: Education-dominant, with Arts & Sciences",Majority undergraduate,"Four-year, very small, primarily nonresidential",247,74,173,1,0,1,247,247,0,0,95,28,67,0,0,0,0,0,0,0,0,0,CA09
116226,Interior Designers Institute, ,1061 Camelback Street,Newport Beach,CA,92660,-117.865722,33.641393,Private for-profit,Graduate degree or certificate offering,No,City: Small,"Special Focus Four-Year: Arts, Music & Design Schools",Postbaccalaureate: Single program-Other,Very high undergraduate,"Four-year, very small, primarily nonresidential",6,2,4,0,0,0,6,0,0,6,6,2,4,0,0,0,0,0,0,0,0,0,CA47
116846,American Jewish University,AJU,15600 Mulholland Dr,Los Angeles,CA,90077-1519,-118.471706,34.128153,Private not-for-profit,Graduate degree or certificate offering,No,City: Large,Baccalaureate Colleges: Arts & Sciences Focus,"Postbaccalaureate: Education-dominant, with other professional programs",Majority graduate,"Four-year, very small, highly residential",65,25,40,0,0,0,65,65,0,0,10,4,6,0,0,0,0,0,0,0,0,0,CA32
117104,Life Pacific University,LIFE Bible College,1100 W. Covina Blvd.,San Dimas,CA,91773-3298,-117.829388,34.098705,Private not-for-profit,Graduate degree or certificate offering,No,Suburb: Large,Baccalaureate Colleges: Diverse Fields,Postbaccalaureate: Single program-Other,High undergraduate,"Four-year, very small, highly residential",149,79,70,7,5,2,149,149,0,0,33,21,12,1,0,1,0,0,0,0,0,0,CA31
117140,University of La Verne,La Verne,1950 Third St,La Verne,CA,91750-4401,-117.773262,34.100855,Private not-for-profit,Graduate degree or certificate offering,No,Suburb: Large,Doctoral/Professional Universities,Research Doctoral: Professional-dominant,Majority undergraduate,"Four-year, medium, primarily nonresidential",3534,1165,2369,348,174,174,3534,3534,0,0,975,336,639,215,102,113,50,13,37,2,1,1,CA31
117168,Laguna College of Art and Design,LCAD,2222 Laguna Canyon Rd,Laguna Beach,CA,92651,-117.772564,33.561448,Private not-for-profit,Graduate degree or certificate offering,No,Rural: Fringe,"Special Focus Four-Year: Arts, Music & Design Schools",Postbaccalaureate: Single program-Other,Very high undergraduate,"Four-year, very small, primarily nonresidential",39,18,21,5,3,2,39,39,0,0,17,8,9,2,1,1,0,0,0,0,0,0,CA47
117520,Life Chiropractic College West,Life West,25001 Industrial Blvd,Hayward,CA,94545-2800,-122.117619,37.638099,Private not-for-profit,Graduate degree or certificate offering,No,Suburb: Large,Special Focus Four-Year: Other Health Professions Schools,Postbaccalaureate: Single program-Other,Exclusively graduate,Exclusively graduate/professional,733,401,332,16,10,6,733,0,733,0,0,0,0,0,0,0,0,0,0,0,0,0,CA14
117557,Lincoln University, ,401 15th Street,Oakland,CA,94612-2801,-122.269745,37.804788,Private not-for-profit,Graduate degree or certificate offering,No,City: Large,Special Focus Four-Year: Business & Management Schools,Postbaccalaureate: Single program-Business,Majority graduate,"Four-year, very small, primarily nonresidential",374,217,157,349,198,151,374,0,0,374,79,41,38,72,35,37,3,2,1,3,2,1,CA12
117575,Southern California Seminary, ,2075 E. Madison Avenue,El Cajon,CA,92019-1108,-116.905461,32.799614,Private not-for-profit,Graduate degree or certificate offering,No,Suburb: Large,Baccalaureate Colleges: Diverse Fields,"Postbaccalaureate: Other-dominant, with Arts & Sciences",Majority graduate,"Four-year, very small, primarily nonresidential",168,98,70,8,2,6,168,76,69,23,17,8,9,1,0,1,0,0,0,0,0,0,CA51
117627,La Sierra University, ,4500 Riverwalk Parkway,Riverside,CA,92505-8247,-117.500054,33.910704,Private not-for-profit,Graduate degree or certificate offering,No,City: Large,Master's Colleges & Universities: Medium Programs,Research Doctoral: Professional-dominant,High undergraduate,"Four-year, small, highly residential",594,219,375,99,46,53,594,1,0,593,114,45,69,21,9,12,6,2,4,2,1,1,CA41
117636,Loma Linda University, ,11139 Anderson Street,Loma Linda,CA,92350,-117.260605,34.051241,Private not-for-profit,Graduate degree or certificate offering,No,Suburb: Large,Doctoral Universities: High Research Activity,Research Doctoral: Professional-dominant,Majority graduate,"Four-year, medium, highly residential",3568,1333,2235,331,146,185,3568,263,933,2372,427,120,307,25,8,17,82,17,65,4,1,3,CA23
117672,Southern California University of Health Sciences,Los Angeles College of Chiropractic,16200 East Amber Valley Drive,Whittier,CA,90604,-117.983401,33.922966,Private not-for-profit,Graduate degree or certificate offering,No,Suburb: Large,Special Focus Four-Year: Other Health Professions Schools,Postbaccalaureate: Single program-Other,Majority graduate,"Four-year, very small, primarily nonresidential",1029,539,490,23,18,5,1029,191,818,20,46,18,28,0,0,0,0,0,0,0,0,0,CA38
117751,The Master's University and Seminary, ,21726 Placerita Canyon Road,Santa Clarita,CA,91321-1200,-118.518193,34.381755,Private not-for-profit,Graduate degree or certificate offering,No,Suburb: Large,Doctoral/Professional Universities,Research Doctoral: Single program-Other,High undergraduate,"Four-year, small, primarily residential",1151,974,177,35,32,3,1151,122,0,1029,169,125,44,13,13,0,27,27,0,1,1,0,CA27
117946,Loyola Marymount University, ,One Lmu Drive,Los Angeles,CA,90045-2659,-118.415744,33.97085,Private not-for-profit,Graduate degree or certificate offering,No,City: Large,Doctoral Universities: High Research Activity,Research Doctoral: Single program-Education,Majority undergraduate,"Four-year, medium, highly residential",3389,1247,2142,300,134,166,3389,3267,120,2,720,239,481,69,30,39,14,3,11,0,0,0,CA36
118541,Marymount California University, ,30800 Palos Verdes Drive East,Rancho Palos Verdes,CA,90275-6299,-118.333371,33.734887,Private not-for-profit,Graduate degree or certificate offering,No,Suburb: Large,Baccalaureate Colleges: Diverse Fields,"Postbaccalaureate: Business-dominant, with Arts & Sciences",High undergraduate,"Four-year, very small, highly residential",78,40,38,9,4,5,78,70,0,8,33,20,13,4,2,2,0,0,0,0,0,0,CA36
118888,Mills College, ,5000 MacArthur Blvd,Oakland,CA,94613,-122.182294,37.781425,Private not-for-profit,Graduate degree or certificate offering,No,City: Large,Master's Colleges & Universities: Medium Programs,Research Doctoral: Single program-Education,Majority undergraduate,"Four-year, very small, highly residential",394,79,315,10,4,6,394,38,356,0,130,27,103,0,0,0,8,2,6,0,0,0,CA12
119058,Middlebury Institute of International Studies at Monterey,MIIS,460 Pierce Street,Monterey,CA,93940,-121.897325,36.599736,Private not-for-profit,Graduate degree or certificate offering,No,Suburb: Midsize,Master's Colleges & Universities: Larger Programs,Postbaccalaureate: Comprehensive programs,Majority graduate,"Four-year, very small, primarily nonresidential",765,259,506,208,54,154,765,765,0,0,302,104,198,88,23,65,0,0,0,0,0,0,CA19
119173,Mount Saint Mary's University, ,12001 Chalon Rd,Los Angeles,CA,90049-1599,-118.482879,34.085315,Private not-for-profit,Graduate degree or certificate offering,No,City: Large,Master's Colleges & Universities: Larger Programs,"Postbaccalaureate: Other-dominant, with Arts & Sciences",Majority undergraduate,"Four-year, small, primarily residential",892,193,699,9,2,7,892,270,491,131,157,22,135,2,1,1,0,0,0,0,0,0,CA32
119605,National University, ,11255 North Torrey Pines Road,La Jolla,CA,92037-1011,-117.243026,32.909894,Private not-for-profit,Graduate degree or certificate offering,No,City: Large,Master's Colleges & Universities: Larger Programs,Postbaccalaureate: Comprehensive programs,Majority graduate,"Four-year, large, primarily nonresidential",15659,4834,10825,84,44,40,15659,2798,3395,9466,4339,1406,2933,55,25,30,0,0,0,0,0,0,CA50
119678,Naval Postgraduate School, ,1 University Circle,Monterey,CA,93943,-121.874248,36.597159,Public,Graduate degree or certificate offering,No,Suburb: Midsize,Master's Colleges & Universities: Larger Programs,Research Doctoral: STEM-dominant,Exclusively graduate,Exclusively graduate/professional,4007,3165,842,208,194,14,4007,1999,0,2008,1211,970,241,77,74,3,13,11,2,0,0,0,CA19
119775,Newschool of Architecture and Design, ,1249 F St,San Diego,CA,92101,-117.153305,32.71331,Private for-profit,Graduate degree or certificate offering,No,City: Large,Master's Colleges & Universities: Small Programs,"Postbaccalaureate: Other-dominant, with Arts & Sciences",High undergraduate,"Four-year, very small, primarily nonresidential",125,85,40,10,7,3,125,125,0,0,41,26,15,6,5,1,0,0,0,0,0,0,CA50
120166,San Francisco Bay University,SFBU,161 Mission Falls Lane,Fremont,CA,94539,-121.925953,37.477991,Private not-for-profit,Graduate degree or certificate offering,No,Suburb: Large,Special Focus Four-Year: Engineering and Other Technology-Related Schools,"Postbaccalaureate: Other-dominant, with Arts & Sciences",Majority graduate,"Four-year, very small, highly residential",47,19,28,40,16,24,47,0,0,47,14,7,7,12,5,7,0,0,0,0,0,0,CA17
120184,Notre Dame de Namur University,NDNU,1500 Ralston Ave,Belmont,CA,94002-1908,-122.284794,37.517111,Private not-for-profit,Graduate degree or certificate offering,No,Suburb: Large,Master's Colleges & Universities: Medium Programs,Research Doctoral: Single program-Other,Majority graduate,"Four-year, very small, primarily residential",459,107,352,33,9,24,459,24,189,246,190,44,146,19,8,11,1,0,1,0,0,0,CA15
120403,Otis College of Art and Design,"Otis Art Institute, Otis Parsons, Otis/Parsons",9045 Lincoln Blvd,Los Angeles,CA,90045-3505,-118.416615,33.956607,Private not-for-profit,Graduate degree or certificate offering,No,City: Large,"Special Focus Four-Year: Arts, Music & Design Schools","Postbaccalaureate: Other-dominant, with Arts & Sciences",Very high undergraduate,"Four-year, small, primarily residential",84,15,69,20,4,16,84,0,44,40,29,6,23,14,4,10,0,0,0,0,0,0,CA36
120537,Hope International University,Hope|HIU|College of Arts and Sciences|College of Business and Management|College of Education|Pacific Christian of Ministry and Biblical Studies|College of Psychology and Counseling|Fullerton|Orange County|California|,2500 E Nutwood Ave,Fullerton,CA,92831-3199,-117.88573,33.87616,Private not-for-profit,Graduate degree or certificate offering,No,Suburb: Large,Master's Colleges & Universities: Medium Programs,"Postbaccalaureate: Other-dominant, with other professional programs",Majority undergraduate,"Four-year, small, primarily residential",637,200,437,2,0,2,637,378,0,259,171,59,112,1,0,1,0,0,0,0,0,0,CA45
120698,Palo Alto University,Pacific Graduate School of Psychology,1791 Arastradero Rd,Palo Alto,CA,94304-1337,-122.187437,37.382216,Private not-for-profit,Graduate degree or certificate offering,No,Rural: Fringe,Special Focus Four-Year: Other Health Professions Schools,"Postbaccalaureate: Other-dominant, with Arts & Sciences",Majority graduate,"Four-year, very small, primarily nonresidential",1232,226,1006,37,6,31,1232,304,92,836,220,43,177,9,1,8,0,0,0,0,0,0,CA16
120768,Pacific Oaks College, ,45 W Eureka Street,Pasadena,CA,91103,-118.151323,34.153382,Private not-for-profit,Graduate degree or certificate offering,No,City: Midsize,Master's Colleges & Universities: Medium Programs,"Postbaccalaureate: Other-dominant, with other professional programs",Majority graduate,"Four-year, very small, primarily nonresidential",967,125,842,1,1,0,967,471,348,148,247,34,213,1,0,1,0,0,0,0,0,0,CA28
120795,Pacific School of Religion, ,1798 Scenic Ave,Berkeley,CA,94709,-122.263155,37.87669,Private not-for-profit,Graduate degree or certificate offering,No,City: Midsize,Special Focus Four-Year: Faith-Related Institutions,Postbaccalaureate: Single program-Other,Exclusively graduate,Exclusively graduate/professional,126,55,71,5,4,1,126,126,0,0,25,9,16,3,1,2,0,0,0,0,0,0,CA12
120838,Pacific States University, ,3424 Wilshire Blvd. 12th floor,Los Angeles,CA,90010-2263,-118.298408,34.061315,Private not-for-profit,Graduate degree or certificate offering,No,City: Large,Special Focus Four-Year: Business & Management Schools,"Postbaccalaureate: Business-dominant, with Arts & Sciences",Majority graduate,"Four-year, very small, primarily nonresidential",29,17,12,25,15,10,29,0,0,29,7,4,3,7,4,3,0,0,0,0,0,0,CA34
120865,Pacific Union College,PUC,One Angwin Ave,Angwin,CA,94508-9707,-122.440308,38.570585,Private not-for-profit,Graduate degree or certificate offering,No,Rural: Fringe,Baccalaureate Colleges: Diverse Fields,Not classified (Exclusively Undergraduate),Very high undergraduate,"Four-year, very small, highly residential",30,6,24,0,0,0,30,24,2,4,1,0,1,0,0,0,0,0,0,0,0,0,CA04
120883,University of the Pacific,Pacific | UOP | University of Pacific | Pacific University | U. Pacific | Univ. of Pacific | U. of Pacific,3601 Pacific Ave,Stockton,CA,95211-0197,-121.312301,37.981424,Private not-for-profit,Graduate degree or certificate offering,No,City: Large,Doctoral/Professional Universities,Research Doctoral: Professional-dominant,Majority undergraduate,"Four-year, medium, highly residential",2965,1088,1877,210,109,101,2965,23,0,2942,513,162,351,52,31,21,93,24,69,7,5,2,CA09
121150,Pepperdine University, ,24255 Pacific Coast Hwy,Malibu,CA,90263,-118.707077,34.037786,Private not-for-profit,Graduate degree or certificate offering,No,Suburb: Large,Doctoral/Professional Universities,Research Doctoral: Single program-Education,Majority graduate,"Four-year, medium, highly residential",8381,2665,5716,781,314,467,8381,8193,94,94,1956,652,1304,371,150,221,68,24,44,3,1,2,CA32
121309,Point Loma Nazarene University,PLNU,3900 Lomaland Dr,San Diego,CA,92106-2899,-117.250265,32.718391,Private not-for-profit,Graduate degree or certificate offering,No,City: Large,Master's Colleges & Universities: Larger Programs,"Postbaccalaureate: Education-dominant, with Arts & Sciences",High undergraduate,"Four-year, medium, primarily residential",1908,507,1401,25,7,18,1908,210,1076,622,401,108,293,15,1,14,0,0,0,0,0,0,CA50
121628,Pardee RAND Graduate School, ,1776 Main St,Santa Monica,CA,90401-3208,-118.490655,34.00973,Private not-for-profit,Graduate degree or certificate offering,No,City: Small,Special Focus Four-Year: Other Special Focus Institutions,Research Doctoral: Single program-Other,Exclusively graduate,Exclusively graduate/professional,125,69,56,26,13,13,125,0,32,93,15,10,5,4,3,1,10,7,3,3,2,1,CA36
121691,University of Redlands, ,1200 E. Colton Ave,Redlands,CA,92373-0999,-117.163218,34.064218,Private not-for-profit,Graduate degree or certificate offering,No,City: Small,Master's Colleges & Universities: Larger Programs,Research Doctoral: Single program-Education,Majority undergraduate,"Four-year, medium, highly residential",2044,661,1383,43,19,24,2044,1159,741,144,979,311,668,33,17,16,9,2,7,1,1,0,CA33
122117,Dongguk University Los Angeles, ,440 Shatto Pl,Los Angeles,CA,90020-1704,-118.289523,34.06597,Private not-for-profit,Graduate degree or certificate offering,No,City: Large,Special Focus Four-Year: Other Health Professions Schools,Postbaccalaureate: Single program-Other,Majority graduate,Exclusively graduate/professional,183,86,97,79,42,37,183,0,0,183,14,7,7,7,4,3,0,0,0,0,0,0,CA34
122296,Samuel Merritt University, ,3100 Telegraph Avenue,Oakland,CA,94609,-122.266331,37.82029,Private not-for-profit,Graduate degree or certificate offering,No,City: Large,Special Focus Four-Year: Other Health Professions Schools,Postbaccalaureate: Single program-Other,Majority graduate,"Four-year, small, primarily nonresidential",1526,401,1125,0,0,0,1526,449,0,1077,265,49,216,0,0,0,0,0,0,0,0,0,CA12
122409,San Diego State University, ,5500 Campanile Dr,San Diego,CA,92182-0001,-117.071228,32.77525,Public,Graduate degree or certificate offering,No,City: Large,Doctoral Universities: High Research Activity,Research Doctoral: Professional-dominant,High undergraduate,"Four-year, large, primarily nonresidential",5426,1934,3492,520,256,264,5426,2795,2311,320,1556,564,992,191,99,92,62,23,39,11,6,5,CA51
122436,University of San Diego,USD,5998 Alcala Park,San Diego,CA,92110-2492,-117.192073,32.770816,Private not-for-profit,Graduate degree or certificate offering,No,City: Large,Doctoral Universities: High Research Activity,Research Doctoral: Professional-dominant,Majority undergraduate,"Four-year, medium, primarily residential",3991,1659,2332,122,56,66,3991,1100,0,2891,1121,478,643,66,26,40,28,12,16,3,2,1,CA51
122454,San Francisco Art Institute,SFAI,800 Chestnut St,San Francisco,CA,94133-2299,-122.417,37.803575,Private not-for-profit,Graduate degree or certificate offering,No,City: Large,"Special Focus Four-Year: Arts, Music & Design Schools","Postbaccalaureate: Other-dominant, with Arts & Sciences",Majority undergraduate,"Four-year, very small, primarily nonresidential",35,6,29,4,2,2,35,24,0,11,14,3,11,3,1,2,0,0,0,0,0,0,CA11
122506,San Francisco Conservatory of Music,SFCM,50 Oak Street,San Francisco,CA,94102-6011,-122.420292,37.775543,Private not-for-profit,Graduate degree or certificate offering,No,City: Large,"Special Focus Four-Year: Arts, Music & Design Schools",Postbaccalaureate: Single program-Other,Majority undergraduate,"Four-year, very small, highly residential",170,73,97,78,27,51,170,0,0,170,66,29,37,35,14,21,0,0,0,0,0,0,CA11
122597,San Francisco State University, ,1600 Holloway Ave,San Francisco,CA,94132,-122.476799,37.721224,Public,Graduate degree or certificate offering,No,City: Large,Doctoral Universities: High Research Activity,Research Doctoral: Single program-Education,High undergraduate,"Four-year, large, primarily nonresidential",3893,1356,2537,346,131,215,3893,3064,813,16,1010,316,694,134,47,87,0,0,0,0,0,0,CA11
122612,University of San Francisco, ,2130 Fulton St,San Francisco,CA,94117-1080,-122.450477,37.776618,Private not-for-profit,Graduate degree or certificate offering,No,City: Large,Doctoral/Professional Universities,Research Doctoral: Single program-Education,Majority undergraduate,"Four-year, medium, primarily residential",5043,1740,3303,750,322,428,5043,4222,813,8,1634,560,1074,348,143,205,25,8,17,4,0,4,CA11
122649,San Joaquin College of Law,SJCL,901 Fifth St,Clovis,CA,93612-1312,-119.697657,36.82448,Private not-for-profit,Graduate degree or certificate offering,No,Suburb: Large,Special Focus Four-Year: Law Schools,Postbaccalaureate: Single program-Other,Exclusively graduate,Exclusively graduate/professional,183,62,121,0,0,0,183,183,0,0,0,0,0,0,0,0,0,0,0,0,0,0,CA20
122728,William Jessup University,San Jose Christian College,2121 University Avenue,Rocklin,CA,95765-3707,-121.292312,38.819728,Private not-for-profit,Graduate degree or certificate offering,No,Rural: Fringe,Master's Colleges & Universities: Medium Programs,"Postbaccalaureate: Business-dominant, with other professional programs",Majority undergraduate,"Four-year, small, primarily residential",693,297,396,253,134,119,693,119,15,559,221,91,130,68,39,29,0,0,0,0,0,0,CA03
122755,San Jose State University, ,One Washington Square,San Jose,CA,95192-0001,-121.880621,37.336569,Public,Graduate degree or certificate offering,No,City: Large,Master's Colleges & Universities: Larger Programs,Research Doctoral: Single program-Education,High undergraduate,"Four-year, large, primarily nonresidential",10119,3662,6457,1975,898,1077,10119,9488,618,13,2906,1063,1843,710,391,319,0,0,0,0,0,0,CA18
122931,Santa Clara University,SCU,500 El Camino Real,Santa Clara,CA,95053,-121.93784,37.348362,Private not-for-profit,Graduate degree or certificate offering,No,City: Midsize,Doctoral/Professional Universities,Research Doctoral: STEM-dominant,Majority undergraduate,"Four-year, medium, highly residential",3558,1635,1923,836,419,417,3558,527,0,3031,895,400,495,273,117,156,8,7,1,6,6,0,CA17
123095,Saybrook University, ,55 W Eureka Street,Pasadena,CA,91103,-118.152155,34.153103,Private not-for-profit,Graduate degree or certificate offering,No,City: Midsize,Doctoral/Professional Universities,Research Doctoral: Humanities/social sciences-dominant,Exclusively graduate,Exclusively graduate/professional,938,172,766,14,0,14,938,250,688,0,30,5,25,0,0,0,41,12,29,3,0,3,CA28
123165,Scripps College, ,1030 North Columbia Avenue,Claremont,CA,91711-3905,-117.711294,34.104147,Private not-for-profit,Graduate degree or certificate offering,No,Suburb: Large,Baccalaureate Colleges: Arts & Sciences Focus,Not classified (Exclusively Undergraduate),Very high undergraduate,"Four-year, very small, highly residential",55,22,33,0,0,0,55,0,0,55,0,0,0,0,0,0,0,0,0,0,0,0,CA28
123280,Shasta Bible College and Graduate School, ,2951 Goodwater Ave.,Redding,CA,96002,-122.314419,40.566034,Private not-for-profit,Graduate degree or certificate offering,No,City: Small,Special Focus Four-Year: Faith-Related Institutions,"Postbaccalaureate: Other-dominant, with other professional programs",High undergraduate,"Four-year, very small, primarily nonresidential",18,10,8,0,0,0,18,13,5,0,3,2,1,0,0,0,0,0,0,0,0,0,CA01
123448,Trinity Law School,Trinity Law School,2200 N Grand Ave,Santa Ana,CA,92705,-117.852059,33.766071,Private not-for-profit,Graduate degree or certificate offering,No,City: Large,Special Focus Four-Year: Law Schools,Postbaccalaureate: Single program-Other,Exclusively graduate,Exclusively graduate/professional,562,182,380,2,1,1,562,381,157,24,72,21,51,0,0,0,0,0,0,0,0,0,CA46
123457,Simpson University, ,2211 College View Drive,Redding,CA,96003-8606,-122.332981,40.61334,Private not-for-profit,Graduate degree or certificate offering,No,City: Small,Baccalaureate Colleges: Arts & Sciences Focus,"Postbaccalaureate: Education-dominant, with other professional programs",Very high undergraduate,"Four-year, very small, primarily residential",284,123,161,0,0,0,284,20,215,49,36,11,25,0,0,0,0,0,0,0,0,0,CA01
123554,Saint Mary's College of California,St. Marys College of California | St Marys College of California,1928 Saint Marys Road,Moraga,CA,94575,-122.109031,37.840731,Private not-for-profit,Graduate degree or certificate offering,No,Suburb: Large,Master's Colleges & Universities: Larger Programs,Research Doctoral: Single program-Education,High undergraduate,"Four-year, medium, highly residential",1366,516,850,32,17,15,1366,0,0,1366,349,140,209,27,17,10,7,0,7,0,0,0,CA10
123572,Sonoma State University, ,1801 E Cotati Ave,Rohnert Park,CA,94928-3609,-122.677066,38.340274,Public,Graduate degree or certificate offering,No,Suburb: Large,Master's Colleges & Universities: Larger Programs,Postbaccalaureate: Comprehensive programs,Very high undergraduate,"Four-year, medium, primarily residential",897,265,632,28,9,19,897,545,351,1,207,58,149,10,4,6,0,0,0,0,0,0,CA04
123633,South Baylo University, ,1126 N Brookhurst St,Anaheim,CA,92801-1701,-117.958416,33.848291,Private not-for-profit,Graduate degree or certificate offering,No,City: Large,Special Focus Four-Year: Other Health Professions Schools,Postbaccalaureate: Single program-Other,Exclusively graduate,Exclusively graduate/professional,348,120,228,87,29,58,348,348,0,0,59,18,41,17,7,10,0,0,0,0,0,0,CA46
123651,Vanguard University of Southern California,Vanguard University,55 Fair Dr,Costa Mesa,CA,92626,-117.900911,33.662686,Private not-for-profit,Graduate degree or certificate offering,No,City: Midsize,Master's Colleges & Universities: Medium Programs,"Postbaccalaureate: Other-dominant, with Arts & Sciences",Very high undergraduate,"Four-year, small, highly residential",427,129,298,4,1,3,427,12,301,114,101,26,75,0,0,0,0,0,0,0,0,0,CA47
123916,Starr King School for the Ministry, ,5000 MacArthur Blvd,Oakland,CA,94613-1209,-122.182294,37.781425,Private not-for-profit,Graduate degree or certificate offering,No,City: Large,Special Focus Four-Year: Faith-Related Institutions,"Postbaccalaureate: Other-dominant, with Arts & Sciences",Exclusively graduate,Exclusively graduate/professional,127,37,90,0,0,0,127,127,0,0,24,8,16,0,0,0,0,0,0,0,0,0,CA12
123943,Marshall B Ketchum University,formerly Southern California College of Optometry,2575 Yorba Linda Blvd,Fullerton,CA,92831-1699,-117.886229,33.889348,Private not-for-profit,Graduate degree or certificate offering,No,Suburb: Large,Special Focus Four-Year: Other Health Professions Schools,"Postbaccalaureate: Other-dominant, with Arts & Sciences",Exclusively graduate,Exclusively graduate/professional,759,254,505,28,9,19,759,13,746,0,40,17,23,0,0,0,0,0,0,0,0,0,CA45
123952,Southern California Institute of Architecture,SCI-Arc,960 E. 3rd Street,Los Angeles,CA,90013-1822,-118.232799,34.044215,Private not-for-profit,Graduate degree or certificate offering,No,City: Large,Special Focus Four-Year: Other Special Focus Institutions,"Postbaccalaureate: Other-dominant, with Arts & Sciences",Majority undergraduate,"Four-year, very small, primarily nonresidential",354,192,162,221,117,104,354,0,0,354,106,66,40,68,40,28,0,0,0,0,0,0,CA34
123961,University of Southern California,USC,University Park,Los Angeles,CA,90089,-118.284169,34.021281,Private not-for-profit,Graduate degree or certificate offering,No,City: Large,Doctoral Universities: Very High Research Activity,"Research Doctoral: Comprehensive programs, with medical/veterinary school",Majority graduate,"Four-year, large, primarily residential",30328,13254,17074,8910,4894,4016,30328,21409,6878,2041,9128,4034,5094,3385,1896,1489,768,386,382,234,143,91,CA37
123970,Southwestern Law School, ,3050 Wilshire Boulevard,Los Angeles,CA,90010-1106,-118.288375,34.061558,Private not-for-profit,Graduate degree or certificate offering,No,City: Large,Special Focus Four-Year: Law Schools,Postbaccalaureate: Single program-Other,Exclusively graduate,Exclusively graduate/professional,905,366,539,28,9,19,905,0,0,905,4,3,1,2,1,1,0,0,0,0,0,0,CA34
124283,Claremont School of Theology, ,1325 N College Ave,Claremont,CA,91711-3199,-117.715256,34.107602,Private not-for-profit,Graduate degree or certificate offering,No,Suburb: Large,Special Focus Four-Year: Faith-Related Institutions,Research Doctoral: Single program-Other,Exclusively graduate,Exclusively graduate/professional,333,193,140,57,38,19,333,333,0,0,60,30,30,5,2,3,31,21,10,11,11,0,CA28
124487,Epic Bible College & Graduate School,Trinity Life Bible College,4330 Auburn Boulevard,Sacramento,CA,95841,-121.362642,38.645152,Private not-for-profit,Graduate degree or certificate offering,No,Suburb: Large,nan,nan,nan,nan,60,40,20,5,5,0,60,14,41,5,9,6,3,2,2,0,0,0,0,0,0,0,CA06
125037,The Santa Barbara and Ventura Colleges of Law at Ventura, ,4475 Market St,Ventura,CA,93003,-119.232988,34.25747,Private not-for-profit,Graduate degree or certificate offering,No,City: Midsize,Special Focus Four-Year: Law Schools,Postbaccalaureate: Single program-Other,Exclusively graduate,Exclusively graduate/professional,297,100,197,1,1,0,297,76,148,73,14,3,11,0,0,0,0,0,0,0,0,0,CA24
125231,Walden University, ,"100 Washington Avenue South, Suite 900",Minneapolis,MN,55401,-93.265738,44.98125,Private for-profit,Graduate degree or certificate offering,No,City: Large,Doctoral/Professional Universities,Research Doctoral: Professional-dominant,Majority graduate,"Four-year, large, primarily nonresidential",64337,12191,52146,1259,288,971,64337,64337,0,0,8948,1532,7416,177,30,147,1641,510,1131,58,19,39,MN05
125718,Westminster Theological Seminary in California,Westminster Seminary California,1725 Bear Valley Parkway,Escondido,CA,92027,-117.046371,33.121447,Private not-for-profit,Graduate degree or certificate offering,No,Suburb: Large,Special Focus Four-Year: Faith-Related Institutions,Postbaccalaureate: Single program-Other,Exclusively graduate,Exclusively graduate/professional,145,125,20,29,26,3,145,0,0,145,36,33,3,6,6,0,0,0,0,0,0,0,CA50
125763,Whittier College, ,13406 E Philadelphia Street,Whittier,CA,90601,-118.032299,33.978773,Private not-for-profit,Graduate degree or certificate offering,No,Suburb: Large,Baccalaureate Colleges: Arts & Sciences Focus,"Postbaccalaureate: Education-dominant, with other professional programs",Very high undergraduate,"Four-year, small, highly residential",102,30,72,0,0,0,102,0,102,0,24,7,17,0,0,0,0,0,0,0,0,0,CA38
125897,Woodbury University, ,7500 Glenoaks Blvd,Burbank,CA,91504-1052,-118.341147,34.208011,Private not-for-profit,Graduate degree or certificate offering,No,City: Large,Master's Colleges & Universities: Small Programs,"Postbaccalaureate: Business-dominant, with Arts & Sciences",Very high undergraduate,"Four-year, small, primarily nonresidential",129,56,73,22,9,13,129,121,8,0,50,24,26,5,3,2,0,0,0,0,0,0,CA30
126012,The Wright Institute, ,2728 Durant Ave,Berkeley,CA,94704-1796,-122.253168,37.868221,Private not-for-profit,Graduate degree or certificate offering,No,City: Midsize,Special Focus Four-Year: Other Health Professions Schools,Postbaccalaureate: Single program-Other,Exclusively graduate,Exclusively graduate/professional,565,118,447,22,3,19,565,0,0,565,115,18,97,5,0,5,0,0,0,0,0,0,CA12
126049,Thomas Jefferson School of Law, ,701 B Street - Suite 110,San Diego,CA,92101,-117.157862,32.717595,Private not-for-profit,Graduate degree or certificate offering,No,City: Large,Special Focus Four-Year: Law Schools,Postbaccalaureate: Single program-Other,Exclusively graduate,Exclusively graduate/professional,285,120,165,3,1,2,285,25,0,260,9,3,6,1,0,1,0,0,0,0,0,0,CA50
126182,Adams State University, ,208 Edgemont Blvd,Alamosa,CO,81101,-105.879642,37.473636,Public,Graduate degree or certificate offering,No,Town: Remote,Master's Colleges & Universities: Larger Programs,Research Doctoral: Single program-Other,Majority undergraduate,"Four-year, small, primarily residential",1635,486,1149,8,4,4,1635,620,1004,11,391,113,278,2,0,2,7,2,5,0,0,0,CO03
126562,University of Colorado Denver/Anschutz Medical Campus,University of Colorado Denver  University of Colorado Anschutz Medical Campus    UCD,"1380 Lawrence Street, Lawrence Street Center, Suite 1400",Denver,CO,80217-3364,-104.837722,39.745149,Public,Graduate degree or certificate offering,No,City: Large,Doctoral Universities: Very High Research Activity,Research Doctoral: STEM-dominant,Majority undergraduate,"Four-year, large, primarily nonresidential",11762,4187,7575,739,333,406,11762,4445,5437,1880,2029,709,1320,179,88,91,165,57,108,11,4,7,CO06
126580,University of Colorado Colorado Springs,UCCS,1420 Austin Bluffs Parkway,Colorado Springs,CO,80918,-104.800296,38.892735,Public,Graduate degree or certificate offering,No,City: Large,Doctoral Universities: High Research Activity,Research Doctoral: STEM-dominant,High undergraduate,"Four-year, medium, primarily nonresidential",2645,1068,1577,114,80,34,2645,1000,768,877,569,241,328,22,14,8,30,22,8,9,7,2,CO05
126614,University of Colorado Boulder,U of Colorado|Univ of Colorado|University of Colorado|U of CO|Univ of CO|University of CO|Boulder|CU|CU-Boulder|UCB|CUB|Colorado|Colorado University|U of Colo|Univ of Colo|University of Colo|Colo|Buffs|Buffalos|Buffaloes|CU at Boulder|Golden Buffs|University of Colorado at Boulder,Regent Drive at Broadway,Boulder,CO,80309-0017,-105.270823,40.008781,Public,Graduate degree or certificate offering,No,City: Midsize,Doctoral Universities: Very High Research Activity,"Research Doctoral: Comprehensive programs, no medical/veterinary school",High undergraduate,"Four-year, large, primarily residential",8417,4745,3672,1364,948,416,8417,430,1000,6987,1745,1021,724,304,205,99,395,252,143,88,59,29,CO02
126669,Colorado Christian University,CCU,8787 West Alameda Avenue,Lakewood,CO,80226,-105.09456,39.71388,Private not-for-profit,Graduate degree or certificate offering,No,City: Midsize,Master's Colleges & Universities: Larger Programs,"Postbaccalaureate: Other-dominant, with other professional programs",High undergraduate,"Four-year, medium, primarily nonresidential",1698,448,1250,1,0,1,1698,1502,169,27,330,93,237,0,0,0,0,0,0,0,0,0,CO07
126678,Colorado College, ,14. E Cache La Poudre St.,Colorado Springs,CO,80903,-104.822697,38.84886,Private not-for-profit,Graduate degree or certificate offering,No,City: Large,Baccalaureate Colleges: Arts & Sciences Focus,Postbaccalaureate: Single program-Education,Very high undergraduate,"Four-year, small, highly residential",31,8,23,0,0,0,31,17,13,1,11,2,9,0,0,0,0,0,0,0,0,0,CO05
126775,Colorado School of Mines,Mines,1500 Illinois St,Golden,CO,80401,-105.223364,39.751443,Public,Graduate degree or certificate offering,No,Suburb: Large,Doctoral Universities: Very High Research Activity,Research Doctoral: STEM-dominant,High undergraduate,"Four-year, medium, primarily residential",1802,1275,527,423,312,111,1802,130,392,1280,456,325,131,82,68,14,88,63,25,30,23,7,CO07
126818,Colorado State University-Fort Collins, ,102 Administration Building,Fort Collins,CO,80523-0100,-105.080732,40.574805,Public,Graduate degree or certificate offering,No,City: Midsize,Doctoral Universities: Very High Research Activity,"Research Doctoral: Comprehensive programs, with medical/veterinary school",High undergraduate,"Four-year, large, primarily residential",9168,3996,5172,935,579,356,9168,3901,2922,2345,1649,736,913,180,116,64,221,115,106,53,32,21,CO02
126827,Colorado Technical University-Colorado Springs,Colorado Tech CTU,4435 N Chestnut Street,Colorado Springs,CO,80907-3812,-104.833928,38.894265,Private for-profit,Graduate degree or certificate offering,No,City: Large,Doctoral/Professional Universities,"Postbaccalaureate: Business-dominant, with Arts & Sciences",High undergraduate,"Four-year, large, primarily nonresidential",5448,2494,2954,1,1,0,5448,5435,13,0,1623,553,1070,0,0,0,0,0,0,0,0,0,CO05
126979,Denver Seminary, ,6399 S. Santa Fe Drive,Littleton,CO,80120,-105.022363,39.600595,Private not-for-profit,Graduate degree or certificate offering,No,Suburb: Large,Master's Colleges & Universities: Medium Programs,"Postbaccalaureate: Other-dominant, with Arts & Sciences",Exclusively graduate,Exclusively graduate/professional,1172,636,536,22,16,6,1172,372,526,274,155,65,90,0,0,0,0,0,0,0,0,0,CO06
127060,University of Denver,DU,2199 S. University Blvd,Denver,CO,80208,-104.963259,39.678005,Private not-for-profit,Graduate degree or certificate offering,No,City: Large,Doctoral Universities: Very High Research Activity,"Research Doctoral: Comprehensive programs, no medical/veterinary school",Majority undergraduate,"Four-year, large, primarily residential",10408,3645,6763,407,198,209,10408,6121,2806,1481,2389,801,1588,126,64,62,120,50,70,22,15,7,CO01
127185,Fort Lewis College,FLC,1000 Rim Drive,Durango,CO,81301-3999,-107.867422,37.275939,Public,Graduate degree or certificate offering,No,Town: Distant,Baccalaureate Colleges: Diverse Fields,Postbaccalaureate: Single program-Education,Very high undergraduate,"Four-year, medium, primarily residential",129,29,100,0,0,0,129,37,52,40,15,3,12,0,0,0,0,0,0,0,0,0,CO03
127273,Iliff School of Theology, ,2323 E. Iliff Ave.,Denver,CO,80210-4798,-104.960657,39.675927,Private not-for-profit,Graduate degree or certificate offering,No,City: Large,Special Focus Four-Year: Faith-Related Institutions,Research Doctoral: Single program-Other,Exclusively graduate,Exclusively graduate/professional,244,98,146,7,4,3,244,244,0,0,34,15,19,0,0,0,8,6,2,0,0,0,CO01
127556,Colorado Mesa University,Colorado Mesa,1100 North Avenue,Grand Junction,CO,81501-3122,-108.553275,39.080643,Public,Graduate degree or certificate offering,No,City: Small,Baccalaureate Colleges: Diverse Fields,"Postbaccalaureate: Education-dominant, with Arts & Sciences",Very high undergraduate,"Four-year, medium, primarily residential",228,81,147,2,1,1,228,81,69,78,57,25,32,0,0,0,0,0,0,0,0,0,CO03
127565,Metropolitan State University of Denver, ,Speer Blvd and Colfax Ave,Denver,CO,80217-3362,-105.00504,39.744202,Public,Graduate degree or certificate offering,No,City: Large,Master's Colleges & Universities: Larger Programs,"Postbaccalaureate: Other-dominant, with other professional programs",Very high undergraduate,"Four-year, large, primarily nonresidential",1270,292,978,13,4,9,1270,1085,66,119,372,75,297,2,2,0,0,0,0,0,0,0,CO01
127653,Naropa University, ,2130 Arapahoe Ave,Boulder,CO,80302-6697,-105.266987,40.014235,Private not-for-profit,Graduate degree or certificate offering,No,City: Midsize,Master's Colleges & Universities: Medium Programs,"Postbaccalaureate: Other-dominant, with Arts & Sciences",Majority graduate,"Four-year, very small, primarily residential",618,154,464,14,3,11,618,180,429,9,125,26,99,1,0,1,0,0,0,0,0,0,CO02
127741,University of Northern Colorado, ,Carter Hall - Rm 4000,Greeley,CO,80639,-104.692777,40.410855,Public,Graduate degree or certificate offering,No,City: Midsize,Doctoral/Professional Universities,"Research Doctoral: Comprehensive programs, no medical/veterinary school",High undergraduate,"Four-year, medium, primarily residential",4126,968,3158,104,46,58,4126,2145,1510,471,892,234,658,16,8,8,84,24,60,8,4,4,CO08
127909,Red Rocks Community College, ,13300 W Sixth Ave,Lakewood,CO,80228-1255,-105.150094,39.720277,Public,Graduate degree or certificate offering,No,City: Midsize,Baccalaureate/Associate's Colleges: Associate's Dominant,Postbaccalaureate: Single program-Other,Very high undergraduate,"Four-year, small, primarily nonresidential",98,31,67,0,0,0,98,0,0,98,31,11,20,0,0,0,0,0,0,0,0,0,CO07
127918,Regis University,Regis/Regis College/RU/Jesuit/Jesuit Denver Colorado/Regis Nursing/College of Computer & Information Science/College of Business & Economics/College of Contemporary Liberal Studies/RHCHP/Rangers/Regis U/Regis in Colorado/Rueckert-Hartman College for Health Professions/College of Computer & Information Sciences/College of Business & Economics/Anderson College of Business,3333 Regis Blvd,Denver,CO,80221-1099,-105.030756,39.788175,Private not-for-profit,Graduate degree or certificate offering,No,City: Large,Doctoral/Professional Universities,Postbaccalaureate: Comprehensive programs,Majority graduate,"Four-year, medium, primarily residential",4019,1280,2739,107,51,56,4019,1097,1869,1053,974,300,674,30,15,15,0,0,0,0,0,0,CO01
127945,Rocky Mountain College of Art and Design,RMCAD,1600 Pierce St,Lakewood,CO,80214,-105.069911,39.74332,Private for-profit,Graduate degree or certificate offering,No,City: Midsize,Baccalaureate Colleges: Diverse Fields,Not classified (Exclusively Undergraduate),Very high undergraduate,"Four-year, small, primarily nonresidential",16,5,11,0,0,0,16,16,0,0,0,0,0,0,0,0,0,0,0,0,0,0,CO07
127954,Montessori Education Center of the Rockies,Rocky Mountain Montessori Teacher Training Center,3975 Martin Luther King Blvd.,Denver,CO,80205,-104.943415,39.762942,Private not-for-profit,Graduate degree or certificate offering,No,City: Large,nan,nan,nan,nan,51,5,46,0,0,0,51,51,0,0,0,0,0,0,0,0,0,0,0,0,0,0,CO01
128106,Colorado State University Pueblo,CSU Pueblo,2200 Bonforte Blvd,Pueblo,CO,81001-4901,-104.579033,38.30859,Public,Graduate degree or certificate offering,No,City: Midsize,Master's Colleges & Universities: Medium Programs,"Postbaccalaureate: Other-dominant, with Arts & Sciences",High undergraduate,"Four-year, medium, primarily residential",7036,1442,5594,31,15,16,7036,6649,272,115,151,52,99,8,6,2,0,0,0,0,0,0,CO03
128391,Western Colorado University,Western,1 Western Way,Gunnison,CO,81231,-106.919132,38.549936,Public,Graduate degree or certificate offering,No,Town: Remote,Master's Colleges & Universities: Medium Programs,"Postbaccalaureate: Education-dominant, with Arts & Sciences",High undergraduate,"Four-year, small, highly residential",691,211,480,2,0,2,691,258,147,286,133,55,78,2,0,2,0,0,0,0,0,0,CO03
128498,Albertus Magnus College, ,700 Prospect St,New Haven,CT,06511-1189,-72.923848,41.332519,Private not-for-profit,Graduate degree or certificate offering,No,City: Midsize,Master's Colleges & Universities: Medium Programs,"Postbaccalaureate: Business-dominant, with Arts & Sciences",High undergraduate,"Four-year, small, primarily residential",379,105,274,3,0,3,379,141,99,139,112,34,78,3,0,3,0,0,0,0,0,0,CT03
128744,University of Bridgeport, ,126 Park Avenue,Bridgeport,CT,06604-5620,-73.190166,41.164741,Private not-for-profit,Graduate degree or certificate offering,No,City: Midsize,Doctoral/Professional Universities,Research Doctoral: STEM-dominant,Majority undergraduate,"Four-year, medium, primarily residential",2193,727,1466,228,140,88,2193,738,399,1056,459,155,304,92,60,32,20,11,9,3,2,1,CT04
128771,Central Connecticut State University,CCSU,1615 Stanley St,New Britain,CT,06050,-72.765991,41.692502,Public,Graduate degree or certificate offering,No,Suburb: Large,Master's Colleges & Universities: Larger Programs,Research Doctoral: Single program-Education,High undergraduate,"Four-year, medium, primarily residential",2641,954,1687,40,12,28,2641,2189,322,130,511,189,322,15,1,14,15,3,12,0,0,0,CT05
128780,Charter Oak State College, ,55 Paul Manafort Drive,New Britain,CT,06053,-72.767972,41.688246,Public,Graduate degree or certificate offering,No,Suburb: Large,Baccalaureate Colleges: Arts & Sciences Focus,Postbaccalaureate: Single program-Business,Very high undergraduate,"Four-year, very small, primarily nonresidential",116,24,92,0,0,0,116,116,0,0,29,7,22,0,0,0,0,0,0,0,0,0,CT05
129020,University of Connecticut, ,352 Mansfield Road,Storrs,CT,06269,-72.249948,41.809098,Public,Graduate degree or certificate offering,No,Suburb: Large,Doctoral Universities: Very High Research Activity,"Research Doctoral: Comprehensive programs, with medical/veterinary school",Majority undergraduate,"Four-year, large, highly residential",9295,4211,5084,1906,981,925,9295,3776,3759,1760,1968,874,1094,543,245,298,308,160,148,144,85,59,CT02
129154,Goodwin University,Goodwin,One Riverside Drive,East Hartford,CT,06118,-72.64032,41.742977,Private not-for-profit,Graduate degree or certificate offering,No,City: Small,Baccalaureate/Associate's Colleges: Mixed Baccalaureate/Associate's,"Postbaccalaureate: Business-dominant, with other professional programs",Very high undergraduate,"Four-year, small, primarily nonresidential",139,32,107,0,0,0,139,73,15,51,54,11,43,0,0,0,0,0,0,0,0,0,CT01
129215,Eastern Connecticut State University,Eastern|ECSU,83 Windham St,Willimantic,CT,06226,-72.218753,41.721673,Public,Graduate degree or certificate offering,No,Town: Fringe,Master's Colleges & Universities: Small Programs,"Postbaccalaureate: Education-dominant, with other professional programs",Very high undergraduate,"Four-year, medium, highly residential",241,73,168,4,0,4,241,45,157,39,101,27,74,2,0,2,0,0,0,0,0,0,CT02
129242,Fairfield University, ,1073 N Benson Rd,Fairfield,CT,06824-5195,-73.255903,41.157673,Private not-for-profit,Graduate degree or certificate offering,No,Suburb: Large,Doctoral/Professional Universities,Postbaccalaureate: Comprehensive programs,High undergraduate,"Four-year, medium, highly residential",1325,410,915,93,44,49,1325,476,380,469,391,143,248,23,13,10,0,0,0,0,0,0,CT04
129428,Rensselaer at Hartford, ,275 Windsor St,Hartford,CT,06120,-72.673916,41.773462,Private not-for-profit,Graduate degree or certificate offering,No,City: Midsize,Special Focus Four-Year: Engineering and Other Technology-Related Schools,Postbaccalaureate: Arts & sciences-dominant,Exclusively graduate,Exclusively graduate/professional,148,116,32,2,1,1,148,0,148,0,24,19,5,0,0,0,0,0,0,0,0,0,CT01
129491,Hartford Seminary, ,77 Sherman Street,Hartford,CT,06105-2260,-72.707766,41.769861,Private not-for-profit,Graduate degree or certificate offering,No,City: Midsize,Master's Colleges & Universities: Small Programs,Postbaccalaureate: Arts & sciences-dominant,Exclusively graduate,Exclusively graduate/professional,159,79,80,15,10,5,159,159,0,0,21,10,11,4,3,1,0,0,0,0,0,0,CT01
129525,University of Hartford,"UHart, UHA, Hartford",200 Bloomfield Ave,West Hartford,CT,06117-1599,-72.715213,41.798591,Private not-for-profit,Graduate degree or certificate offering,No,City: Midsize,Doctoral/Professional Universities,Research Doctoral: Professional-dominant,High undergraduate,"Four-year, medium, highly residential",2527,934,1593,207,80,127,2527,1734,170,623,742,299,443,80,35,45,26,17,9,4,3,1,CT01
129534,Holy Apostles College and Seminary,HACS,33 Prospect Hill Road,Cromwell,CT,06416-2005,-72.647853,41.60682,Private not-for-profit,Graduate degree or certificate offering,No,Suburb: Large,Master's Colleges & Universities: Medium Programs,"Postbaccalaureate: Other-dominant, with Arts & Sciences",Majority graduate,"Four-year, very small, primarily nonresidential",639,460,179,60,45,15,639,575,61,3,123,84,39,30,20,10,0,0,0,0,0,0,CT01
129941,University of New Haven,UNH,300 Boston Post Road,West Haven,CT,06516-1916,-72.961472,41.291314,Private not-for-profit,Graduate degree or certificate offering,No,Suburb: Large,Master's Colleges & Universities: Larger Programs,Research Doctoral: Single program-Other,High undergraduate,"Four-year, medium, highly residential",2534,1277,1257,840,521,319,2534,702,782,1050,981,499,482,365,237,128,2,2,0,0,0,0,CT03
130183,Post University, ,800 Country Club Rd,Waterbury,CT,06723,-73.081497,41.535549,Private for-profit,Graduate degree or certificate offering,No,Suburb: Midsize,Master's Colleges & Universities: Larger Programs,"Postbaccalaureate: Business-dominant, with other professional programs",High undergraduate,"Four-year, medium, primarily nonresidential",2023,731,1292,4,3,1,2023,1916,105,2,371,172,199,3,3,0,0,0,0,0,0,0,CT05
130226,Quinnipiac University, ,Mt Carmel Ave,Hamden,CT,06518,-72.894117,41.418915,Private not-for-profit,Graduate degree or certificate offering,No,Suburb: Large,Doctoral/Professional Universities,"Postbaccalaureate: Other-dominant, with Arts & Sciences",High undergraduate,"Four-year, medium, highly residential",3833,1219,2614,46,13,33,3833,915,2918,0,831,287,544,5,1,4,0,0,0,0,0,0,CT03
130253,Sacred Heart University,SHU,5151 Park Ave,Fairfield,CT,06825-1000,-73.243332,41.220893,Private not-for-profit,Graduate degree or certificate offering,No,Suburb: Large,Doctoral/Professional Universities,"Postbaccalaureate: Other-dominant, with Arts & Sciences",High undergraduate,"Four-year, medium, highly residential",3671,908,2763,191,114,77,3671,1542,1352,777,1025,323,702,96,57,39,0,0,0,0,0,0,CT04
130314,University of Saint Joseph,USJ,1678 Asylum Avenue,West Hartford,CT,06117,-72.72965,41.781041,Private not-for-profit,Graduate degree or certificate offering,No,Suburb: Large,Master's Colleges & Universities: Larger Programs,"Postbaccalaureate: Education-dominant, with Arts & Sciences",Majority graduate,"Four-year, small, primarily residential",1700,301,1399,17,5,12,1700,364,453,883,490,73,417,2,0,2,0,0,0,0,0,0,CT01
130493,Southern Connecticut State University,SCSU,501 Crescent Street,New Haven,CT,06515-1355,-72.947897,41.333225,Public,Graduate degree or certificate offering,No,City: Midsize,Master's Colleges & Universities: Larger Programs,Research Doctoral: Professional-dominant,High undergraduate,"Four-year, medium, primarily residential",2322,590,1732,28,10,18,2322,1536,591,195,451,116,335,7,3,4,10,1,9,0,0,0,CT03
130590,Trinity College,"Trinity College, Hartford, Connecticut",300 Summit St,Hartford,CT,06106-3100,-72.690882,41.747451,Private not-for-profit,Graduate degree or certificate offering,No,City: Midsize,Baccalaureate Colleges: Arts & Sciences Focus,"Postbaccalaureate: Other-dominant, with Arts & Sciences",Very high undergraduate,"Four-year, small, highly residential",56,36,20,3,2,1,56,0,0,56,24,13,11,1,0,1,0,0,0,0,0,0,CT01
130697,Wesleyan University, ,45 Wyllys Avenue,Middletown,CT,06459,-72.657146,41.554665,Private not-for-profit,Graduate degree or certificate offering,No,City: Small,Baccalaureate Colleges: Arts & Sciences Focus,Research Doctoral: STEM-dominant,Very high undergraduate,"Four-year, small, highly residential",245,103,142,57,27,30,245,79,131,35,59,20,39,6,3,3,9,5,4,1,1,0,CT03
130776,Western Connecticut State University,"Western, WCSU",181 White Street,Danbury,CT,06810-6826,-73.444264,41.400365,Public,Graduate degree or certificate offering,No,City: Small,Master's Colleges & Universities: Medium Programs,"Postbaccalaureate: Education-dominant, with Arts & Sciences",Very high undergraduate,"Four-year, medium, primarily residential",778,193,585,1,0,1,778,574,122,82,158,35,123,0,0,0,0,0,0,0,0,0,CT05
130794,Yale University, ,Woodbridge Hall,New Haven,CT,06520,-72.926688,41.311158,Private not-for-profit,Graduate degree or certificate offering,No,City: Midsize,Doctoral Universities: Very High Research Activity,"Research Doctoral: Comprehensive programs, with medical/veterinary school",Majority graduate,"Four-year, large, highly residential",7655,3607,4048,2200,1162,1038,7655,4407,3217,31,2175,1033,1142,684,360,324,427,242,185,171,102,69,CT03
130934,Delaware State University, ,1200 N. Dupont Highway,Dover,DE,19901,-75.54053,39.187173,Public,Graduate degree or certificate offering,Yes,City: Small,Master's Colleges & Universities: Medium Programs,Research Doctoral: STEM-dominant,High undergraduate,"Four-year, medium, highly residential",745,219,526,51,28,23,745,255,179,311,143,34,109,12,7,5,18,3,15,0,0,0,DE00
130943,University of Delaware,UD,104 Hullihen Hall,Newark,DE,19716,-75.752822,39.679577,Public,Graduate degree or certificate offering,No,Suburb: Large,Doctoral Universities: Very High Research Activity,"Research Doctoral: Comprehensive programs, no medical/veterinary school",High undergraduate,"Four-year, large, primarily residential",4973,2351,2622,1312,745,567,4973,3177,1057,739,954,411,543,228,116,112,219,116,103,90,57,33,DE00
130989,Goldey-Beacom College, ,4701 Limestone Rd,Wilmington,DE,19808,-75.689624,39.741501,Private not-for-profit,Graduate degree or certificate offering,No,Suburb: Large,Master's Colleges & Universities: Larger Programs,"Postbaccalaureate: Business-dominant, with other professional programs",Majority undergraduate,"Four-year, very small, primarily residential",665,272,393,451,188,263,665,0,0,665,271,117,154,179,78,101,3,1,2,0,0,0,DE00
131098,Wesley College, ,120 N State St,Dover,DE,19901-3875,-75.527716,39.163182,Private not-for-profit,Graduate degree or certificate offering,No,City: Small,nan,nan,nan,nan,121,35,86,1,1,0,121,13,70,38,61,13,48,0,0,0,0,0,0,0,0,0,DE00
131113,Wilmington University, ,320 Dupont Hwy,New Castle,DE,19720,-75.586998,39.682299,Private not-for-profit,Graduate degree or certificate offering,No,Suburb: Large,Doctoral/Professional Universities,Research Doctoral: Professional-dominant,Majority undergraduate,"Four-year, medium, primarily nonresidential",7382,2126,5256,537,259,278,7382,4860,1639,883,1814,536,1278,213,101,112,160,43,117,4,3,1,DE00
131159,American University, ,4400 Massachusetts Ave NW,Washington,DC,20016-8001,-77.088875,38.936005,Private not-for-profit,Graduate degree or certificate offering,No,City: Large,Doctoral Universities: High Research Activity,"Research Doctoral: Comprehensive programs, no medical/veterinary school",Majority undergraduate,"Four-year, large, highly residential",7138,2674,4464,729,300,429,7138,2065,2324,2749,1829,624,1205,311,119,192,38,16,22,8,3,5,DC98
131283,The Catholic University of America, ,"620 Michigan Avenue, NE",Washington,DC,20064,-76.997909,38.933651,Private not-for-profit,Graduate degree or certificate offering,No,City: Large,Doctoral Universities: High Research Activity,"Research Doctoral: Comprehensive programs, no medical/veterinary school",Majority undergraduate,"Four-year, medium, highly residential",2578,1190,1388,389,219,170,2578,342,2146,90,543,253,290,97,60,37,86,41,45,27,7,20,DC98
131399,University of the District of Columbia, ,4200 Connecticut Ave NW,Washington,DC,20008,-77.066247,38.943819,Public,Graduate degree or certificate offering,Yes,City: Large,Master's Colleges & Universities: Medium Programs,"Postbaccalaureate: Education-dominant, with Arts & Sciences",High undergraduate,"Four-year, small, primarily nonresidential",638,249,389,29,19,10,638,0,184,454,130,57,73,10,6,4,0,0,0,0,0,0,DC98
131405,Pontifical Faculty of the Immaculate Conception at the Dominican House of Studies,DHS | Pontifical Faculty of the Immaculate Conception | College of the Immaculate Conception,"487 Michigan Ave, NE",Washington,DC,20017-1585,-76.998724,38.931652,Private not-for-profit,Graduate degree or certificate offering,No,City: Large,Special Focus Four-Year: Faith-Related Institutions,Postbaccalaureate: Single program-Other,Exclusively graduate,Exclusively graduate/professional,105,75,30,4,4,0,105,0,0,105,36,29,7,2,2,0,0,0,0,0,0,0,DC98
131450,Gallaudet University, ,"800 Florida Ave, NE",Washington,DC,20002-3695,-76.993675,38.907371,Private not-for-profit,Graduate degree or certificate offering,No,City: Large,Doctoral/Professional Universities,Research Doctoral: Professional-dominant,Majority undergraduate,"Four-year, small, highly residential",498,121,377,26,16,10,498,56,242,200,128,35,93,5,3,2,16,3,13,0,0,0,DC98
131469,George Washington University,GWU|GW,"1918 F Street, NW",Washington,DC,20052,-77.048363,38.89923,Private not-for-profit,Graduate degree or certificate offering,No,City: Large,Doctoral Universities: Very High Research Activity,"Research Doctoral: Comprehensive programs, with medical/veterinary school",Majority undergraduate,"Four-year, large, highly residential",17464,6764,10700,2420,1218,1202,17464,5304,3010,9150,4602,1828,2774,1017,539,478,218,96,122,67,41,26,DC98
131496,Georgetown University,Georgetown|GU,37th and O St NW,Washington,DC,20057-0001,-77.073463,38.908809,Private not-for-profit,Graduate degree or certificate offering,No,City: Large,Doctoral Universities: Very High Research Activity,"Research Doctoral: Comprehensive programs, with medical/veterinary school",Majority graduate,"Four-year, large, highly residential",14730,6844,7886,2472,1123,1349,14730,12043,2633,54,3926,1832,2094,916,407,509,160,71,89,36,22,14,DC98
131520,Howard University,HU,2400 Sixth St NW,Washington,DC,20059,-77.018966,38.922392,Private not-for-profit,Graduate degree or certificate offering,Yes,City: Large,Doctoral Universities: High Research Activity,"Research Doctoral: Comprehensive programs, with medical/veterinary school",Majority undergraduate,"Four-year, large, highly residential",3206,1094,2112,223,88,135,3206,179,2014,1013,229,57,172,14,5,9,103,39,64,22,8,14,DC98
131803,Strayer University-District of Columbia, ,1133 15th St NW,Washington,DC,20005,-77.034133,38.904881,Private for-profit,Graduate degree or certificate offering,No,City: Large,Master's Colleges & Universities: Small Programs,"Postbaccalaureate: Business-dominant, with Arts & Sciences",High undergraduate,"Four-year, very small, primarily nonresidential",155,48,107,0,0,0,155,155,0,0,49,19,30,0,0,0,0,0,0,0,0,0,DC98
131876,Trinity Washington University,"Trinity College, Washington, D.C.",125 Michigan Ave NE,Washington,DC,20017-1094,-77.004261,38.927398,Private not-for-profit,Graduate degree or certificate offering,No,City: Large,Master's Colleges & Universities: Medium Programs,"Postbaccalaureate: Education-dominant, with other professional programs",High undergraduate,"Four-year, small, primarily nonresidential",506,70,436,12,2,10,506,454,52,0,111,20,91,1,0,1,0,0,0,0,0,0,DC98
131973,Wesley Theological Seminary, ,"4500 Massachusetts Ave., NW",Washington,DC,20016-5690,-77.08996,38.939606,Private not-for-profit,Graduate degree or certificate offering,No,City: Large,Special Focus Four-Year: Faith-Related Institutions,Postbaccalaureate: Single program-Other,Exclusively graduate,Exclusively graduate/professional,653,331,322,38,23,15,653,167,276,210,80,32,48,10,5,5,0,0,0,0,0,0,DC98
132408,The Baptist College of Florida,BCF,5400 College Dr,Graceville,FL,32440,-85.503931,30.962708,Private not-for-profit,Graduate degree or certificate offering,No,Town: Distant,Baccalaureate Colleges: Diverse Fields,"Postbaccalaureate: Other-dominant, with Arts & Sciences",Very high undergraduate,"Four-year, very small, primarily residential",36,25,11,0,0,0,36,30,5,1,12,8,4,0,0,0,0,0,0,0,0,0,FL02
132471,Barry University, ,11300 NE 2nd Ave,Miami,FL,33161-6695,-80.198925,25.878908,Private not-for-profit,Graduate degree or certificate offering,No,Suburb: Large,Doctoral/Professional Universities,Research Doctoral: Professional-dominant,Majority undergraduate,"Four-year, medium, primarily residential",4902,1383,3519,247,77,170,4902,1111,489,3302,907,224,683,69,23,46,30,6,24,7,1,6,FL24
132602,Bethune-Cookman University,Bethune-Cookman  Bethune-Cookman College  Bethune  Cookman  BCC  B-CC  B-CU,640 Dr Mary McLeod Bethune Blvd,Daytona Beach,FL,32114-3099,-81.032946,29.207195,Private not-for-profit,Graduate degree or certificate offering,Yes,City: Small,Baccalaureate Colleges: Arts & Sciences Focus,"Postbaccalaureate: Other-dominant, with other professional programs",Very high undergraduate,"Four-year, small, highly residential",127,44,83,3,2,1,127,53,74,0,45,12,33,0,0,0,0,0,0,0,0,0,FL06
132657,Lynn University,Lynn University,3601 N. Military Trail,Boca Raton,FL,33431-5598,-80.122806,26.385985,Private not-for-profit,Graduate degree or certificate offering,No,City: Small,Master's Colleges & Universities: Larger Programs,Research Doctoral: Single program-Education,High undergraduate,"Four-year, small, highly residential",1004,401,603,193,106,87,1004,451,439,114,359,139,220,68,31,37,30,7,23,0,0,0,FL23
132842,Albizu University-Miami,Albizu University-Miami,2173 N.W. 99th Avenue,Miami,FL,33172-2209,-80.356315,25.794178,Private not-for-profit,Graduate degree or certificate offering,No,City: Small,Doctoral/Professional Universities,Research Doctoral: Professional-dominant,Majority graduate,"Four-year, very small, primarily nonresidential",858,125,733,26,3,23,858,72,442,344,175,25,150,4,1,3,32,5,27,3,0,3,FL26
132903,University of Central Florida,UCF,4000 Central Florida Blvd,Orlando,FL,32816,-81.200889,28.602159,Public,Graduate degree or certificate offering,No,Suburb: Large,Doctoral Universities: Very High Research Activity,"Research Doctoral: Comprehensive programs, with medical/veterinary school",High undergraduate,"Four-year, large, primarily nonresidential",12792,4962,7830,1250,789,461,12792,5630,4741,2421,2702,980,1722,228,135,93,317,178,139,122,90,32,FL10
133465,South University-West Palm Beach, ,9801 Belvedere Road,Royal Palm Beach,FL,33411,-80.200219,26.69215,Private for-profit,Graduate degree or certificate offering,No,Suburb: Large,Special Focus Four-Year: Other Health Professions Schools,"Postbaccalaureate: Other-dominant, with other professional programs",High undergraduate,"Four-year, very small, primarily nonresidential",209,38,171,2,0,2,209,33,34,142,46,7,39,0,0,0,0,0,0,0,0,0,FL20
133553,Embry-Riddle Aeronautical University-Daytona Beach,Embry Riddle Aeronautical University-Daytona Beach,1 Aerospace Blvd.,Daytona Beach,FL,32114-3900,-81.048367,29.189903,Private not-for-profit,Graduate degree or certificate offering,No,City: Small,Master's Colleges & Universities: Larger Programs,Research Doctoral: STEM-dominant,Very high undergraduate,"Four-year, medium, primarily residential",717,515,202,321,231,90,717,55,378,284,242,171,71,117,80,37,13,5,8,9,4,5,FL06
133650,Florida Agricultural and Mechanical University,FAMU|Florida A&M University|Florida A&M University |Rattlers|FAMU Rattlers,1500 S Martin Luther King Jr Blvd,Tallahassee,FL,32307,-84.290226,30.428504,Public,Graduate degree or certificate offering,Yes,City: Midsize,Doctoral Universities: High Research Activity,Research Doctoral: Professional-dominant,High undergraduate,"Four-year, medium, primarily residential",1966,678,1288,67,35,32,1966,65,1885,16,303,99,204,6,3,3,28,7,21,0,0,0,FL02
133669,Florida Atlantic University,FAU,"777 Glades Rd, Administration Bldg., Room 339",Boca Raton,FL,33431-0991,-80.102978,26.372421,Public,Graduate degree or certificate offering,No,City: Small,Doctoral Universities: High Research Activity,Research Doctoral: STEM-dominant,High undergraduate,"Four-year, large, primarily nonresidential",6565,2497,4068,456,236,220,6565,2877,3036,652,1591,603,988,100,51,49,96,43,53,18,11,7,FL23
133711,Flagler College,Flagler,74 King Street,Saint Augustine,FL,32084,-81.314887,29.892733,Private not-for-profit,Graduate degree or certificate offering,No,Suburb: Small,Baccalaureate Colleges: Diverse Fields,Postbaccalaureate: Single program-Education,Very high undergraduate,"Four-year, small, primarily residential",23,1,22,0,0,0,23,0,23,0,4,1,3,0,0,0,0,0,0,0,0,0,FL05
133872,AdventHealth University,Florida Hospital College,671 Winyah Drive,Orlando,FL,32803,-81.367687,28.576142,Private not-for-profit,Graduate degree or certificate offering,No,City: Large,Special Focus Four-Year: Other Health Professions Schools,Postbaccalaureate: Single program-Other,Majority undergraduate,"Four-year, small, primarily nonresidential",701,165,536,11,4,7,701,308,154,239,120,22,98,2,1,1,0,0,0,0,0,0,FL10
133881,Florida Institute of Technology,Florida Tech,150 West University Boulevard,Melbourne,FL,32901-6975,-80.622893,28.065815,Private not-for-profit,Graduate degree or certificate offering,No,City: Small,Doctoral Universities: High Research Activity,Research Doctoral: STEM-dominant,Majority undergraduate,"Four-year, medium, highly residential",4896,1930,2966,719,331,388,4896,2907,367,1622,1171,545,626,186,101,85,60,42,18,39,31,8,FL08
133951,Florida International University,FIU,11200 S. W. 8 Street,Miami,FL,33199,-80.373928,25.75732,Public,Graduate degree or certificate offering,No,Suburb: Large,Doctoral Universities: Very High Research Activity,"Research Doctoral: Comprehensive programs, with medical/veterinary school",High undergraduate,"Four-year, large, primarily nonresidential",12817,4997,7820,1647,840,807,12817,4323,5849,2645,3536,1404,2132,553,275,278,206,102,104,90,57,33,FL28
133979,Florida Memorial University, ,15800 NW 42 Avenue,Miami Gardens,FL,33054-6199,-80.270753,25.918278,Private not-for-profit,Graduate degree or certificate offering,Yes,Suburb: Large,Baccalaureate Colleges: Diverse Fields,"Postbaccalaureate: Education-dominant, with other professional programs",Very high undergraduate,"Four-year, very small, highly residential",53,19,34,13,4,9,53,0,0,53,34,9,25,5,0,5,0,0,0,0,0,0,FL24
134079,Florida Southern College,Florida Southern|FSC,111 Lake Hollingsworth Dr,Lakeland,FL,33801-5698,-81.948203,28.032443,Private not-for-profit,Graduate degree or certificate offering,No,City: Midsize,Master's Colleges & Universities: Medium Programs,Research Doctoral: Single program-Education,High undergraduate,"Four-year, medium, highly residential",742,220,522,28,15,13,742,144,424,174,150,39,111,5,2,3,9,1,8,0,0,0,FL18
134097,Florida State University,Florida State|F.S.U.|FSU|F. S. U.|Fla. State University|Fla. State|Fl State University|Fl State|FL State University|FL State|Seminoles|Noles|Florida State Seminoles|Florida State University Seminoles|Fl. State|Fl. State University|The Florida State University|Floridia State University|Florda State University|Florida State Univerisity|Flordia State University|Florida State Unversity|,222 S. Copeland Street,Tallahassee,FL,32306-1037,-84.291921,30.440756,Public,Graduate degree or certificate offering,No,City: Midsize,Doctoral Universities: Very High Research Activity,"Research Doctoral: Comprehensive programs, with medical/veterinary school",High undergraduate,"Four-year, large, primarily nonresidential",12945,5036,7909,1387,750,637,12945,7090,4558,1297,2407,928,1479,211,115,96,391,211,180,113,81,32,FL02
134130,University of Florida, ,Tigert Hall,Gainesville,FL,32611,-82.347911,29.64629,Public,Graduate degree or certificate offering,No,City: Midsize,Doctoral Universities: Very High Research Activity,"Research Doctoral: Comprehensive programs, with medical/veterinary school",Majority undergraduate,"Four-year, large, primarily residential",21664,9302,12362,3657,2173,1484,21664,11652,5865,4147,4096,1992,2104,998,649,349,748,402,346,299,183,116,FL03
134237,Full Sail University, ,3300 University Blvd,Winter Park,FL,32792-7429,-81.301286,28.596546,Private for-profit,Graduate degree or certificate offering,No,Suburb: Large,Master's Colleges & Universities: Larger Programs,"Postbaccalaureate: Other-dominant, with Arts & Sciences",Very high undergraduate,"Four-year, large, primarily nonresidential",2287,1241,1046,6,5,1,2287,1850,437,0,841,441,400,1,1,0,0,0,0,0,0,0,FL10
134510,Hobe Sound Bible College, ,11298 SE Gomez Ave,Hobe Sound,FL,33455-1065,-80.13184,27.066304,Private not-for-profit,Graduate degree or certificate offering,No,Suburb: Large,Baccalaureate Colleges: Diverse Fields,Not classified (Exclusively Undergraduate),Very high undergraduate,"Four-year, very small, primarily residential",15,8,7,0,0,0,15,15,0,0,9,4,5,0,0,0,0,0,0,0,0,0,FL21
134811,AI Miami International University of Art and Design, ,"1501 Biscayne Boulevard, Suite 100",Miami,FL,33132-1418,-80.18839,25.790008,Private for-profit,Graduate degree or certificate offering,No,City: Large,Baccalaureate Colleges: Diverse Fields,Postbaccalaureate: Single program-Other,Very high undergraduate,"Four-year, very small, primarily nonresidential",78,21,57,54,8,46,78,0,0,78,15,4,11,11,2,9,0,0,0,0,0,0,FL24
134945,Jacksonville University,JU,2800 University Blvd N,Jacksonville,FL,32211-3394,-81.60458,30.353227,Private not-for-profit,Graduate degree or certificate offering,No,City: Large,Master's Colleges & Universities: Larger Programs,"Postbaccalaureate: Other-dominant, with Arts & Sciences",High undergraduate,"Four-year, medium, highly residential",1669,430,1239,56,25,31,1669,363,917,389,406,130,276,11,4,7,11,8,3,2,2,0,FL04
135081,Keiser University-Ft Lauderdale, ,1500 NW 49th St.,Fort Lauderdale,FL,33309,-80.163959,26.185869,Private not-for-profit,Graduate degree or certificate offering,No,City: Midsize,Doctoral/Professional Universities,Research Doctoral: Professional-dominant,High undergraduate,"Four-year, large, primarily nonresidential",3129,1015,2114,229,74,155,3129,2276,214,639,531,161,370,10,4,6,81,33,48,1,0,1,FL20
135364,Luther Rice College & Seminary, ,3038 Evans Mill Road,Lithonia,GA,30038-9869,-84.123179,33.698126,Private not-for-profit,Graduate degree or certificate offering,No,Suburb: Large,Special Focus Four-Year: Faith-Related Institutions,Research Doctoral: Single program-Other,Majority graduate,"Four-year, very small, primarily nonresidential",657,480,177,3,3,0,657,35,610,12,127,85,42,0,0,0,8,8,0,0,0,0,GA04
135610,Trinity International University-Florida, ,"9010 SW 137th Ave, Suite #101",Miami,FL,33186,-80.417646,25.68307,Private not-for-profit,Graduate degree or certificate offering,No,Suburb: Large,Baccalaureate Colleges: Diverse Fields,"Postbaccalaureate: Other-dominant, with Arts & Sciences",Majority undergraduate,"Four-year, very small, primarily nonresidential",89,30,59,0,0,0,89,25,60,4,27,5,22,0,0,0,0,0,0,0,0,0,FL28
135726,University of Miami, ,University of Miami,Coral Gables,FL,33146,-80.278662,25.72126,Private not-for-profit,Graduate degree or certificate offering,No,City: Small,Doctoral Universities: Very High Research Activity,"Research Doctoral: Comprehensive programs, with medical/veterinary school",Majority undergraduate,"Four-year, large, primarily residential",7852,3473,4379,1264,637,627,7852,2853,3461,1538,1715,738,977,282,133,149,211,111,100,81,49,32,FL27
136172,University of North Florida,UNF,1 UNF Drive,Jacksonville,FL,32224-7699,-81.509144,30.27194,Public,Graduate degree or certificate offering,No,City: Large,Doctoral Universities: High Research Activity,Research Doctoral: Single program-Education,High undergraduate,"Four-year, large, primarily nonresidential",2970,890,2080,116,50,66,2970,2009,786,175,766,262,504,59,26,33,12,3,9,1,0,1,FL05
136215,Nova Southeastern University, ,3301 College Ave,Fort Lauderdale,FL,33314-7796,-80.24248,26.079337,Private not-for-profit,Graduate degree or certificate offering,No,Suburb: Large,Doctoral Universities: High Research Activity,Research Doctoral: Professional-dominant,Majority graduate,"Four-year, large, primarily residential",16925,4699,12226,589,244,345,16925,7067,2048,7810,2809,675,2134,122,54,68,500,128,372,10,2,8,FL25
136330,Palm Beach Atlantic University,Palm Beach Atlantic  PBA,901 S. Flagler Drive,West Palm Beach,FL,33401,-80.05247,26.7044,Private not-for-profit,Graduate degree or certificate offering,No,City: Midsize,Doctoral/Professional Universities,"Postbaccalaureate: Other-dominant, with Arts & Sciences",High undergraduate,"Four-year, small, highly residential",957,295,662,100,59,41,957,77,523,357,173,59,114,15,12,3,0,0,0,0,0,0,FL22
136701,Saint Vincent de Paul Regional Seminary,St. Vincent de Paul Regional Seminary | St. Vincent de Paul Regional Seminary,10701 South Military Trail,Boynton Beach,FL,33436-4899,-80.125185,26.516538,Private not-for-profit,Graduate degree or certificate offering,No,Suburb: Large,Special Focus Four-Year: Faith-Related Institutions,"Postbaccalaureate: Other-dominant, with Arts & Sciences",Exclusively graduate,Exclusively graduate/professional,149,146,3,31,31,0,149,19,106,24,33,33,0,6,6,0,0,0,0,0,0,0,FL22
136950,Rollins College,Rollins,1000 Holt Avenue,Winter Park,FL,32789-4499,-81.349239,28.592787,Private not-for-profit,Graduate degree or certificate offering,No,Suburb: Large,Master's Colleges & Universities: Larger Programs,Research Doctoral: Single program-Other,High undergraduate,"Four-year, small, highly residential",580,244,336,41,27,14,580,0,0,580,158,61,97,8,5,3,11,7,4,1,1,0,FL10
137032,Saint Leo University,St. Leo University   St Leo University,33701 State Road 52,Saint Leo,FL,33574-6665,-82.257801,28.336776,Private not-for-profit,Graduate degree or certificate offering,No,Suburb: Small,Doctoral/Professional Universities,Research Doctoral: Single program-Other,Majority undergraduate,"Four-year, medium, primarily nonresidential",4315,1529,2786,155,82,73,4315,3519,626,170,1269,402,867,34,13,21,25,9,16,0,0,0,FL12
137272,St. John Vianney College Seminary,St. John Vianney College Seminary   St John Vianney College Seminary,2900 SW 87th Ave,Miami,FL,33165-3244,-80.337411,25.742579,Private not-for-profit,Graduate degree or certificate offering,No,Suburb: Large,Special Focus Four-Year: Faith-Related Institutions,Not classified (Exclusively Undergraduate),Majority undergraduate,"Four-year, very small, highly residential",22,22,0,3,3,0,22,10,0,12,0,0,0,0,0,0,0,0,0,0,0,0,FL27
137351,University of South Florida,University of South Florida USF,4202 East Fowler Ave,Tampa,FL,33620-9951,-82.413232,28.061458,Public,Graduate degree or certificate offering,No,City: Large,Doctoral Universities: Very High Research Activity,"Research Doctoral: Comprehensive programs, with medical/veterinary school",High undergraduate,"Four-year, large, primarily nonresidential",14506,5633,8873,2309,1336,973,14506,5218,7618,1670,3539,1380,2159,694,409,285,381,168,213,110,60,50,FL15
137476,St. Thomas University,St Thomas University Saint Thomas University Miami Catholic University,16401 NW 37th Ave,Miami Gardens,FL,33054-6459,-80.253273,25.922071,Private not-for-profit,Graduate degree or certificate offering,No,Suburb: Large,Doctoral/Professional Universities,Research Doctoral: Professional-dominant,Majority graduate,"Four-year, medium, primarily residential",2669,947,1722,145,69,76,2669,1173,229,1267,354,138,216,37,17,20,68,31,37,9,4,5,FL24
137546,Stetson University, ,421 N Woodland Blvd,DeLand,FL,32723,-81.300746,29.035475,Private not-for-profit,Graduate degree or certificate offering,No,City: Small,Master's Colleges & Universities: Larger Programs,"Postbaccalaureate: Other-dominant, with Arts & Sciences",Majority undergraduate,"Four-year, medium, highly residential",1460,611,849,36,15,21,1460,431,949,80,136,54,82,7,4,3,0,0,0,0,0,0,FL06
137564,Southeastern University,SEU,1000 Longfellow Blvd,Lakeland,FL,33801-6034,-81.918382,28.029733,Private not-for-profit,Graduate degree or certificate offering,No,City: Midsize,Doctoral/Professional Universities,Research Doctoral: Professional-dominant,High undergraduate,"Four-year, medium, primarily residential",1607,601,1006,140,69,71,1607,1134,221,252,359,120,239,8,6,2,38,14,24,0,0,0,FL18
137777,Talmudic College of Florida,Talmudic University of Florida,4000 Alton Rd,Miami Beach,FL,33140-3854,-80.136293,25.811996,Private not-for-profit,Graduate degree or certificate offering,No,City: Small,Special Focus Four-Year: Faith-Related Institutions,Not classified (Exclusively Undergraduate),Very high undergraduate,"Four-year, very small, highly residential",3,3,0,3,3,0,3,0,0,3,0,0,0,0,0,0,0,0,0,0,0,0,FL24
137847,The University of Tampa, ,401 W Kennedy Blvd,Tampa,FL,33606-1490,-82.46483,27.948455,Private not-for-profit,Graduate degree or certificate offering,No,City: Large,Master's Colleges & Universities: Larger Programs,Postbaccalaureate: Comprehensive programs,Very high undergraduate,"Four-year, medium, primarily residential",1214,461,753,193,98,95,1214,62,92,1060,392,166,226,77,39,38,0,0,0,0,0,0,FL14
137953,Trinity Baptist College, ,800 Hammond Blvd,Jacksonville,FL,32221,-81.79626,30.311171,Private not-for-profit,Graduate degree or certificate offering,No,City: Large,Baccalaureate Colleges: Diverse Fields,"Postbaccalaureate: Other-dominant, with other professional programs",Very high undergraduate,"Four-year, very small, highly residential",26,11,15,0,0,0,26,19,7,0,5,1,4,0,0,0,0,0,0,0,0,0,FL04
138275,Warner University, ,13895 Hwy 27,Lake Wales,FL,33859-8797,-81.599972,27.825751,Private not-for-profit,Graduate degree or certificate offering,No,Rural: Fringe,Master's Colleges & Universities: Small Programs,"Postbaccalaureate: Business-dominant, with other professional programs",Very high undergraduate,"Four-year, very small, highly residential",185,85,100,8,4,4,185,178,7,0,65,27,38,1,0,1,0,0,0,0,0,0,FL18
138293,Webber International University, ,1201 N Scenic Hwy,Babson Park,FL,33827-0096,-81.532315,27.838778,Private not-for-profit,Graduate degree or certificate offering,No,Town: Fringe,Baccalaureate Colleges: Diverse Fields,"Postbaccalaureate: Other-dominant, with other professional programs",Very high undergraduate,"Four-year, very small, highly residential",83,44,39,14,9,5,83,12,32,39,33,16,17,4,2,2,0,0,0,0,0,0,FL18
138309,Rasmussen University-Florida, ,4755 Southwest 46th Court,Ocala,FL,34474-6226,-82.197343,29.140099,Private for-profit,Graduate degree or certificate offering,No,City: Small,Baccalaureate Colleges: Diverse Fields,"Postbaccalaureate: Other-dominant, with other professional programs",Very high undergraduate,"Four-year, medium, primarily nonresidential",98,15,83,0,0,0,98,98,0,0,15,4,11,0,0,0,0,0,0,0,0,0,FL03
138354,The University of West Florida,University of West Florida,11000 University Parkway,Pensacola,FL,32514-5750,-87.218511,30.549076,Public,Graduate degree or certificate offering,No,City: Small,Master's Colleges & Universities: Larger Programs,Research Doctoral: Single program-Education,High undergraduate,"Four-year, medium, primarily nonresidential",4714,1448,3266,168,82,86,4714,4150,504,60,1074,293,781,55,21,34,21,3,18,2,0,2,FL01
138600,Agnes Scott College, ,141 E. College Ave.,Decatur,GA,30030-3770,-84.295459,33.769268,Private not-for-profit,Graduate degree or certificate offering,No,Suburb: Large,Baccalaureate Colleges: Arts & Sciences Focus,Postbaccalaureate: Single program-Other,Very high undergraduate,"Four-year, small, highly residential",99,5,94,2,0,2,99,0,99,0,25,1,24,0,0,0,0,0,0,0,0,0,GA05
138716,Albany State University, ,504 College Drive,Albany,GA,31705,-84.141825,31.56928,Public,Graduate degree or certificate offering,Yes,City: Small,Master's Colleges & Universities: Medium Programs,"Postbaccalaureate: Education-dominant, with other professional programs",Very high undergraduate,"Four-year, medium, primarily residential",526,103,423,9,5,4,526,385,121,20,123,24,99,4,2,2,0,0,0,0,0,0,GA02
138868,Point University,Point U,507 West 10th Street,West Point,GA,31833,-85.184931,32.87912,Private not-for-profit,Graduate degree or certificate offering,No,Town: Distant,Baccalaureate Colleges: Diverse Fields,"Postbaccalaureate: Other-dominant, with other professional programs",Very high undergraduate,"Four-year, very small, primarily residential",47,27,20,0,0,0,47,47,0,0,17,7,10,0,0,0,0,0,0,0,0,0,GA03
138929,Atlanta's John Marshall Law School, ,"245 Peachtree Center Ave. NE, Suite 1900",Atlanta,GA,30303,-84.385603,33.76128,Private for-profit,Graduate degree or certificate offering,No,City: Large,Special Focus Four-Year: Law Schools,Postbaccalaureate: Single program-Other,Exclusively graduate,Exclusively graduate/professional,303,127,176,2,1,1,303,303,0,0,0,0,0,0,0,0,0,0,0,0,0,0,GA05
138947,Clark Atlanta University,CAU,"223 James P Brawley Drive, SW",Atlanta,GA,30314-4391,-84.412584,33.747628,Private not-for-profit,Graduate degree or certificate offering,Yes,City: Large,Doctoral Universities: High Research Activity,"Research Doctoral: Comprehensive programs, no medical/veterinary school",High undergraduate,"Four-year, medium, highly residential",736,213,523,44,21,23,736,121,614,1,145,39,106,6,3,3,42,18,24,3,1,2,GA05
139144,Berry College, ,2277 Martha Berry Hwy NW,Mount Berry,GA,30149,-85.189202,34.290414,Private not-for-profit,Graduate degree or certificate offering,No,Suburb: Small,Master's Colleges & Universities: Small Programs,"Postbaccalaureate: Education-dominant, with other professional programs",Very high undergraduate,"Four-year, small, highly residential",216,68,148,1,1,0,216,111,89,16,65,27,38,0,0,0,0,0,0,0,0,0,GA14
139153,Beulah Heights University,BHU,892 Berne St SE,Atlanta,GA,30316,-84.35768,33.736993,Private not-for-profit,Graduate degree or certificate offering,No,City: Large,Baccalaureate Colleges: Arts & Sciences Focus,Research Doctoral: Professional-dominant,Majority undergraduate,"Four-year, very small, primarily nonresidential",308,140,168,2,0,2,308,308,0,0,44,22,22,0,0,0,2,2,0,0,0,0,GA05
139199,Brenau University, ,500 Washington Street SE,Gainesville,GA,30501-3668,-83.821513,34.303117,Private not-for-profit,Graduate degree or certificate offering,No,City: Small,Doctoral/Professional Universities,"Postbaccalaureate: Other-dominant, with Arts & Sciences",Majority undergraduate,"Four-year, small, primarily nonresidential",1425,257,1168,9,4,5,1425,767,87,571,285,57,228,2,1,1,0,0,0,0,0,0,GA09
139311,Clayton  State University, ,2000 Clayton State Boulevard,Morrow,GA,30260-0285,-84.328174,33.594079,Public,Graduate degree or certificate offering,No,Suburb: Large,Master's Colleges & Universities: Medium Programs,"Postbaccalaureate: Business-dominant, with Arts & Sciences",Very high undergraduate,"Four-year, medium, primarily nonresidential",875,256,619,21,15,6,875,734,139,2,200,63,137,9,5,4,0,0,0,0,0,0,GA13
139348,Columbia Theological Seminary, ,701 S. Columbia Dr,Decatur,GA,30030-4118,-84.281695,33.764292,Private not-for-profit,Graduate degree or certificate offering,No,Suburb: Large,Special Focus Four-Year: Faith-Related Institutions,Research Doctoral: Single program-Other,Exclusively graduate,Exclusively graduate/professional,255,121,134,34,23,11,255,255,0,0,56,23,33,9,6,3,0,0,0,0,0,0,GA05
139366,Columbus State University,"CSU, Columbus State",4225 University Ave,Columbus,GA,31907-5645,-84.94106,32.50096,Public,Graduate degree or certificate offering,No,City: Midsize,Master's Colleges & Universities: Larger Programs,Research Doctoral: Single program-Education,High undergraduate,"Four-year, medium, primarily nonresidential",1924,640,1284,58,37,21,1924,1285,439,200,435,164,271,13,9,4,23,5,18,0,0,0,GA02
139393,Covenant College, ,14049 Scenic Highway,Lookout Mountain,GA,30750-4164,-85.375066,34.965161,Private not-for-profit,Graduate degree or certificate offering,No,Rural: Fringe,Baccalaureate Colleges: Arts & Sciences Focus,Postbaccalaureate: Single program-Education,Very high undergraduate,"Four-year, very small, highly residential",49,19,30,6,2,4,49,0,0,49,18,11,7,1,1,0,0,0,0,0,0,0,GA14
139579,South University-Savannah, ,709 Mall Blvd,Savannah,GA,31406,-81.105435,31.999571,Private for-profit,Graduate degree or certificate offering,No,City: Midsize,Master's Colleges & Universities: Larger Programs,Research Doctoral: Single program-Other,Majority graduate,"Four-year, very small, primarily nonresidential",889,237,652,9,6,3,889,69,91,729,175,40,135,0,0,0,6,3,3,3,3,0,GA01
139658,Emory University, ,201 Dowman Drive,Atlanta,GA,30322,-84.325512,33.790183,Private not-for-profit,Graduate degree or certificate offering,No,City: Large,Doctoral Universities: Very High Research Activity,"Research Doctoral: Comprehensive programs, with medical/veterinary school",Majority undergraduate,"Four-year, large, highly residential",7680,2874,4806,1226,592,634,7680,2229,5031,420,1571,546,1025,282,129,153,239,101,138,49,28,21,GA05
139719,Fort Valley State University, ,1005 State University Dr,Fort Valley,GA,31030-4313,-83.89537,32.537595,Public,Graduate degree or certificate offering,Yes,Town: Fringe,Master's Colleges & Universities: Small Programs,"Postbaccalaureate: Other-dominant, with Arts & Sciences",Very high undergraduate,"Four-year, small, highly residential",340,84,256,8,5,3,340,94,189,57,83,21,62,2,2,0,0,0,0,0,0,0,GA02
139755,Georgia Institute of Technology-Main Campus,Georgia Tech,225 North Ave,Atlanta,GA,30332-0530,-84.394832,33.77242,Public,Graduate degree or certificate offering,No,City: Large,Doctoral Universities: Very High Research Activity,"Research Doctoral: Comprehensive programs, no medical/veterinary school",Majority undergraduate,"Four-year, large, highly residential",29799,22318,7481,10692,7641,3051,29799,16364,5127,8308,4762,3482,1280,1809,1276,533,577,404,173,336,247,89,GA05
139764,Georgia Southwestern State University,"GSW, Georgia Southwestern",800 Georgia Southwestern State University Dr.,Americus,GA,31709-4693,-84.217738,32.054662,Public,Graduate degree or certificate offering,No,Town: Distant,Master's Colleges & Universities: Medium Programs,"Postbaccalaureate: Education-dominant, with Arts & Sciences",High undergraduate,"Four-year, small, primarily residential",858,169,689,42,25,17,858,492,366,0,160,28,132,6,4,2,0,0,0,0,0,0,GA02
139861,Georgia College & State University,Georgia College,231 W Hancock Street,Milledgeville,GA,31061,-83.231962,33.082787,Public,Graduate degree or certificate offering,No,Town: Distant,Master's Colleges & Universities: Larger Programs,"Postbaccalaureate: Education-dominant, with Arts & Sciences",High undergraduate,"Four-year, medium, primarily residential",1714,512,1202,11,7,4,1714,1196,494,24,535,177,358,7,5,2,0,0,0,0,0,0,GA08
139931,Georgia Southern University, ,1332 Southern Drive,Statesboro,GA,30460-8126,-81.784045,32.426153,Public,Graduate degree or certificate offering,No,Town: Distant,Doctoral Universities: High Research Activity,Research Doctoral: Professional-dominant,Very high undergraduate,"Four-year, large, primarily residential",4320,1194,3126,172,88,84,4320,2648,1345,327,1103,306,797,54,32,22,76,24,52,8,2,6,GA12
139940,Georgia State University, ,33 gilmer st,Atlanta,GA,30303-3083,-84.38667,33.7527,Public,Graduate degree or certificate offering,No,City: Large,Doctoral Universities: Very High Research Activity,"Research Doctoral: Comprehensive programs, no medical/veterinary school",High undergraduate,"Four-year, large, primarily nonresidential",9117,3335,5782,1442,675,767,9117,2788,5913,416,1921,682,1239,411,177,234,252,91,161,63,30,33,GA05
139959,University of Georgia, ,Administration Building,Athens,GA,30602,-83.374039,33.956262,Public,Graduate degree or certificate offering,No,City: Midsize,Doctoral Universities: Very High Research Activity,"Research Doctoral: Comprehensive programs, with medical/veterinary school",High undergraduate,"Four-year, large, primarily residential",10510,4149,6361,1581,778,803,10510,961,2579,6970,1952,755,1197,221,87,134,469,208,261,135,64,71,GA10
140146,Interdenominational Theological Center, ,700 Martin Luther King Jr Dr SW,Atlanta,GA,30314-4143,-84.409207,33.752338,Private not-for-profit,Graduate degree or certificate offering,Yes,City: Large,Special Focus Four-Year: Faith-Related Institutions,Postbaccalaureate: Single program-Other,Exclusively graduate,Exclusively graduate/professional,329,182,147,3,2,1,329,329,0,0,41,25,16,1,1,0,0,0,0,0,0,0,GA05
140234,LaGrange College, ,601 Broad Street,Lagrange,GA,30240-2999,-85.043113,33.038564,Private not-for-profit,Graduate degree or certificate offering,No,Town: Distant,Baccalaureate Colleges: Diverse Fields,"Postbaccalaureate: Education-dominant, with Arts & Sciences",High undergraduate,"Four-year, very small, highly residential",190,54,136,2,0,2,190,96,83,11,72,24,48,2,0,2,0,0,0,0,0,0,GA03
140252,Life University, ,1269 Barclay Circle,Marietta,GA,30060,-84.514729,33.932781,Private not-for-profit,Graduate degree or certificate offering,No,City: Small,Master's Colleges & Universities: Larger Programs,"Postbaccalaureate: Other-dominant, with Arts & Sciences",Majority graduate,"Four-year, small, highly residential",2111,1009,1102,73,35,38,2111,129,146,1836,61,20,41,3,0,3,0,0,0,0,0,0,GA11
140340,Herzing University-Atlanta, ,50 Hurt Plaza SE  Ste. 400,Atlanta,GA,30303,-84.387251,33.754218,Private not-for-profit,Graduate degree or certificate offering,No,City: Large,Baccalaureate Colleges: Diverse Fields,Postbaccalaureate: Single program-Business,Very high undergraduate,"Four-year, very small, primarily nonresidential",75,21,54,0,0,0,75,42,26,7,39,12,27,0,0,0,0,0,0,0,0,0,GA05
140447,Mercer University, ,1501 Mercer University Drive,Macon,GA,31207,-83.648295,32.831787,Private not-for-profit,Graduate degree or certificate offering,No,City: Midsize,Doctoral Universities: High Research Activity,Research Doctoral: Professional-dominant,Majority undergraduate,"Four-year, medium, highly residential",4794,1548,3246,184,81,103,4794,986,2470,1338,950,298,652,48,19,29,41,11,30,4,1,3,GA02
140562,Morehouse School of Medicine,MSM,"720 Westview Drive, S.W.",Atlanta,GA,30310,-84.41186,33.742888,Private not-for-profit,Graduate degree or certificate offering,Yes,City: Large,Special Focus Four-Year: Medical Schools & Centers,Research Doctoral: Single program-Other,Exclusively graduate,Exclusively graduate/professional,746,293,453,0,0,0,746,62,0,684,66,25,41,0,0,0,10,3,7,0,0,0,GA05
140818,Piedmont University, ,1021 Central Ave,Demorest,GA,30535-0010,-83.542126,34.566042,Private not-for-profit,Graduate degree or certificate offering,No,Town: Distant,Master's Colleges & Universities: Larger Programs,Research Doctoral: Single program-Education,Majority undergraduate,"Four-year, small, highly residential",1582,290,1292,1,0,1,1582,1293,273,16,259,41,218,0,0,0,16,3,13,0,0,0,GA09
140872,Reinhardt University, ,7300 Reinhardt Circle,Waleska,GA,30183-2981,-84.554264,34.319756,Private not-for-profit,Graduate degree or certificate offering,No,Rural: Fringe,Baccalaureate Colleges: Diverse Fields,"Postbaccalaureate: Business-dominant, with Arts & Sciences",Very high undergraduate,"Four-year, small, highly residential",129,65,64,1,1,0,129,60,14,55,51,30,21,0,0,0,0,0,0,0,0,0,GA11
140951,Savannah College of Art and Design,SCAD,342 Bull St,Savannah,GA,31402-3146,-81.09395,32.072964,Private not-for-profit,Graduate degree or certificate offering,No,City: Midsize,Master's Colleges & Universities: Larger Programs,"Postbaccalaureate: Other-dominant, with Arts & Sciences",High undergraduate,"Four-year, large, primarily residential",3153,985,2168,1589,484,1105,3153,492,1744,917,837,288,549,443,146,297,0,0,0,0,0,0,GA01
140960,Savannah State University, ,3219 College Street,Savannah,GA,31404-5310,-81.063377,32.024781,Public,Graduate degree or certificate offering,Yes,City: Midsize,Master's Colleges & Universities: Small Programs,"Postbaccalaureate: Other-dominant, with Arts & Sciences",Very high undergraduate,"Four-year, small, highly residential",273,86,187,15,8,7,273,19,228,26,79,28,51,7,2,5,0,0,0,0,0,0,GA01
140988,Shorter University,Shorter,315 Shorter Ave,Rome,GA,30165,-85.196529,34.257543,Private not-for-profit,Graduate degree or certificate offering,No,City: Small,Master's Colleges & Universities: Small Programs,Postbaccalaureate: Single program-Business,Very high undergraduate,"Four-year, small, highly residential",172,81,91,1,1,0,172,172,0,0,66,23,43,0,0,0,0,0,0,0,0,0,GA14
141167,Thomas University,TU,1501 Millpond Rd,Thomasville,GA,31792,-83.963587,30.815576,Private not-for-profit,Graduate degree or certificate offering,No,Town: Distant,Master's Colleges & Universities: Medium Programs,"Postbaccalaureate: Education-dominant, with other professional programs",Majority undergraduate,"Four-year, very small, primarily nonresidential",709,112,597,1,1,0,709,243,466,0,138,25,113,1,1,0,0,0,0,0,0,0,GA02
141185,Toccoa Falls College, ,107 Kincaid Drive,Toccoa Falls,GA,30598,-83.357617,34.593414,Private not-for-profit,Graduate degree or certificate offering,No,Town: Distant,Baccalaureate Colleges: Diverse Fields,Not classified (Exclusively Undergraduate),Very high undergraduate,"Four-year, very small, highly residential",24,15,9,0,0,0,24,24,0,0,0,0,0,0,0,0,0,0,0,0,0,0,GA09
141237,Truett McConnell University, ,100 Alumni Dr,Cleveland,GA,30528,-83.748911,34.596306,Private not-for-profit,Graduate degree or certificate offering,No,Town: Distant,Baccalaureate Colleges: Diverse Fields,"Postbaccalaureate: Business-dominant, with Arts & Sciences",Very high undergraduate,"Four-year, very small, highly residential",109,47,62,3,0,3,109,42,29,38,31,14,17,0,0,0,0,0,0,0,0,0,GA09
141264,Valdosta State University,VSU; Valdosta State; Valdosta State College; V-State,1500 N Patterson St,Valdosta,GA,31698,-83.289282,30.847402,Public,Graduate degree or certificate offering,No,City: Small,Doctoral/Professional Universities,Research Doctoral: Professional-dominant,High undergraduate,"Four-year, medium, primarily residential",3559,862,2697,50,18,32,3559,2822,646,91,759,171,588,21,5,16,42,6,36,0,0,0,GA08
141325,Wesleyan College, ,4760 Forsyth Road,Macon,GA,31210-4462,-83.715417,32.876037,Private not-for-profit,Graduate degree or certificate offering,No,City: Midsize,Baccalaureate Colleges: Diverse Fields,"Postbaccalaureate: Business-dominant, with other professional programs",Very high undergraduate,"Four-year, very small, highly residential",58,7,51,2,0,2,58,0,17,41,33,6,27,2,0,2,0,0,0,0,0,0,GA08
141334,University of West Georgia, ,1601 Maple St,Carrollton,GA,30118-0001,-85.097762,33.573621,Public,Graduate degree or certificate offering,No,Town: Fringe,Doctoral/Professional Universities,Research Doctoral: Professional-dominant,High undergraduate,"Four-year, medium, primarily residential",4102,897,3205,43,18,25,4102,3468,591,43,675,139,536,11,3,8,30,9,21,0,0,0,GA03
141361,Young Harris College,YHC  Young Harris,1 College Street,Young Harris,GA,30582,-83.84587,34.933523,Private not-for-profit,Graduate degree or certificate offering,No,Rural: Remote,Baccalaureate Colleges: Arts & Sciences Focus,Postbaccalaureate: Single program-Education,Very high undergraduate,"Four-year, very small, highly residential",38,14,24,1,0,1,38,0,38,0,18,8,10,1,0,1,0,0,0,0,0,0,GA09
141486,Chaminade University of Honolulu, ,3140 Waialae Avenue,Honolulu,HI,96816-1578,-157.807851,21.28995,Private not-for-profit,Graduate degree or certificate offering,No,City: Large,Master's Colleges & Universities: Medium Programs,"Postbaccalaureate: Education-dominant, with other professional programs",High undergraduate,"Four-year, small, primarily nonresidential",791,219,572,37,11,26,791,234,348,209,241,70,171,28,10,18,0,0,0,0,0,0,HI01
141565,University of Hawaii at Hilo,UH Hilo / UHH,200 W Kawili St,Hilo,HI,96720-4091,-155.080847,19.701189,Public,Graduate degree or certificate offering,No,Town: Remote,Doctoral/Professional Universities,Research Doctoral: Single program-Other,High undergraduate,"Four-year, small, primarily residential",561,179,382,14,8,6,561,197,321,43,55,17,38,1,0,1,2,2,0,1,1,0,HI02
141574,University of Hawaii at Manoa,UH Manoa / UHM,2500 Campus Road,Honolulu,HI,96822-2217,-157.818979,21.298598,Public,Graduate degree or certificate offering,No,City: Large,Doctoral Universities: Very High Research Activity,"Research Doctoral: Comprehensive programs, with medical/veterinary school",High undergraduate,"Four-year, large, primarily residential",5466,2104,3362,756,365,391,5466,2296,2083,1087,850,281,569,135,64,71,142,61,81,36,12,24,HI01
141644,Hawaii Pacific University, ,1 Aloha Tower Drive,Honolulu,HI,96813,-157.859645,21.310306,Private not-for-profit,Graduate degree or certificate offering,No,City: Large,Master's Colleges & Universities: Larger Programs,Postbaccalaureate: Comprehensive programs,High undergraduate,"Four-year, small, primarily nonresidential",571,239,332,42,17,25,571,146,241,184,199,92,107,24,8,16,0,0,0,0,0,0,HI01
142115,Boise State University,Boise State,1910 University Dr,Boise,ID,83725,-116.203301,43.604284,Public,Graduate degree or certificate offering,No,City: Midsize,Doctoral Universities: High Research Activity,Research Doctoral: STEM-dominant,High undergraduate,"Four-year, large, primarily nonresidential",5862,1808,4054,181,101,80,5862,4017,745,1100,1075,382,693,46,27,19,44,27,17,8,6,2,ID02
142276,Idaho State University,ISU,921 S 8th Ave,Pocatello,ID,83209,-112.432312,42.863832,Public,Graduate degree or certificate offering,No,City: Small,Doctoral Universities: High Research Activity,"Research Doctoral: Comprehensive programs, no medical/veterinary school",High undergraduate,"Four-year, medium, primarily nonresidential",2578,1022,1556,106,59,47,2578,632,1242,704,452,163,289,18,10,8,35,17,18,3,3,0,ID02
142285,University of Idaho,UIdaho,875 Perimeter Drive MS 2282,Moscow,ID,83844-2282,-117.014167,46.727406,Public,Graduate degree or certificate offering,No,Town: Distant,Doctoral Universities: High Research Activity,Research Doctoral: STEM-dominant,High undergraduate,"Four-year, medium, primarily residential",2893,1540,1353,336,222,114,2893,832,694,1367,464,254,210,69,39,30,80,48,32,32,21,11,ID01
142294,The College of Idaho,C of I,2112 Cleveland Blvd,Caldwell,ID,83605-4432,-116.677992,43.652284,Private not-for-profit,Graduate degree or certificate offering,No,Suburb: Midsize,Baccalaureate Colleges: Diverse Fields,Postbaccalaureate: Single program-Education,Very high undergraduate,"Four-year, small, highly residential",34,7,27,0,0,0,34,0,0,34,9,3,6,0,0,0,0,0,0,0,0,0,ID01
142461,Northwest Nazarene University,Northwest Nazarene University/Northwest Nazarene College/NNU/NNC/Northwest Nazarene University,623 S. University Blvd.,Nampa,ID,83686-5897,-116.565783,43.562411,Private not-for-profit,Graduate degree or certificate offering,No,Suburb: Midsize,Master's Colleges & Universities: Larger Programs,Research Doctoral: Single program-Education,Majority undergraduate,"Four-year, small, highly residential",859,229,630,4,2,2,859,410,179,270,215,57,158,1,0,1,9,4,5,0,0,0,ID01
142832,Adler University, ,17 North Dearborn Street,Chicago,IL,60602,-87.629156,41.882414,Private not-for-profit,Graduate degree or certificate offering,No,City: Large,Special Focus Four-Year: Other Health Professions Schools,"Postbaccalaureate: Other-dominant, with Arts & Sciences",Exclusively graduate,Exclusively graduate/professional,2365,425,1940,14,2,12,2365,2365,0,0,397,75,322,1,0,1,0,0,0,0,0,0,IL07
142957,American Islamic College, ,640 W Irving Park RD,Chicago,IL,60613,-87.646898,41.954969,Private not-for-profit,Graduate degree or certificate offering,No,City: Large,nan,nan,nan,nan,14,8,6,0,0,0,14,14,0,0,1,1,0,0,0,0,0,0,0,0,0,0,IL09
143048,School of the Art Institute of Chicago, ,36 S Wabash,Chicago,IL,60603,-87.625758,41.88105,Private not-for-profit,Graduate degree or certificate offering,No,City: Large,"Special Focus Four-Year: Arts, Music & Design Schools","Postbaccalaureate: Other-dominant, with Arts & Sciences",High undergraduate,"Four-year, small, primarily residential",716,183,533,219,66,153,716,92,606,18,242,63,179,81,19,62,0,0,0,0,0,0,IL07
143084,Augustana College, ,639 38th St,Rock Island,IL,61201-2296,-90.55057,41.502365,Private not-for-profit,Graduate degree or certificate offering,No,City: Small,Baccalaureate Colleges: Arts & Sciences Focus,Not classified (Exclusively Undergraduate),Very high undergraduate,"Four-year, small, highly residential",21,0,21,0,0,0,21,0,0,21,0,0,0,0,0,0,0,0,0,0,0,0,IL17
143118,Aurora University, ,347 S Gladstone Ave,Aurora,IL,60506-4892,-88.349023,41.753631,Private not-for-profit,Graduate degree or certificate offering,No,Suburb: Large,Doctoral/Professional Universities,Research Doctoral: Professional-dominant,Majority undergraduate,"Four-year, medium, primarily nonresidential",2791,579,2212,4,1,3,2791,1937,722,132,903,190,713,3,0,3,39,15,24,0,0,0,IL11
143233,Bethany Theological Seminary, ,615 National Rd W,Richmond,IN,47374-4019,-84.910689,39.826244,Private not-for-profit,Graduate degree or certificate offering,No,Town: Distant,Special Focus Four-Year: Faith-Related Institutions,Postbaccalaureate: Single program-Other,Exclusively graduate,Exclusively graduate/professional,79,46,33,3,1,2,79,79,0,0,15,5,10,2,1,1,0,0,0,0,0,0,IN06
143297,Blessing Rieman College of Nursing and Health Sciences,BRCN/B-RCN/Blessing-Rieman,3609 North Marx Drive,Quincy,IL,62305-7005,-91.357497,39.949641,Private not-for-profit,Graduate degree or certificate offering,No,Town: Remote,Special Focus Four-Year: Other Health Professions Schools,Postbaccalaureate: Single program-Other,Very high undergraduate,"Four-year, very small, primarily nonresidential",21,1,20,0,0,0,21,20,0,1,7,1,6,0,0,0,0,0,0,0,0,0,IL15
143358,Bradley University, ,1501 W BRADLEY AVE,Peoria,IL,61625-0001,-89.616786,40.696896,Private not-for-profit,Graduate degree or certificate offering,No,City: Midsize,Doctoral/Professional Universities,"Postbaccalaureate: Other-dominant, with Arts & Sciences",High undergraduate,"Four-year, medium, primarily residential",1625,347,1278,124,68,56,1625,1255,276,94,284,89,195,39,22,17,0,0,0,0,0,0,IL17
143659,Catholic Theological Union at Chicago,CTU,5416 S Cornell Ave,Chicago,IL,60615-5698,-87.585989,41.797895,Private not-for-profit,Graduate degree or certificate offering,No,City: Large,Special Focus Four-Year: Faith-Related Institutions,Postbaccalaureate: Single program-Other,Exclusively graduate,Exclusively graduate/professional,273,170,103,71,53,18,273,273,0,0,47,30,17,17,10,7,0,0,0,0,0,0,IL02
143853,Midwestern University-Downers Grove, ,555 31st Street,Downers Grove,IL,60515-5514,-87.998342,41.828115,Private not-for-profit,Graduate degree or certificate offering,No,Suburb: Large,Special Focus Four-Year: Medical Schools & Centers,"Postbaccalaureate: Other-dominant, with Arts & Sciences",Exclusively graduate,Exclusively graduate/professional,3214,1155,2059,34,13,21,3214,0,0,3214,247,61,186,1,1,0,0,0,0,0,0,0,IL06
143978,The Chicago School of Professional Psychology at Chicago, ,325 N Wells Street,Chicago,IL,60654,-87.63379,41.888293,Private not-for-profit,Graduate degree or certificate offering,No,City: Large,Special Focus Four-Year: Other Health Professions Schools,Research Doctoral: Humanities/social sciences-dominant,Majority graduate,Exclusively graduate/professional,1360,267,1093,68,14,54,1360,49,463,848,231,34,197,12,0,12,28,14,14,2,1,1,IL07
144005,Chicago State University,CSU,9501 S. King Drive,Chicago,IL,60628-1598,-87.609384,41.718446,Public,Graduate degree or certificate offering,No,City: Large,Master's Colleges & Universities: Larger Programs,Research Doctoral: Single program-Education,Majority undergraduate,"Four-year, small, primarily nonresidential",1185,355,830,63,31,32,1185,161,215,809,132,35,97,17,6,11,6,2,4,0,0,0,IL01
144014,Chicago Theological Seminary, ,1407 E. 60th Street,Chicago,IL,60637,-87.591178,41.785701,Private not-for-profit,Graduate degree or certificate offering,No,City: Large,Special Focus Four-Year: Faith-Related Institutions,Research Doctoral: Single program-Other,Exclusively graduate,Exclusively graduate/professional,359,159,200,3,1,2,359,352,0,7,35,12,23,0,0,0,5,4,1,0,0,0,IL01
144050,University of Chicago, ,5801 S Ellis Ave,Chicago,IL,60637,-87.599539,41.787994,Private not-for-profit,Graduate degree or certificate offering,No,City: Large,Doctoral Universities: Very High Research Activity,"Research Doctoral: Comprehensive programs, with medical/veterinary school",Majority graduate,"Four-year, large, highly residential",11605,6550,5055,3874,2231,1643,11605,6289,5316,0,3309,1845,1464,1246,669,577,457,277,180,184,125,59,IL01
144281,Columbia College Chicago, ,600 South Michigan Ave,Chicago,IL,60605-1996,-87.624667,41.874261,Private not-for-profit,Graduate degree or certificate offering,No,City: Large,Master's Colleges & Universities: Medium Programs,"Postbaccalaureate: Other-dominant, with Arts & Sciences",Very high undergraduate,"Four-year, medium, primarily residential",249,89,160,57,30,27,249,0,0,249,74,24,50,14,6,8,0,0,0,0,0,0,IL07
144351,Concordia University-Chicago,Concordia University Chicago,7400 Augusta,River Forest,IL,60305-1499,-87.809482,41.898696,Private not-for-profit,Graduate degree or certificate offering,No,Suburb: Large,Master's Colleges & Universities: Larger Programs,Research Doctoral: Professional-dominant,Majority graduate,"Four-year, medium, highly residential",6521,2121,4400,288,128,160,6521,6119,260,142,1377,456,921,0,0,0,137,59,78,0,0,0,IL07
144740,DePaul University, ,1 E Jackson Blvd,Chicago,IL,60604,-87.62724,41.877618,Private not-for-profit,Graduate degree or certificate offering,No,City: Large,Doctoral Universities: High Research Activity,"Research Doctoral: Comprehensive programs, no medical/veterinary school",Majority undergraduate,"Four-year, large, primarily nonresidential",9645,4277,5368,953,485,468,9645,5938,3308,399,2751,1211,1540,307,150,157,50,19,31,2,0,2,IL07
144892,Eastern Illinois University,EIU|E.I.U.|Eastern,600 Lincoln Avenue,Charleston,IL,61920,-88.175658,39.479843,Public,Graduate degree or certificate offering,No,Town: Distant,Master's Colleges & Universities: Larger Programs,Postbaccalaureate: Comprehensive programs,High undergraduate,"Four-year, medium, highly residential",2125,702,1423,218,116,102,2125,1122,523,480,675,223,452,116,57,59,0,0,0,0,0,0,IL15
144962,Elmhurst University, ,190 Prospect Ave,Elmhurst,IL,60126-3296,-87.945369,41.897164,Private not-for-profit,Graduate degree or certificate offering,No,Suburb: Large,Master's Colleges & Universities: Larger Programs,"Postbaccalaureate: Business-dominant, with Arts & Sciences",High undergraduate,"Four-year, medium, primarily residential",679,217,462,19,10,9,679,184,353,142,246,79,167,4,1,3,0,0,0,0,0,0,IL06
145275,Garrett-Evangelical Theological Seminary, ,2121 Sheridan Road,Evanston,IL,60201-3298,-87.675497,42.056221,Private not-for-profit,Graduate degree or certificate offering,No,City: Small,Special Focus Four-Year: Faith-Related Institutions,Research Doctoral: Single program-Other,Exclusively graduate,Exclusively graduate/professional,341,156,185,47,32,15,341,313,0,28,42,23,19,10,9,1,6,5,1,2,2,0,IL09
145336,Governors State University,GSU,1 University Pky,University Park,IL,60484,-87.716441,41.449103,Public,Graduate degree or certificate offering,No,Rural: Fringe,Master's Colleges & Universities: Larger Programs,Research Doctoral: Professional-dominant,Majority undergraduate,"Four-year, medium, primarily nonresidential",2037,620,1417,214,131,83,2037,339,420,1278,429,130,299,75,48,27,12,3,9,1,0,1,IL02
145372,Greenville University, ,315 E. College Ave.,Greenville,IL,62246,-89.40824,38.894162,Private not-for-profit,Graduate degree or certificate offering,No,Town: Distant,Master's Colleges & Universities: Small Programs,"Postbaccalaureate: Education-dominant, with other professional programs",Very high undergraduate,"Four-year, very small, highly residential",291,88,203,1,1,0,291,279,6,6,76,23,53,0,0,0,0,0,0,0,0,0,IL15
145558,Rosalind Franklin University of Medicine and Science,RFUMS,3333 Green Bay Road,North Chicago,IL,60064-3095,-87.859632,42.300069,Private not-for-profit,Graduate degree or certificate offering,No,Suburb: Large,Special Focus Four-Year: Medical Schools & Centers,Research Doctoral: Professional-dominant,Exclusively graduate,Exclusively graduate/professional,2320,994,1326,44,21,23,2320,178,1878,264,205,70,135,2,1,1,13,7,6,1,1,0,IL10
145600,University of Illinois Chicago,UIC|U of I-Chicago|Illinois-Chicago|U of I-Medical Center|University of Illinois-Medical Center|,601 S Morgan,Chicago,IL,60607,-87.650503,41.871837,Public,Graduate degree or certificate offering,No,City: Large,Doctoral Universities: Very High Research Activity,"Research Doctoral: Comprehensive programs, with medical/veterinary school",Majority undergraduate,"Four-year, large, primarily nonresidential",13067,5287,7780,2324,1271,1053,13067,1181,4076,7810,2193,885,1308,731,426,305,334,170,164,121,72,49,IL07
145619,Benedictine University, ,5700 College Rd,Lisle,IL,60532-0900,-88.097307,41.777569,Private not-for-profit,Graduate degree or certificate offering,No,Suburb: Large,Master's Colleges & Universities: Larger Programs,Research Doctoral: Professional-dominant,Majority undergraduate,"Four-year, small, primarily nonresidential",3092,949,2143,32,15,17,3092,2961,128,3,887,228,659,13,5,8,29,16,13,2,2,0,IL11
145628,Illinois College of Optometry, ,3241 S Michigan Ave,Chicago,IL,60616-3878,-87.623016,41.835447,Private not-for-profit,Graduate degree or certificate offering,No,City: Large,Special Focus Four-Year: Other Health Professions Schools,Postbaccalaureate: Single program-Other,Exclusively graduate,Exclusively graduate/professional,536,158,378,96,26,70,536,0,0,536,0,0,0,0,0,0,0,0,0,0,0,0,IL01
145637,University of Illinois Urbana-Champaign,Illinois|Illinios|Ilinois|Ilinios|Urbana|Champaign|Champagne|Champaign-Urbana|Champagne-Urbana|Urbana-Champaign|Urbana-Champagne|University of Illinois at Urbana|University of Illinois at Champaign|University of Illinois at Champagne|University of Illinois at Champaign-Urbana|University of Illinois at Champagne-Urbana|UIUC|UICU|University of Illinois at UC|University of Illinois at CU,601 E John Street,Champaign,IL,61820-5711,-88.229114,40.104718,Public,Graduate degree or certificate offering,No,City: Small,Doctoral Universities: Very High Research Activity,"Research Doctoral: Comprehensive programs, with medical/veterinary school",Majority undergraduate,"Four-year, large, primarily residential",23759,13146,10613,6643,4089,2554,23759,14531,7666,1562,4812,2564,2248,1715,980,735,733,427,306,337,223,114,IL13
145725,Illinois Institute of Technology,Illinois Tech,10 West 35th Street,Chicago,IL,60616,-87.627321,41.8313,Private not-for-profit,Graduate degree or certificate offering,No,City: Large,Doctoral Universities: High Research Activity,Research Doctoral: STEM-dominant,Majority undergraduate,"Four-year, medium, highly residential",3885,2323,1562,2126,1381,745,3885,1083,744,2058,1110,668,442,779,470,309,88,47,41,61,40,21,IL01
145813,Illinois State University, ,North and School Streets,Normal,IL,61790-1000,-88.990058,40.509403,Public,Graduate degree or certificate offering,No,Suburb: Midsize,Doctoral Universities: High Research Activity,Research Doctoral: Professional-dominant,Very high undergraduate,"Four-year, large, primarily residential",3198,1122,2076,518,277,241,3198,1562,1317,319,820,312,508,202,103,99,47,13,34,4,1,3,IL17
145886,Institute for Clinical Social Work, ,1345 W Argyle Street,Chicago,IL,60640-1229,-87.662806,41.972414,Private not-for-profit,Graduate degree or certificate offering,No,City: Large,Special Focus Four-Year: Other Health Professions Schools,Research Doctoral: Single program-Other,Exclusively graduate,Exclusively graduate/professional,134,25,109,0,0,0,134,0,0,134,10,2,8,0,0,0,9,1,8,0,0,0,IL09
146339,Judson University, ,1151 N State St,Elgin,IL,60123-1498,-88.291336,42.061754,Private not-for-profit,Graduate degree or certificate offering,No,City: Midsize,Master's Colleges & Universities: Small Programs,Research Doctoral: Single program-Education,High undergraduate,"Four-year, small, highly residential",297,108,189,68,48,20,297,57,135,105,73,20,53,2,2,0,8,2,6,0,0,0,IL08
146481,Lake Forest College, ,555 N Sheridan Road,Lake Forest,IL,60045-2338,-87.827454,42.249574,Private not-for-profit,Graduate degree or certificate offering,No,Suburb: Large,Baccalaureate Colleges: Arts & Sciences Focus,"Postbaccalaureate: Education-dominant, with Arts & Sciences",Very high undergraduate,"Four-year, small, highly residential",46,14,32,0,0,0,46,7,39,0,13,3,10,0,0,0,0,0,0,0,0,0,IL10
146490,Lake Forest Graduate School of Management, ,1905 W. Field Court,Lake Forest,IL,60045,-87.893204,42.243432,Private not-for-profit,Graduate degree or certificate offering,No,Suburb: Large,Special Focus Four-Year: Business & Management Schools,Postbaccalaureate: Single program-Business,Exclusively graduate,Exclusively graduate/professional,507,228,279,0,0,0,507,507,0,0,122,57,65,0,0,0,0,0,0,0,0,0,IL10
146612,Lewis University,Lewis College  Lewis College of Science and Technology  Lewis School of Aeronautics  Lewis Holy Name School of Aeronautics  Lewis Holy Name Technical School  Holy Name Technical School,One University Parkway,Romeoville,IL,60446-2200,-88.079032,41.605432,Private not-for-profit,Graduate degree or certificate offering,No,Suburb: Large,Master's Colleges & Universities: Larger Programs,Research Doctoral: Single program-Education,High undergraduate,"Four-year, medium, primarily residential",2795,871,1924,143,87,56,2795,1637,1012,146,691,239,452,37,25,12,5,1,4,0,0,0,IL14
146667,Lincoln Christian University,Lincoln Christian College and Seminary,100 Campus View Drive,Lincoln,IL,62656-2111,-89.346721,40.148924,Private not-for-profit,Graduate degree or certificate offering,No,Town: Distant,Master's Colleges & Universities: Small Programs,"Postbaccalaureate: Other-dominant, with Arts & Sciences",Majority undergraduate,"Four-year, very small, highly residential",326,199,127,12,7,5,326,83,140,103,94,62,32,6,5,1,0,0,0,0,0,0,IL15
146676,Lincoln College, ,300 Keokuk St,Lincoln,IL,62656,-89.36153,40.155442,Private not-for-profit,Graduate degree or certificate offering,No,Town: Distant,Baccalaureate Colleges: Diverse Fields,Not classified (Exclusively Undergraduate),Very high undergraduate,"Four-year, very small, primarily residential",33,9,24,1,1,0,33,0,33,0,0,0,0,0,0,0,0,0,0,0,0,0,IL15
146719,Loyola University Chicago, ,1032 W. Sheridan Rd,Chicago,IL,60660,-87.656872,42.000765,Private not-for-profit,Graduate degree or certificate offering,No,City: Large,Doctoral Universities: High Research Activity,"Research Doctoral: Comprehensive programs, with medical/veterinary school",Majority undergraduate,"Four-year, large, primarily residential",5964,1966,3998,260,120,140,5964,5212,306,446,1245,367,878,106,46,60,121,38,83,19,4,15,IL09
146728,Lutheran School of Theology at Chicago,LSTC,1100 E 55th St,Chicago,IL,60615-5134,-87.598978,41.79563,Private not-for-profit,Graduate degree or certificate offering,No,City: Large,Special Focus Four-Year: Faith-Related Institutions,Research Doctoral: Single program-Other,Exclusively graduate,Exclusively graduate/professional,151,65,86,36,20,16,151,151,0,0,41,15,26,7,4,3,2,0,2,1,0,1,IL01
146755,Trinity College of Nursing & Health Sciences,Trinity College|Trinity College of Nursing and Health Sciences|Trinity College of Nursing,2122 25th Avenue,Rock Island,IL,61201-5317,-90.568862,41.484924,Private not-for-profit,Graduate degree or certificate offering,No,City: Small,Special Focus Four-Year: Other Health Professions Schools,Postbaccalaureate: Single program-Other,High undergraduate,"Four-year, very small, primarily nonresidential",32,3,29,0,0,0,32,0,30,2,11,1,10,0,0,0,0,0,0,0,0,0,IL17
146977,McCormick Theological Seminary, ,5460 S. University,Chicago,IL,60615,-87.598511,41.79597,Private not-for-profit,Graduate degree or certificate offering,No,City: Large,Special Focus Four-Year: Faith-Related Institutions,Postbaccalaureate: Single program-Other,Exclusively graduate,Exclusively graduate/professional,246,145,101,22,16,6,246,246,0,0,27,13,14,2,2,0,0,0,0,0,0,0,IL01
147013,McKendree University, ,701 College Rd,Lebanon,IL,62254-1291,-89.816822,38.608154,Private not-for-profit,Graduate degree or certificate offering,No,Suburb: Large,Master's Colleges & Universities: Medium Programs,Research Doctoral: Professional-dominant,High undergraduate,"Four-year, small, highly residential",694,232,462,12,11,1,694,284,205,205,187,60,127,2,2,0,19,5,14,0,0,0,IL12
147031,Meadville Theological School of Lombard College,Meadville Lombard Theological School,180 N. Wabash Avenue,Chicago,IL,60601,-87.62671,41.885452,Private not-for-profit,Graduate degree or certificate offering,No,City: Large,Special Focus Four-Year: Faith-Related Institutions,"Postbaccalaureate: Other-dominant, with Arts & Sciences",Exclusively graduate,Exclusively graduate/professional,87,31,56,4,1,3,87,87,0,0,14,4,10,0,0,0,0,0,0,0,0,0,IL07
147129,Methodist College, ,7600 N. Academic Drive,Peoria,IL,61615,-89.682864,40.7804,Private not-for-profit,Graduate degree or certificate offering,No,City: Midsize,Special Focus Four-Year: Other Health Professions Schools,Postbaccalaureate: Single program-Other,Very high undergraduate,"Four-year, very small, primarily nonresidential",45,5,40,0,0,0,45,8,36,1,13,1,12,0,0,0,0,0,0,0,0,0,IL16
147244,Millikin University, ,1184 W Main St,Decatur,IL,62522-2084,-88.976298,39.842612,Private not-for-profit,Graduate degree or certificate offering,No,City: Small,Baccalaureate Colleges: Diverse Fields,"Postbaccalaureate: Business-dominant, with other professional programs",Very high undergraduate,"Four-year, small, primarily residential",130,46,84,7,2,5,130,6,82,42,37,13,24,2,0,2,0,0,0,0,0,0,IL13
147369,Moody Bible Institute,Moody Theological Seminary and Graduate School; Moody Theological Seminary and Graduate School--Michigan; Moody Bible Institute Aviation--Spokane,820 N LaSalle Blvd,Chicago,IL,60610-3284,-87.633459,41.897822,Private not-for-profit,Graduate degree or certificate offering,No,City: Large,Special Focus Four-Year: Faith-Related Institutions,"Postbaccalaureate: Other-dominant, with other professional programs",High undergraduate,"Four-year, small, highly residential",926,603,323,99,60,39,926,408,291,227,188,131,57,19,9,10,0,0,0,0,0,0,IL07
147536,National Louis University, ,122 S Michigan Ave,Chicago,IL,60603,-87.624699,41.880093,Private not-for-profit,Graduate degree or certificate offering,No,City: Large,Doctoral/Professional Universities,Research Doctoral: Professional-dominant,Majority undergraduate,"Four-year, medium, primarily nonresidential",5531,972,4559,23,3,20,5531,1927,1756,1848,1095,215,880,2,1,1,139,34,105,0,0,0,IL07
147590,National University of Health Sciences,National College of Chiropractic,200 E Roosevelt Rd,Lombard,IL,60148-4583,-88.013171,41.861697,Private not-for-profit,Graduate degree or certificate offering,No,Suburb: Large,Special Focus Four-Year: Other Health Professions Schools,Postbaccalaureate: Single program-Other,Majority graduate,"Four-year, very small, primarily nonresidential",606,270,336,14,5,9,606,17,589,0,26,9,17,2,2,0,0,0,0,0,0,0,IL06
147660,North Central College,NCC|North Central|Cardinals|North Central University|University of Naperville|Naperville University,30 N Brainard St,Naperville,IL,60540,-88.14279,41.77576,Private not-for-profit,Graduate degree or certificate offering,No,City: Midsize,Master's Colleges & Universities: Small Programs,"Postbaccalaureate: Other-dominant, with Arts & Sciences",High undergraduate,"Four-year, small, highly residential",409,113,296,3,1,2,409,198,151,60,123,32,91,2,1,1,0,0,0,0,0,0,IL11
147679,North Park University, ,3225 W Foster Ave,Chicago,IL,60625-4895,-87.709948,41.975268,Private not-for-profit,Graduate degree or certificate offering,No,City: Large,Master's Colleges & Universities: Larger Programs,"Postbaccalaureate: Business-dominant, with Arts & Sciences",High undergraduate,"Four-year, small, highly residential",1167,431,736,22,8,14,1167,905,223,39,274,89,185,0,0,0,0,0,0,0,0,0,IL03
147697,Northern Baptist Theological Seminary,Northern Seminary,"410 Warrenville Road, Suite 300",Lisle,IL,60532-1348,-88.056162,41.809104,Private not-for-profit,Graduate degree or certificate offering,No,Suburb: Large,Special Focus Four-Year: Faith-Related Institutions,"Postbaccalaureate: Other-dominant, with Arts & Sciences",Exclusively graduate,Exclusively graduate/professional,325,215,110,12,11,1,325,19,274,32,43,23,20,1,0,1,0,0,0,0,0,0,IL06
147703,Northern Illinois University, ,1425 W. Lincoln Hwy.,Dekalb,IL,60115-2828,-88.766428,41.933869,Public,Graduate degree or certificate offering,No,Suburb: Small,Doctoral Universities: High Research Activity,"Research Doctoral: Comprehensive programs, no medical/veterinary school",High undergraduate,"Four-year, large, primarily residential",5349,2198,3151,672,380,292,5349,3125,1758,466,1181,552,629,218,133,85,99,41,58,21,11,10,IL14
147767,Northwestern University, ,633 Clark St,Evanston,IL,60208,-87.679858,42.050356,Private not-for-profit,Graduate degree or certificate offering,No,City: Small,Doctoral Universities: Very High Research Activity,"Research Doctoral: Comprehensive programs, with medical/veterinary school",Majority graduate,"Four-year, large, primarily residential",16648,8179,8469,3506,2019,1487,16648,1762,2090,12796,4367,2215,2152,1126,643,483,461,271,190,176,119,57,IL09
147776,Northeastern Illinois University, ,5500 N Saint Louis Ave,Chicago,IL,60625-4699,-87.718983,41.980399,Public,Graduate degree or certificate offering,No,City: Large,Master's Colleges & Universities: Larger Programs,Postbaccalaureate: Comprehensive programs,High undergraduate,"Four-year, medium, primarily nonresidential",2489,813,1676,79,28,51,2489,2421,67,1,476,144,332,24,6,18,0,0,0,0,0,0,IL05
147828,Olivet Nazarene University, ,One University Avenue,Bourbonnais,IL,60914-2271,-87.875165,41.155237,Private not-for-profit,Graduate degree or certificate offering,No,Suburb: Small,Master's Colleges & Universities: Larger Programs,Research Doctoral: Single program-Education,High undergraduate,"Four-year, small, highly residential",1291,309,982,1,1,0,1291,1191,42,58,452,93,359,0,0,0,10,2,8,0,0,0,IL02
148131,Quincy University, ,1800 College Ave,Quincy,IL,62301-2699,-91.385975,39.938898,Private not-for-profit,Graduate degree or certificate offering,No,Town: Remote,Baccalaureate Colleges: Diverse Fields,"Postbaccalaureate: Education-dominant, with other professional programs",Very high undergraduate,"Four-year, small, highly residential",308,124,184,7,5,2,308,188,68,52,45,20,25,2,1,1,0,0,0,0,0,0,IL15
148405,Rockford University,Rockford College,5050 E State St,Rockford,IL,61108-2311,-89.019536,42.270639,Private not-for-profit,Graduate degree or certificate offering,No,City: Midsize,Master's Colleges & Universities: Small Programs,"Postbaccalaureate: Education-dominant, with other professional programs",High undergraduate,"Four-year, small, primarily residential",363,127,236,10,3,7,363,0,0,363,93,36,57,4,2,2,0,0,0,0,0,0,IL17
148487,Roosevelt University, ,430 S Michigan Ave,Chicago,IL,60605-1394,-87.624952,41.876055,Private not-for-profit,Graduate degree or certificate offering,No,City: Large,Doctoral/Professional Universities,Research Doctoral: Professional-dominant,Majority undergraduate,"Four-year, medium, primarily residential",1968,586,1382,128,54,74,1968,345,1097,526,665,216,449,51,20,31,2,0,2,0,0,0,IL07
148496,Dominican University,Dominican,7900 W Division Street,River Forest,IL,60305,-87.823003,41.902678,Private not-for-profit,Graduate degree or certificate offering,No,Suburb: Large,Master's Colleges & Universities: Larger Programs,Research Doctoral: Single program-Other,High undergraduate,"Four-year, small, primarily nonresidential",1392,286,1106,25,13,12,1392,303,964,125,320,65,255,5,2,3,4,0,4,1,0,1,IL07
148511,Rush University,Rush University Medical Center,600 S. Paulina St. STE 440,Chicago,IL,60612,-87.668581,41.874742,Private not-for-profit,Graduate degree or certificate offering,No,City: Large,Special Focus Four-Year: Medical Schools & Centers,Research Doctoral: STEM-dominant,Majority graduate,"Four-year, small, primarily nonresidential",3231,741,2490,34,16,18,3231,904,1871,456,386,86,300,9,1,8,18,7,11,1,1,0,IL07
148575,Saint Francis Medical Center College of Nursing,St. Francis Medical Center College of Nursing   St. Francis Medical Center College of Nursing  SFMCCoN,511 NE Greenleaf St,Peoria,IL,61603-3783,-89.590322,40.701241,Private not-for-profit,Graduate degree or certificate offering,No,City: Midsize,Special Focus Four-Year: Other Health Professions Schools,Postbaccalaureate: Single program-Other,High undergraduate,"Four-year, very small, primarily residential",199,29,170,0,0,0,199,199,0,0,43,4,39,0,0,0,0,0,0,0,0,0,IL17
148584,University of St Francis, ,500 N Wilcox St,Joliet,IL,60435-6188,-88.096057,41.532225,Private not-for-profit,Graduate degree or certificate offering,No,Suburb: Large,Doctoral/Professional Universities,Research Doctoral: Single program-Education,Majority undergraduate,"Four-year, small, primarily residential",3148,686,2462,25,18,7,3148,2534,461,153,494,116,378,14,11,3,28,10,18,0,0,0,IL14
148593,St. John's College-Department of Nursing,St Johns School of Nursing  St John's College of Nursing,729 E. Carpenter St,Springfield,IL,62702,-89.64532,39.807602,Private not-for-profit,Graduate degree or certificate offering,No,City: Midsize,Special Focus Four-Year: Other Health Professions Schools,Postbaccalaureate: Single program-Other,Very high undergraduate,"Four-year, very small, primarily nonresidential",11,2,9,0,0,0,11,1,0,10,4,1,3,0,0,0,0,0,0,0,0,0,IL13
148627,Saint Xavier University,St. Xavier University   St Xavier University,3700 W 103rd St,Chicago,IL,60655,-87.714749,41.707199,Private not-for-profit,Graduate degree or certificate offering,No,City: Large,Master's Colleges & Universities: Larger Programs,"Postbaccalaureate: Other-dominant, with Arts & Sciences",High undergraduate,"Four-year, medium, primarily nonresidential",951,245,706,0,0,0,951,399,452,100,225,77,148,0,0,0,0,0,0,0,0,0,IL06
148654,University of Illinois Springfield,UIS,One University Plaza,Springfield,IL,62703-5407,-89.616796,39.729524,Public,Graduate degree or certificate offering,No,City: Midsize,Master's Colleges & Universities: Larger Programs,Research Doctoral: Single program-Other,Majority undergraduate,"Four-year, small, primarily residential",1914,933,981,255,143,112,1914,1505,360,49,442,227,215,106,53,53,8,2,6,0,0,0,IL13
148885,University of Saint Mary of the Lake,University of St. Mary of the Lake University,1000 E Maple Ave,Mundelein,IL,60060-1174,-88.000262,42.280702,Private not-for-profit,Graduate degree or certificate offering,No,Suburb: Large,Special Focus Four-Year: Faith-Related Institutions,Postbaccalaureate: Single program-Other,Exclusively graduate,Exclusively graduate/professional,194,174,20,13,13,0,194,0,27,167,41,40,1,7,7,0,0,0,0,0,0,0,IL10
148982,Spertus College,Spertus Institute of Jewish Studies  Spertus Institute for Jewish Learning and Leadership,610 S Michigan Ave,Chicago,IL,60605,-87.624785,41.873881,Private not-for-profit,Graduate degree or certificate offering,No,City: Large,Special Focus Four-Year: Faith-Related Institutions,Research Doctoral: Single program-Other,Exclusively graduate,Exclusively graduate/professional,169,66,103,0,0,0,169,46,123,0,25,12,13,0,0,0,3,2,1,0,0,0,IL07
149028,Saint Anthony College of Nursing,"SACN, St. Anthony College of Nursing",3301 N. Mulford Road,Rockford,IL,61114,-88.991968,42.310147,Private not-for-profit,Graduate degree or certificate offering,No,City: Midsize,Special Focus Four-Year: Other Health Professions Schools,Postbaccalaureate: Single program-Other,High undergraduate,"Four-year, very small, primarily nonresidential",99,5,94,0,0,0,99,0,0,99,4,0,4,0,0,0,0,0,0,0,0,0,IL17
149222,Southern Illinois University-Carbondale, ,Lincoln Drive,Carbondale,IL,62901-4512,-89.217273,37.714193,Public,Graduate degree or certificate offering,No,City: Small,Doctoral Universities: High Research Activity,"Research Doctoral: Comprehensive programs, with medical/veterinary school",High undergraduate,"Four-year, medium, highly residential",3479,1618,1861,642,359,283,3479,646,576,2257,671,300,371,122,66,56,105,57,48,54,33,21,IL12
149231,Southern Illinois University-Edwardsville,SIUE,Il State Rte 157,Edwardsville,IL,62026-1259,-89.997779,38.793949,Public,Graduate degree or certificate offering,No,Suburb: Large,Doctoral/Professional Universities,Research Doctoral: Single program-Education,High undergraduate,"Four-year, large, primarily residential",3679,1392,2287,265,151,114,3679,2116,1401,162,692,275,417,97,50,47,8,4,4,0,0,0,IL13
149329,Telshe Yeshiva-Chicago, ,3535 West Foster,Chicago,IL,60625,-87.71755,41.975536,Private not-for-profit,Graduate degree or certificate offering,No,City: Large,nan,nan,nan,nan,12,12,0,0,0,0,12,0,0,12,1,1,0,0,0,0,0,0,0,0,0,0,IL05
149505,Trinity Christian College, ,6601 W College Dr,Palos Heights,IL,60463-0929,-87.783973,41.667687,Private not-for-profit,Graduate degree or certificate offering,No,Suburb: Large,Baccalaureate Colleges: Diverse Fields,"Postbaccalaureate: Other-dominant, with other professional programs",Very high undergraduate,"Four-year, very small, highly residential",89,8,81,1,0,1,89,0,21,68,23,1,22,0,0,0,0,0,0,0,0,0,IL06
149514,Trinity International University-Illinois, ,2065 Half Day Rd,Deerfield,IL,60015-1283,-87.880851,42.197945,Private not-for-profit,Graduate degree or certificate offering,No,Suburb: Large,Doctoral/Professional Universities,Research Doctoral: Single program-Other,Majority graduate,"Four-year, small, highly residential",1099,777,322,258,194,64,1099,351,410,338,157,105,52,29,22,7,36,30,6,12,10,2,IL10
149639,VanderCook College of Music, ,3140 South Federal Street,Chicago,IL,60616-3731,-87.629138,41.836833,Private not-for-profit,Graduate degree or certificate offering,No,City: Large,Special Focus Four-Year: Other Special Focus Institutions,Postbaccalaureate: Single program-Education,Majority graduate,"Four-year, very small, primarily nonresidential",1054,418,636,15,4,11,1054,855,59,140,42,28,14,1,0,1,0,0,0,0,0,0,IL07
149763,Oak Point University,Oak Point,2122 York Road,Oak Brook,IL,60523,-87.930551,41.848066,Private not-for-profit,Graduate degree or certificate offering,No,Suburb: Large,Special Focus Four-Year: Other Health Professions Schools,Postbaccalaureate: Single program-Other,Very high undergraduate,"Four-year, very small, primarily nonresidential",99,15,84,0,0,0,99,55,0,44,27,4,23,0,0,0,0,0,0,0,0,0,IL04
149772,Western Illinois University, ,1 University Circle,Macomb,IL,61455,-90.686899,40.468086,Public,Graduate degree or certificate offering,No,Town: Remote,Master's Colleges & Universities: Larger Programs,Research Doctoral: Single program-Education,High undergraduate,"Four-year, medium, primarily residential",2156,834,1322,316,177,139,2156,862,959,335,556,229,327,117,64,53,16,4,12,1,0,1,IL17
149781,Wheaton College, ,501 College Ave,Wheaton,IL,60187-5593,-88.099643,41.870176,Private not-for-profit,Graduate degree or certificate offering,No,Suburb: Large,Baccalaureate Colleges: Arts & Sciences Focus,Research Doctoral: Single program-Other,High undergraduate,"Four-year, small, highly residential",803,287,516,110,50,60,803,136,279,388,176,68,108,42,13,29,4,4,0,0,0,0,IL03
150066,Anderson University, ,1100 E 5th St,Anderson,IN,46012-3495,-85.664315,40.112768,Private not-for-profit,Graduate degree or certificate offering,No,City: Small,Master's Colleges & Universities: Small Programs,Research Doctoral: Professional-dominant,Very high undergraduate,"Four-year, small, highly residential",307,154,153,24,15,9,307,123,146,38,62,37,25,4,3,1,5,3,2,0,0,0,IN05
150136,Ball State University,BSU|Ball U,2000 University Ave,Muncie,IN,47306,-85.409043,40.203431,Public,Graduate degree or certificate offering,No,City: Small,Doctoral Universities: High Research Activity,"Research Doctoral: Comprehensive programs, no medical/veterinary school",High undergraduate,"Four-year, large, primarily residential",7464,1647,5817,234,84,150,7464,6193,686,585,2357,466,1891,98,31,67,68,27,41,8,3,5,IN05
150145,Bethel University, ,1001 Bethel Circle,Mishawaka,IN,46545-5591,-86.194686,41.678399,Private not-for-profit,Graduate degree or certificate offering,No,City: Small,Master's Colleges & Universities: Small Programs,"Postbaccalaureate: Business-dominant, with other professional programs",Very high undergraduate,"Four-year, small, highly residential",241,85,156,9,6,3,241,180,42,19,90,27,63,2,0,2,0,0,0,0,0,0,IN02
150163,Butler University, ,4600 Sunset Ave,Indianapolis,IN,46208,-86.172167,39.8374,Private not-for-profit,Graduate degree or certificate offering,No,City: Large,Master's Colleges & Universities: Larger Programs,"Postbaccalaureate: Other-dominant, with Arts & Sciences",High undergraduate,"Four-year, medium, highly residential",1376,462,914,17,11,6,1376,215,674,487,249,108,141,4,3,1,0,0,0,0,0,0,IN07
150172,Calumet College of Saint Joseph,"CCSJ, CAL COLLEGE, CALUMET COLLEGE;  Calumet College of St. Joseph   Calumet College of St Joseph",2400 New York Ave,Whiting,IN,46394,-87.494123,41.671008,Private not-for-profit,Graduate degree or certificate offering,No,Suburb: Large,Master's Colleges & Universities: Small Programs,"Postbaccalaureate: Other-dominant, with Arts & Sciences",High undergraduate,"Four-year, very small, primarily nonresidential",178,77,101,0,0,0,178,0,91,87,48,26,22,0,0,0,0,0,0,0,0,0,IN01
150215,Christian Theological Seminary, ,1000 W 42nd St,Indianapolis,IN,46208-3301,-86.178551,39.832673,Private not-for-profit,Graduate degree or certificate offering,No,City: Large,Special Focus Four-Year: Faith-Related Institutions,"Postbaccalaureate: Other-dominant, with other professional programs",Exclusively graduate,Exclusively graduate/professional,177,68,109,1,1,0,177,174,0,3,29,17,12,0,0,0,0,0,0,0,0,0,IN07
150288,Concordia Theological Seminary, ,6600 N Clinton St,Fort Wayne,IN,46825-4996,-85.10994,41.139321,Private not-for-profit,Graduate degree or certificate offering,No,City: Large,Special Focus Four-Year: Faith-Related Institutions,Research Doctoral: Single program-Other,Exclusively graduate,Exclusively graduate/professional,357,307,50,22,21,1,357,12,50,295,65,49,16,8,8,0,10,10,0,4,4,0,IN03
150455,Earlham College,Earlham,801 National Rd West,Richmond,IN,47374-4095,-84.915037,39.823431,Private not-for-profit,Graduate degree or certificate offering,No,Town: Distant,Baccalaureate Colleges: Arts & Sciences Focus,"Postbaccalaureate: Other-dominant, with Arts & Sciences",Very high undergraduate,"Four-year, very small, highly residential",109,41,68,5,3,2,109,68,0,41,21,6,15,2,2,0,0,0,0,0,0,0,IN06
150534,University of Evansville,UE | Aces | Evansville | Purple Aces,1800 Lincoln Avenue,Evansville,IN,47722,-87.531644,37.971549,Private not-for-profit,Graduate degree or certificate offering,No,City: Midsize,Master's Colleges & Universities: Medium Programs,"Postbaccalaureate: Other-dominant, with other professional programs",High undergraduate,"Four-year, small, highly residential",365,109,256,8,5,3,365,5,43,317,87,24,63,7,5,2,0,0,0,0,0,0,IN08
150604,Franklin College,Franklin College of Indiana,101 Branigin Blvd,Franklin,IN,46131-2623,-86.047182,39.478298,Private not-for-profit,Graduate degree or certificate offering,No,Suburb: Large,Baccalaureate Colleges: Arts & Sciences Focus,Postbaccalaureate: Single program-Other,Very high undergraduate,"Four-year, very small, highly residential",80,16,64,0,0,0,80,0,0,80,25,3,22,0,0,0,0,0,0,0,0,0,IN06
150668,Goshen College, ,1700 S Main St,Goshen,IN,46526-4794,-85.827795,41.563582,Private not-for-profit,Graduate degree or certificate offering,No,City: Small,Baccalaureate Colleges: Diverse Fields,"Postbaccalaureate: Other-dominant, with other professional programs",Very high undergraduate,"Four-year, very small, highly residential",78,8,70,1,0,1,78,15,57,6,36,6,30,1,0,1,0,0,0,0,0,0,IN02
150677,Grace College and Theological Seminary, ,1 Lancer Way,Winona Lake,IN,46590-1274,-85.814228,41.22595,Private not-for-profit,Graduate degree or certificate offering,No,Town: Distant,Master's Colleges & Universities: Medium Programs,"Postbaccalaureate: Other-dominant, with other professional programs",Very high undergraduate,"Four-year, small, highly residential",388,232,156,42,35,7,388,221,97,70,150,80,70,12,12,0,0,0,0,0,0,0,IN02
150941,Huntington University, ,2303 College Ave,Huntington,IN,46750,-85.497317,40.898152,Private not-for-profit,Graduate degree or certificate offering,No,Town: Distant,Master's Colleges & Universities: Small Programs,"Postbaccalaureate: Other-dominant, with other professional programs",High undergraduate,"Four-year, small, highly residential",283,55,228,5,3,2,283,87,12,184,48,14,34,1,0,1,0,0,0,0,0,0,IN03
151102,Purdue University Fort Wayne,IPFW|IUPUFW|Purdue University-Fort Wayne|Purdue-Fort Wayne|Purdue Fort Wayne,2101 E Coliseum Blvd,Fort Wayne,IN,46805-1499,-85.108962,41.117278,Public,Graduate degree or certificate offering,No,City: Large,Master's Colleges & Universities: Medium Programs,"Postbaccalaureate: Business-dominant, with Arts & Sciences",Very high undergraduate,"Four-year, medium, primarily nonresidential",618,297,321,116,70,46,618,99,363,156,219,121,98,58,38,20,0,0,0,0,0,0,IN03
151111,Indiana University-Purdue University-Indianapolis,IUPUI,420 University Blvd,Indianapolis,IN,46202-5143,-86.172217,39.772948,Public,Graduate degree or certificate offering,No,City: Large,Doctoral Universities: High Research Activity,Research Doctoral: STEM-dominant,High undergraduate,"Four-year, large, primarily nonresidential",9869,3788,6081,1043,555,488,9869,2497,5709,1663,1929,678,1251,299,175,124,101,43,58,25,10,15,IN07
151263,University of Indianapolis,UIndy,1400 E Hanna Ave,Indianapolis,IN,46227-3697,-86.133969,39.709571,Private not-for-profit,Graduate degree or certificate offering,No,City: Large,Doctoral/Professional Universities,Research Doctoral: Professional-dominant,High undergraduate,"Four-year, medium, highly residential",1495,378,1117,49,17,32,1495,596,705,194,374,104,270,21,7,14,44,9,35,0,0,0,IN06
151290,Indiana Institute of Technology,"Indiana Tech, IIT",1600 E Washington Blvd,Fort Wayne,IN,46803-1228,-85.116479,41.078365,Private not-for-profit,Graduate degree or certificate offering,No,City: Large,Master's Colleges & Universities: Larger Programs,Research Doctoral: Single program-Other,Majority undergraduate,"Four-year, small, primarily residential",993,503,490,83,59,24,993,879,59,55,219,109,110,30,23,7,9,5,4,0,0,0,IN03
151306,University of Southern Indiana,USI,8600 University Blvd,Evansville,IN,47712,-87.677214,37.962374,Public,Graduate degree or certificate offering,No,Suburb: Midsize,Master's Colleges & Universities: Larger Programs,"Postbaccalaureate: Business-dominant, with Arts & Sciences",High undergraduate,"Four-year, medium, primarily residential",2606,1004,1602,52,27,25,2606,2436,151,19,761,290,471,14,7,7,0,0,0,0,0,0,IN08
151324,Indiana State University,Indiana State  ISU,210 N 7th St,Terre Haute,IN,47809,-87.407846,39.469073,Public,Graduate degree or certificate offering,No,City: Small,Doctoral/Professional Universities,Research Doctoral: Professional-dominant,High undergraduate,"Four-year, medium, primarily residential",2352,822,1530,143,71,72,2352,1186,589,577,512,163,349,55,26,29,43,16,27,0,0,0,IN08
151333,Indiana University-Kokomo,IU Kokomo | IUK | IU KO,2300 S Washington St,Kokomo,IN,46902-9003,-86.132048,40.460062,Public,Graduate degree or certificate offering,No,City: Small,Master's Colleges & Universities: Small Programs,"Postbaccalaureate: Business-dominant, with Arts & Sciences",Very high undergraduate,"Four-year, small, primarily nonresidential",281,88,193,22,6,16,281,71,91,119,91,28,63,12,6,6,0,0,0,0,0,0,IN05
151342,Indiana University-South Bend,IUSB | IU SB | IU South Bend,1700 Mishawaka Ave,South Bend,IN,46615-7111,-86.221991,41.665324,Public,Graduate degree or certificate offering,No,City: Midsize,Master's Colleges & Universities: Medium Programs,"Postbaccalaureate: Education-dominant, with Arts & Sciences",Very high undergraduate,"Four-year, medium, primarily nonresidential",716,214,502,29,8,21,716,361,274,81,110,32,78,5,1,4,0,0,0,0,0,0,IN02
151351,Indiana University-Bloomington,IUB | IU Bloomington,107 South Indiana Ave.,Bloomington,IN,47405-7000,-86.526559,39.16609,Public,Graduate degree or certificate offering,No,City: Small,Doctoral Universities: Very High Research Activity,"Research Doctoral: Comprehensive programs, no medical/veterinary school",High undergraduate,"Four-year, large, primarily residential",11755,6293,5462,2826,1553,1273,11755,4826,4805,2124,2641,1507,1134,711,390,321,445,226,219,156,86,70,IN09
151360,Indiana University-Northwest,IUN | IU Northwest,3400 Broadway,Gary,IN,46408-1197,-87.337249,41.557324,Public,Graduate degree or certificate offering,No,City: Small,Master's Colleges & Universities: Small Programs,"Postbaccalaureate: Business-dominant, with Arts & Sciences",Very high undergraduate,"Four-year, small, primarily nonresidential",490,128,362,3,1,2,490,145,289,56,74,20,54,0,0,0,0,0,0,0,0,0,IN01
151379,Indiana University-Southeast,IUSE | IU SE | IU Southeast,4201 Grant Line Rd,New Albany,IN,47150,-85.819985,38.345191,Public,Graduate degree or certificate offering,No,Suburb: Large,Master's Colleges & Universities: Medium Programs,"Postbaccalaureate: Education-dominant, with Arts & Sciences",Very high undergraduate,"Four-year, medium, primarily nonresidential",857,287,570,9,2,7,857,452,340,65,160,59,101,4,0,4,0,0,0,0,0,0,IN09
151388,Indiana University-East,IUE | IU East,2325 Chester Blvd,Richmond,IN,47374-1289,-84.881923,39.868707,Public,Graduate degree or certificate offering,No,Rural: Fringe,Master's Colleges & Universities: Small Programs,"Postbaccalaureate: Other-dominant, with Arts & Sciences",Very high undergraduate,"Four-year, small, primarily nonresidential",434,124,310,0,0,0,434,355,42,37,52,10,42,0,0,0,0,0,0,0,0,0,IN06
151777,Manchester University, ,604 E. College Ave,North Manchester,IN,46962,-85.762643,41.010549,Private not-for-profit,Graduate degree or certificate offering,No,Town: Distant,Master's Colleges & Universities: Small Programs,"Postbaccalaureate: Other-dominant, with Arts & Sciences",High undergraduate,"Four-year, small, highly residential",392,139,253,11,2,9,392,33,359,0,50,15,35,0,0,0,0,0,0,0,0,0,IN02
151786,Marian University,Marian,3200 Cold Spring Rd,Indianapolis,IN,46222-1997,-86.202643,39.813233,Private not-for-profit,Graduate degree or certificate offering,No,City: Large,Doctoral/Professional Universities,"Postbaccalaureate: Other-dominant, with Arts & Sciences",Majority undergraduate,"Four-year, medium, primarily residential",1405,563,842,26,12,14,1405,199,724,482,174,54,120,4,2,2,0,0,0,0,0,0,IN07
151801,Indiana Wesleyan University-Marion,IWU,4201 South Washington Street,Marion,IN,46953-4974,-85.667503,40.517937,Private not-for-profit,Graduate degree or certificate offering,No,Town: Distant,Master's Colleges & Universities: Small Programs,"Postbaccalaureate: Education-dominant, with Arts & Sciences",High undergraduate,"Four-year, small, highly residential",478,100,378,5,2,3,478,378,75,25,121,30,91,1,1,0,0,0,0,0,0,0,IN05
151810,Martin University, ,2186 North Sherman Drive,Indianapolis,IN,46218-0567,-86.103953,39.798144,Private not-for-profit,Graduate degree or certificate offering,No,City: Large,Baccalaureate Colleges: Arts & Sciences Focus,"Postbaccalaureate: Other-dominant, with Arts & Sciences",High undergraduate,"Four-year, very small, primarily nonresidential",66,16,50,1,1,0,66,0,66,0,30,9,21,0,0,0,0,0,0,0,0,0,IN07
151865,Anabaptist Mennonite Biblical Seminary,AMBS | Mennonite Biblical Seminary | Mennonite Seminary,3003 Benham Ave,Elkhart,IN,46517-1999,-85.972165,41.656013,Private not-for-profit,Graduate degree or certificate offering,No,City: Small,Special Focus Four-Year: Faith-Related Institutions,Postbaccalaureate: Single program-Other,Exclusively graduate,Exclusively graduate/professional,127,66,61,46,31,15,127,67,34,26,19,12,7,6,5,1,0,0,0,0,0,0,IN02
152080,University of Notre Dame,Notre Dame | Fighting Irish | ND,400 Main Building,Notre Dame,IN,46556,-86.238959,41.703058,Private not-for-profit,Graduate degree or certificate offering,No,Suburb: Large,Doctoral Universities: Very High Research Activity,"Research Doctoral: Comprehensive programs, no medical/veterinary school",Majority undergraduate,"Four-year, large, highly residential",4281,2422,1859,916,564,352,4281,318,2790,1173,1047,608,439,218,127,91,239,141,98,82,51,31,IN02
152099,Oakland City University, ,138 N Lucretia St,Oakland City,IN,47660-1099,-87.35144,38.340891,Private not-for-profit,Graduate degree or certificate offering,No,Town: Distant,Doctoral/Professional Universities,Research Doctoral: Single program-Education,High undergraduate,"Four-year, very small, highly residential",366,171,195,2,1,1,366,24,138,204,44,20,24,0,0,0,25,9,16,0,0,0,IN08
152318,Rose-Hulman Institute of Technology,R-HIT|RHIT|Rose Polytechnic|Rose Polytechnic Institute|RP|RPI|Rose-Hulman|Rose Hulman|Rose-Hulman Institute|Rose Hulman Institute|Rose,5500 Wabash Avenue,Terre Haute,IN,47803-3920,-87.326749,39.483602,Private not-for-profit,Graduate degree or certificate offering,No,City: Small,Special Focus Four-Year: Engineering and Other Technology-Related Schools,"Postbaccalaureate: Other-dominant, with Arts & Sciences",Very high undergraduate,"Four-year, small, highly residential",26,23,3,7,7,0,26,0,17,9,12,11,1,2,2,0,0,0,0,0,0,0,IN08
152336,University of Saint Francis-Fort Wayne,"University of Saint Francis of Fort Wayne, Indiana  University of Saint Francis  Saint Francis College  University of St. Francis-Fort Wayne   University of St Francis-Fort Wayne  USF",2701 Spring St,Fort Wayne,IN,46808-3994,-85.177246,41.087205,Private not-for-profit,Graduate degree or certificate offering,No,City: Large,Master's Colleges & Universities: Medium Programs,"Postbaccalaureate: Other-dominant, with Arts & Sciences",High undergraduate,"Four-year, small, primarily nonresidential",793,201,592,5,0,5,793,553,48,192,238,56,182,1,0,1,0,0,0,0,0,0,IN03
152381,Saint Mary-of-the-Woods College,St. Mary-of-the-Woods College   St Mary-of-the-Woods College,1 St Mary of Woods Coll,Saint Mary of the Woods,IN,47876-1099,-87.463791,39.508546,Private not-for-profit,Graduate degree or certificate offering,No,Rural: Fringe,Master's Colleges & Universities: Small Programs,"Postbaccalaureate: Other-dominant, with other professional programs",High undergraduate,"Four-year, very small, primarily residential",375,42,333,6,1,5,375,182,193,0,70,4,66,0,0,0,0,0,0,0,0,0,IN08
152390,Saint Mary's College,St. Mary's College   St Mary's College,133 Le Mans Hall,Notre Dame,IN,46556,-86.256947,41.707274,Private not-for-profit,Graduate degree or certificate offering,No,Suburb: Large,Baccalaureate Colleges: Arts & Sciences Focus,"Postbaccalaureate: Other-dominant, with Arts & Sciences",Very high undergraduate,"Four-year, small, highly residential",156,18,138,0,0,0,156,80,4,72,31,1,30,0,0,0,0,0,0,0,0,0,IN02
152451,Saint Meinrad School of Theology,Saint Meinrad Seminary and School of Theology,200 Hill Drive,St. Meinrad,IN,47577,-86.810388,38.165546,Private not-for-profit,Graduate degree or certificate offering,No,Rural: Remote,Special Focus Four-Year: Faith-Related Institutions,Postbaccalaureate: Single program-Other,Exclusively graduate,Exclusively graduate/professional,250,201,49,35,33,2,250,62,133,55,46,39,7,10,10,0,0,0,0,0,0,0,IN08
152530,Taylor University, ,236 W Reade Ave,Upland,IN,46989-1001,-85.497034,40.456246,Private not-for-profit,Graduate degree or certificate offering,No,Town: Distant,Baccalaureate Colleges: Diverse Fields,Postbaccalaureate: Single program-Education,Very high undergraduate,"Four-year, small, highly residential",37,17,20,0,0,0,37,0,0,37,13,6,7,0,0,0,0,0,0,0,0,0,IN05
152567,Trine University, ,1 University Ave,Angola,IN,46703-1764,-85.008009,41.632502,Private not-for-profit,Graduate degree or certificate offering,No,Town: Distant,Baccalaureate Colleges: Diverse Fields,"Postbaccalaureate: Other-dominant, with Arts & Sciences",Very high undergraduate,"Four-year, small, highly residential",203,64,139,0,0,0,203,0,0,203,27,9,18,0,0,0,0,0,0,0,0,0,IN03
152600,Valparaiso University,Valpo|VU,US Highway 30 and Sturdy Road,Valparaiso,IN,46383,-87.040172,41.462239,Private not-for-profit,Graduate degree or certificate offering,No,Suburb: Large,Doctoral/Professional Universities,Postbaccalaureate: Comprehensive programs,High undergraduate,"Four-year, small, highly residential",535,205,330,112,70,42,535,155,345,35,209,96,113,64,45,19,0,0,0,0,0,0,IN01
152798,Allen College, ,1990 Heath St,Waterloo,IA,50703-1999,-92.340148,42.530084,Private not-for-profit,Graduate degree or certificate offering,No,City: Small,Special Focus Four-Year: Other Health Professions Schools,Research Doctoral: Single program-Other,Majority undergraduate,"Four-year, very small, primarily nonresidential",331,31,300,1,0,1,331,31,233,67,89,10,79,0,0,0,1,0,1,0,0,0,IA02
152992,Briar Cliff University, ,3303 Rebecca Street,Sioux City,IA,51104,-96.428444,42.526443,Private not-for-profit,Graduate degree or certificate offering,No,City: Small,Doctoral/Professional Universities,"Postbaccalaureate: Other-dominant, with Arts & Sciences",High undergraduate,"Four-year, very small, highly residential",282,86,196,4,4,0,282,190,91,1,43,10,33,0,0,0,0,0,0,0,0,0,IA04
153001,Buena Vista University, ,610 W 4th St,Storm Lake,IA,50588,-95.208529,42.642255,Private not-for-profit,Graduate degree or certificate offering,No,Town: Remote,Master's Colleges & Universities: Medium Programs,"Postbaccalaureate: Education-dominant, with other professional programs",Very high undergraduate,"Four-year, small, highly residential",598,107,491,0,0,0,598,352,123,123,168,29,139,0,0,0,0,0,0,0,0,0,IA04
153126,Clarke University, ,1550 Clarke Dr,Dubuque,IA,52001-3198,-90.690487,42.509475,Private not-for-profit,Graduate degree or certificate offering,No,City: Small,Doctoral/Professional Universities,"Postbaccalaureate: Other-dominant, with other professional programs",High undergraduate,"Four-year, very small, highly residential",245,58,187,0,0,0,245,47,126,72,35,7,28,0,0,0,0,0,0,0,0,0,IA02
153162,Cornell College, ,600 First St. SW,Mount Vernon,IA,52314-1098,-91.423741,41.924554,Private not-for-profit,Graduate degree or certificate offering,No,Town: Fringe,Baccalaureate Colleges: Arts & Sciences Focus,Not classified (Exclusively Undergraduate),Very high undergraduate,"Four-year, very small, highly residential",10,3,7,0,0,0,10,5,2,3,0,0,0,0,0,0,0,0,0,0,0,0,IA02
153250,Dordt University, ,700 7th St SE,Sioux Center,IA,51250-1606,-96.166562,43.082527,Private not-for-profit,Graduate degree or certificate offering,No,Town: Remote,Master's Colleges & Universities: Small Programs,Postbaccalaureate: Single program-Education,Very high undergraduate,"Four-year, small, highly residential",296,124,172,5,2,3,296,294,2,0,58,33,25,3,1,2,0,0,0,0,0,0,IA04
153269,Drake University,Drake,2507 University Avenue,Des Moines,IA,50311-4505,-93.652163,41.60129,Private not-for-profit,Graduate degree or certificate offering,No,City: Midsize,Doctoral/Professional Universities,Research Doctoral: Single program-Education,Majority undergraduate,"Four-year, medium, highly residential",2396,763,1633,35,13,22,2396,1091,1164,141,404,114,290,9,3,6,19,9,10,0,0,0,IA03
153278,University of Dubuque, ,2000 University Ave,Dubuque,IA,52001,-90.693428,42.49726,Private not-for-profit,Graduate degree or certificate offering,No,City: Small,Master's Colleges & Universities: Medium Programs,"Postbaccalaureate: Business-dominant, with Arts & Sciences",High undergraduate,"Four-year, small, highly residential",562,239,323,12,6,6,562,25,157,380,140,60,80,7,2,5,0,0,0,0,0,0,IA02
153320,Faith Baptist Bible College and Theological Seminary,"FBBC&TS, FBBC",1900 NW 4th St,Ankeny,IA,50023-2152,-93.624422,41.737082,Private not-for-profit,Graduate degree or certificate offering,No,Suburb: Large,Baccalaureate Colleges: Diverse Fields,"Postbaccalaureate: Other-dominant, with Arts & Sciences",High undergraduate,"Four-year, very small, highly residential",110,94,16,6,5,1,110,35,39,36,7,5,2,0,0,0,0,0,0,0,0,0,IA03
153366,Graceland University-Lamoni, ,1 University Place,Lamoni,IA,50140,-93.924893,40.615966,Private not-for-profit,Graduate degree or certificate offering,No,Rural: Remote,Master's Colleges & Universities: Larger Programs,"Postbaccalaureate: Other-dominant, with Arts & Sciences",Majority undergraduate,"Four-year, small, highly residential",666,105,561,14,3,11,666,625,41,0,198,35,163,3,1,2,0,0,0,0,0,0,IA03
153375,Grand View University, ,1200 Grandview Ave,Des Moines,IA,50316,-93.604352,41.620813,Private not-for-profit,Graduate degree or certificate offering,No,City: Midsize,Master's Colleges & Universities: Small Programs,"Postbaccalaureate: Business-dominant, with other professional programs",Very high undergraduate,"Four-year, small, highly residential",257,94,163,3,2,1,257,122,81,54,38,13,25,0,0,0,0,0,0,0,0,0,IA03
153603,Iowa State University,ISU,1750 Beardshear Hall,Ames,IA,50011-2103,-93.648504,42.026212,Public,Graduate degree or certificate offering,No,City: Small,Doctoral Universities: Very High Research Activity,"Research Doctoral: Comprehensive programs, with medical/veterinary school",High undergraduate,"Four-year, large, primarily residential",5558,2781,2777,1695,1037,658,5558,1129,1564,2865,937,481,456,249,151,98,327,201,126,165,111,54,IA04
153621,Iowa Wesleyan University, ,601 N Main Street,Mount Pleasant,IA,52641,-91.552459,40.973791,Private not-for-profit,Graduate degree or certificate offering,No,Town: Remote,Baccalaureate Colleges: Diverse Fields,Postbaccalaureate: Single program-Business,Very high undergraduate,"Four-year, very small, highly residential",69,36,33,6,5,1,69,60,9,0,18,11,7,2,2,0,0,0,0,0,0,0,IA01
153658,University of Iowa,Iowa,101 Jessup Hall,Iowa City,IA,52242-1316,-91.536425,41.661935,Public,Graduate degree or certificate offering,No,City: Small,Doctoral Universities: Very High Research Activity,"Research Doctoral: Comprehensive programs, with medical/veterinary school",High undergraduate,"Four-year, large, primarily residential",9069,4250,4819,1144,626,518,9069,2928,884,5257,1486,726,760,188,115,73,398,200,198,107,66,41,IA01
153825,Loras College, ,1450 Alta Vista,Dubuque,IA,52004-0178,-90.679023,42.503908,Private not-for-profit,Graduate degree or certificate offering,No,City: Small,Baccalaureate Colleges: Diverse Fields,"Postbaccalaureate: Education-dominant, with Arts & Sciences",Very high undergraduate,"Four-year, small, highly residential",120,44,76,1,1,0,120,38,47,35,53,21,32,0,0,0,0,0,0,0,0,0,IA02
153861,Maharishi International University, ,1000 North 4th Street,Fairfield,IA,52557,-91.967306,41.017781,Private not-for-profit,Graduate degree or certificate offering,No,Town: Remote,Master's Colleges & Universities: Larger Programs,Research Doctoral: Humanities/social sciences-dominant,Majority graduate,"Four-year, small, primarily residential",2090,1366,724,1182,968,214,2090,999,427,664,467,344,123,303,254,49,2,1,1,2,1,1,IA01
154004,Morningside University, ,1501 Morningside Ave,Sioux City,IA,51106-1751,-96.359464,42.473891,Private not-for-profit,Graduate degree or certificate offering,No,City: Small,Master's Colleges & Universities: Larger Programs,"Postbaccalaureate: Education-dominant, with other professional programs",Majority undergraduate,"Four-year, small, highly residential",1944,352,1592,2,0,2,1944,1944,0,0,315,44,271,0,0,0,0,0,0,0,0,0,IA04
154013,Mount Mercy University,Mount Mercy College,1330 Elmhurst Dr NE,Cedar Rapids,IA,52402-4797,-91.650991,42.001931,Private not-for-profit,Graduate degree or certificate offering,No,City: Midsize,Master's Colleges & Universities: Medium Programs,"Postbaccalaureate: Business-dominant, with other professional programs",High undergraduate,"Four-year, small, primarily residential",417,128,289,8,4,4,417,199,111,107,155,47,108,8,4,4,0,0,0,0,0,0,IA02
154022,Ashford University, ,8620 Spectrum Center Boulevard,San Diego,CA,92123,-117.141961,32.8273,Private for-profit,Graduate degree or certificate offering,No,City: Large,Doctoral/Professional Universities,Research Doctoral: Professional-dominant,High undergraduate,"Four-year, large, primarily nonresidential",11565,3437,8128,30,16,14,11565,11565,0,0,3124,951,2173,9,6,3,64,20,44,0,0,0,CA51
154095,University of Northern Iowa,UNI Panthers Northern Iowa,1227 W 27th St,Cedar Falls,IA,50614-0005,-92.459703,42.514923,Public,Graduate degree or certificate offering,No,City: Small,Master's Colleges & Universities: Larger Programs,Postbaccalaureate: Comprehensive programs,Very high undergraduate,"Four-year, medium, primarily residential",1769,578,1191,201,79,122,1769,796,679,294,440,116,324,70,28,42,0,0,0,0,0,0,IA02
154101,Northwestern College, ,101 Seventh St SW,Orange City,IA,51041,-96.058772,42.999007,Private not-for-profit,Graduate degree or certificate offering,No,Town: Distant,Master's Colleges & Universities: Medium Programs,Postbaccalaureate: Single program-Education,High undergraduate,"Four-year, small, highly residential",771,166,605,4,1,3,771,713,0,58,102,15,87,0,0,0,0,0,0,0,0,0,IA04
154156,Des Moines University-Osteopathic Medical Center,Des Moines University,3200 Grand Ave,Des Moines,IA,50312,-93.661686,41.583325,Private not-for-profit,Graduate degree or certificate offering,No,City: Midsize,Special Focus Four-Year: Medical Schools & Centers,"Postbaccalaureate: Other-dominant, with Arts & Sciences",Exclusively graduate,Exclusively graduate/professional,1702,811,891,2,1,1,1702,171,887,644,150,44,106,0,0,0,0,0,0,0,0,0,IA03
154174,Palmer College of Chiropractic, ,1000 Brady St,Davenport,IA,52803-5287,-90.574607,41.529021,Private not-for-profit,Graduate degree or certificate offering,No,City: Midsize,Special Focus Four-Year: Other Health Professions Schools,Postbaccalaureate: Single program-Other,Majority graduate,"Four-year, small, highly residential",2596,1483,1113,1,1,0,2596,0,0,2596,0,0,0,0,0,0,0,0,0,0,0,0,IA01
154235,Saint Ambrose University,St. Ambrose University   St Ambrose University,518 W Locust St,Davenport,IA,52803-2898,-90.579854,41.54065,Private not-for-profit,Graduate degree or certificate offering,No,City: Midsize,Doctoral/Professional Universities,Research Doctoral: Single program-Other,High undergraduate,"Four-year, small, highly residential",753,224,529,12,5,7,753,122,179,452,200,57,143,6,2,4,4,3,1,0,0,0,IA01
154350,Simpson College, ,701 North C St,Indianola,IA,50125,-93.563471,41.365503,Private not-for-profit,Graduate degree or certificate offering,No,Town: Fringe,Baccalaureate Colleges: Diverse Fields,"Postbaccalaureate: Other-dominant, with other professional programs",Very high undergraduate,"Four-year, small, highly residential",72,31,41,2,1,1,72,16,19,37,11,4,7,0,0,0,0,0,0,0,0,0,IA01
154493,Upper Iowa University,UIU,605 Washington St,Fayette,IA,52142-1857,-91.799543,42.838283,Private not-for-profit,Graduate degree or certificate offering,No,Rural: Remote,Master's Colleges & Universities: Larger Programs,"Postbaccalaureate: Business-dominant, with other professional programs",High undergraduate,"Four-year, small, primarily residential",1059,355,704,18,12,6,1059,825,176,58,263,112,151,6,5,1,0,0,0,0,0,0,IA02
154518,Waldorf University, ,106 S Sixth St,Forest City,IA,50436-1713,-93.641714,43.262923,Private for-profit,Graduate degree or certificate offering,No,Town: Remote,Master's Colleges & Universities: Medium Programs,"Postbaccalaureate: Business-dominant, with other professional programs",Very high undergraduate,"Four-year, small, primarily nonresidential",818,516,302,14,8,6,818,818,0,0,242,157,85,0,0,0,0,0,0,0,0,0,IA04
154527,Wartburg College, ,100 Wartburg Blvd.,Waverly,IA,50677-0903,-92.483387,42.7277,Private not-for-profit,Graduate degree or certificate offering,No,Town: Distant,Baccalaureate Colleges: Arts & Sciences Focus,Not classified (Exclusively Undergraduate),Very high undergraduate,"Four-year, small, highly residential",18,6,12,0,0,0,18,17,1,0,0,0,0,0,0,0,0,0,0,0,0,0,IA02
154536,Wartburg Theological Seminary,Wartburg Seminary,333 Wartburg Pl,Dubuque,IA,52003-7769,-90.691225,42.485761,Private not-for-profit,Graduate degree or certificate offering,No,City: Small,Special Focus Four-Year: Faith-Related Institutions,Postbaccalaureate: Single program-Other,Exclusively graduate,Exclusively graduate/professional,220,81,139,1,0,1,220,11,170,39,36,14,22,0,0,0,0,0,0,0,0,0,IA02
154590,William Penn University, ,201 Trueblood Ave,Oskaloosa,IA,52577,-92.647095,41.310111,Private not-for-profit,Graduate degree or certificate offering,No,Town: Remote,Baccalaureate Colleges: Diverse Fields,Postbaccalaureate: Single program-Business,Very high undergraduate,"Four-year, small, highly residential",84,46,38,10,7,3,84,19,65,0,37,20,17,6,3,3,0,0,0,0,0,0,IA01
154688,Baker University,Baker|BU|Baker U,615 Dearborn Street,Baldwin City,KS,66006-0065,-95.187346,38.778712,Private not-for-profit,Graduate degree or certificate offering,No,Town: Fringe,Doctoral/Professional Universities,Research Doctoral: Single program-Education,High undergraduate,"Four-year, small, primarily residential",1203,393,810,1,0,1,1203,1184,19,0,300,100,200,1,0,1,26,10,16,0,0,0,KS02
154712,Benedictine College, ,1020 N 2nd St,Atchison,KS,66002-1499,-95.111473,39.572646,Private not-for-profit,Graduate degree or certificate offering,No,Town: Distant,Baccalaureate Colleges: Diverse Fields,"Postbaccalaureate: Business-dominant, with other professional programs",Very high undergraduate,"Four-year, small, highly residential",97,55,42,4,4,0,97,89,8,0,35,26,9,2,2,0,0,0,0,0,0,0,KS02
155025,Emporia State University,ESU E-State,1 Kellogg Circle,Emporia,KS,66801-5415,-96.179021,38.414784,Public,Graduate degree or certificate offering,No,Town: Remote,Master's Colleges & Universities: Larger Programs,Research Doctoral: Single program-Other,Majority undergraduate,"Four-year, medium, primarily residential",3785,1131,2654,106,45,61,3785,3347,200,238,1074,305,769,38,11,27,3,0,3,0,0,0,KS02
155061,Fort Hays State University,FHSU,600 Park St,Hays,KS,67601-4099,-99.342503,38.872156,Public,Graduate degree or certificate offering,No,Town: Remote,Master's Colleges & Universities: Larger Programs,Postbaccalaureate: Comprehensive programs,High undergraduate,"Four-year, medium, primarily nonresidential",3767,1262,2505,72,32,40,3767,3290,305,172,924,304,620,34,17,17,0,0,0,0,0,0,KS01
155070,Barclay College, ,607 N Kingman,Haviland,KS,67059-0288,-99.105351,37.62012,Private not-for-profit,Graduate degree or certificate offering,No,Rural: Remote,Baccalaureate Colleges: Diverse Fields,Postbaccalaureate: Single program-Other,High undergraduate,"Four-year, very small, highly residential",70,50,20,4,2,2,70,70,0,0,16,8,8,0,0,0,0,0,0,0,0,0,KS04
155089,Friends University, ,2100 W. University Ave.,Wichita,KS,67213,-97.367048,37.678459,Private not-for-profit,Graduate degree or certificate offering,No,City: Large,Master's Colleges & Universities: Larger Programs,"Postbaccalaureate: Business-dominant, with Arts & Sciences",High undergraduate,"Four-year, small, primarily residential",1365,330,1035,0,0,0,1365,220,86,1059,225,70,155,0,0,0,0,0,0,0,0,0,KS04
155317,University of Kansas,"University of Kansas | Univ of Kansas | Kansas University | KU | Kansas Jayhawks | Univ of KS |University of KS | Kansas Univ | Kansas U, KUMC, University of Kansas Medical Center, KU Medical Center, Kansas University Medical Center","Strong Hall, 1450 Jayhawk Blvd, Room 230",Lawrence,KS,66045,-95.247567,38.958549,Public,Graduate degree or certificate offering,No,City: Small,Doctoral Universities: Very High Research Activity,"Research Doctoral: Comprehensive programs, with medical/veterinary school",Majority undergraduate,"Four-year, large, primarily residential",9113,3873,5240,1070,556,514,9113,2738,3858,2517,1560,670,890,124,67,57,308,160,148,112,67,45,KS01
155335,Newman University, ,3100 McCormick Ave,Wichita,KS,67213-2097,-97.37768,37.672643,Private not-for-profit,Graduate degree or certificate offering,No,City: Large,Master's Colleges & Universities: Medium Programs,"Postbaccalaureate: Other-dominant, with other professional programs",Majority undergraduate,"Four-year, small, primarily residential",526,149,377,3,2,1,526,208,24,294,150,56,94,3,2,1,0,0,0,0,0,0,KS04
155399,Kansas State University,K-State,"919 Mid-Campus Drive, Anderson Hall",Manhattan,KS,66506,-96.581077,39.188648,Public,Graduate degree or certificate offering,No,City: Small,Doctoral Universities: Very High Research Activity,"Research Doctoral: Comprehensive programs, with medical/veterinary school",High undergraduate,"Four-year, large, primarily residential",5239,2075,3164,777,424,353,5239,2136,1735,1368,1146,414,732,87,38,49,216,115,101,99,59,40,KS01
155414,Kansas Wesleyan University, ,100 E. Claflin Ave.,Salina,KS,67401-6146,-97.607973,38.813795,Private not-for-profit,Graduate degree or certificate offering,No,Town: Remote,Baccalaureate Colleges: Diverse Fields,Postbaccalaureate: Single program-Business,Very high undergraduate,"Four-year, very small, highly residential",81,51,30,4,2,2,81,80,1,0,29,13,16,3,0,3,0,0,0,0,0,0,KS01
155511,McPherson College, ,1600 E. Euclid,McPherson,KS,67460-1402,-97.642996,38.371422,Private not-for-profit,Graduate degree or certificate offering,No,Town: Remote,Baccalaureate Colleges: Diverse Fields,Postbaccalaureate: Single program-Education,Very high undergraduate,"Four-year, very small, highly residential",34,8,26,0,0,0,34,0,0,34,2,0,2,0,0,0,0,0,0,0,0,0,KS01
155520,MidAmerica Nazarene University,MidAmerica Nazarene College,2030 E College Way,Olathe,KS,66062-1899,-94.781635,38.875615,Private not-for-profit,Graduate degree or certificate offering,No,Suburb: Large,Master's Colleges & Universities: Medium Programs,"Postbaccalaureate: Business-dominant, with other professional programs",High undergraduate,"Four-year, small, highly residential",2226,405,1821,9,2,7,2226,208,55,1963,127,31,96,1,0,1,0,0,0,0,0,0,KS03
155627,Ottawa University-Ottawa,OUKS - Ottawa,1001 South Cedar,Ottawa,KS,66067-3399,-95.264187,38.603173,Private not-for-profit,Graduate degree or certificate offering,No,Town: Distant,Baccalaureate Colleges: Diverse Fields,"Postbaccalaureate: Business-dominant, with other professional programs",Very high undergraduate,"Four-year, very small, highly residential",95,62,33,0,0,0,95,10,85,0,18,12,6,0,0,0,0,0,0,0,0,0,KS03
155636,Ottawa University-Kansas City,Ottawa University - Overland Park,4370 W. 109th Street Suite 200,Overland Park,KS,66211,-94.635461,38.932055,Private not-for-profit,Graduate degree or certificate offering,No,City: Midsize,Master's Colleges & Universities: Small Programs,"Postbaccalaureate: Other-dominant, with other professional programs",Majority undergraduate,"Four-year, very small, primarily nonresidential",376,211,165,0,0,0,376,114,262,0,68,32,36,0,0,0,0,0,0,0,0,0,KS03
155681,Pittsburg State University,Pitt State,1701 S Broadway,Pittsburg,KS,66762,-94.702473,37.392071,Public,Graduate degree or certificate offering,No,Town: Distant,Master's Colleges & Universities: Larger Programs,Postbaccalaureate: Comprehensive programs,High undergraduate,"Four-year, medium, primarily residential",2620,865,1755,147,109,38,2620,1293,555,772,580,236,344,65,50,15,0,0,0,0,0,0,KS02
155812,University of Saint Mary,"University of St. Mary, University of St Mary",4100 S 4th St,Leavenworth,KS,66048-5082,-94.906743,39.279396,Private not-for-profit,Graduate degree or certificate offering,No,Town: Fringe,Master's Colleges & Universities: Medium Programs,"Postbaccalaureate: Business-dominant, with other professional programs",Majority undergraduate,"Four-year, small, primarily residential",628,208,420,10,8,2,628,167,42,419,132,48,84,5,3,2,0,0,0,0,0,0,KS02
155900,Southwestern College,SC,100 College Street,Winfield,KS,67156-2499,-96.975405,37.248608,Private not-for-profit,Graduate degree or certificate offering,No,Town: Distant,Baccalaureate Colleges: Diverse Fields,Research Doctoral: Single program-Education,Very high undergraduate,"Four-year, very small, primarily residential",231,104,127,6,3,3,231,160,11,60,49,26,23,1,0,1,7,3,4,0,0,0,KS04
155937,Sterling College,SC,125 W. Cooper,Sterling,KS,67579,-98.208644,38.219937,Private not-for-profit,Graduate degree or certificate offering,No,Rural: Distant,Baccalaureate Colleges: Diverse Fields,"Postbaccalaureate: Other-dominant, with other professional programs",Very high undergraduate,"Four-year, very small, highly residential",15,6,9,0,0,0,15,4,0,11,4,2,2,0,0,0,0,0,0,0,0,0,KS01
155973,Tabor College,Tabor|TC,400 S Jefferson,Hillsboro,KS,67063-1799,-97.200949,38.348606,Private not-for-profit,Graduate degree or certificate offering,No,Town: Remote,Baccalaureate Colleges: Diverse Fields,"Postbaccalaureate: Business-dominant, with other professional programs",Very high undergraduate,"Four-year, very small, highly residential",72,48,24,8,7,1,72,50,0,22,25,13,12,1,1,0,0,0,0,0,0,0,KS02
156082,Washburn University, ,1700 SW College Avenue,Topeka,KS,66621-0001,-95.702222,39.033778,Public,Graduate degree or certificate offering,No,City: Midsize,Master's Colleges & Universities: Medium Programs,"Postbaccalaureate: Other-dominant, with Arts & Sciences",High undergraduate,"Four-year, medium, primarily nonresidential",925,308,617,27,18,9,925,264,192,469,139,47,92,13,7,6,0,0,0,0,0,0,KS02
156125,Wichita State University,WSU,1845 N. Fairmount,Wichita,KS,67260-0124,-97.292361,37.718882,Public,Graduate degree or certificate offering,No,City: Large,Doctoral Universities: High Research Activity,Research Doctoral: STEM-dominant,High undergraduate,"Four-year, large, primarily nonresidential",3646,1378,2268,580,391,189,3646,867,566,2213,767,324,443,153,102,51,39,27,12,18,16,2,KS04
156213,Asbury University,Asbury College,1 Macklem Dr,Wilmore,KY,40390-1198,-84.662606,37.862029,Private not-for-profit,Graduate degree or certificate offering,No,Town: Fringe,Master's Colleges & Universities: Small Programs,"Postbaccalaureate: Education-dominant, with Arts & Sciences",Very high undergraduate,"Four-year, small, highly residential",293,125,168,7,2,5,293,268,23,2,66,35,31,2,1,1,0,0,0,0,0,0,KY06
156222,Asbury Theological Seminary, ,204 N Lexington Ave,Wilmore,KY,40390-1199,-84.660127,37.861561,Private not-for-profit,Graduate degree or certificate offering,No,Town: Fringe,Special Focus Four-Year: Faith-Related Institutions,Research Doctoral: Single program-Other,Exclusively graduate,Exclusively graduate/professional,2060,1227,833,226,159,67,2060,289,1251,520,260,149,111,19,11,8,52,45,7,24,21,3,KY06
156286,Bellarmine University, ,2001 Newburg Rd,Louisville,KY,40205-0671,-85.704997,38.219279,Private not-for-profit,Graduate degree or certificate offering,No,City: Large,Doctoral/Professional Universities,Research Doctoral: Single program-Education,High undergraduate,"Four-year, small, primarily residential",981,305,676,22,14,8,981,207,294,480,173,67,106,13,9,4,13,3,10,0,0,0,KY03
156356,Brescia University, ,717 Frederica St,Owensboro,KY,42301-3023,-87.111639,37.769041,Private not-for-profit,Graduate degree or certificate offering,No,City: Small,Baccalaureate Colleges: Diverse Fields,"Postbaccalaureate: Other-dominant, with other professional programs",Very high undergraduate,"Four-year, very small, primarily residential",105,17,88,0,0,0,105,90,0,15,52,5,47,0,0,0,0,0,0,0,0,0,KY02
156365,Campbellsville University, ,1 University Dr,Campbellsville,KY,42718-2799,-85.348943,37.343342,Private not-for-profit,Graduate degree or certificate offering,No,Town: Distant,Master's Colleges & Universities: Larger Programs,"Postbaccalaureate: Other-dominant, with Arts & Sciences",Majority graduate,"Four-year, medium, highly residential",8331,5122,3209,6443,4716,1727,8331,1607,6550,174,2839,1911,928,2400,1794,606,8,5,3,0,0,0,KY01
156417,Clear Creek Baptist Bible College,Clear Creek Springs|Clear Creek Mountain Preachers Bible School|Clear Creek Baptist School|CCBBC,300 Clear Creek Rd,Pineville,KY,40977-9752,-83.727702,36.725236,Private not-for-profit,Graduate degree or certificate offering,No,Rural: Distant,Special Focus Four-Year: Faith-Related Institutions,Not classified (Exclusively Undergraduate),Majority undergraduate,"Four-year, very small, primarily residential",28,27,1,0,0,0,28,28,0,0,0,0,0,0,0,0,0,0,0,0,0,0,KY05
156471,Galen College of Nursing-Louisville, ,3050 Terra Crossing Blvd.,Louisville,KY,40245,-85.499039,38.281333,Private for-profit,Graduate degree or certificate offering,No,City: Large,Special Focus Four-Year: Other Health Professions Schools,Not classified (Exclusively Undergraduate),Very high undergraduate,"Four-year, small, primarily nonresidential",288,40,248,0,0,0,288,288,0,0,0,0,0,0,0,0,0,0,0,0,0,0,KY03
156541,University of the Cumberlands,Cumberland College,6191 College Station Drive,Williamsburg,KY,40769,-84.161646,36.737048,Private not-for-profit,Graduate degree or certificate offering,No,Town: Remote,Doctoral/Professional Universities,Research Doctoral: Professional-dominant,Majority graduate,"Four-year, medium, primarily residential",19391,11324,8067,4522,3371,1151,19391,8708,10537,146,3053,1383,1670,792,572,220,194,75,119,7,5,2,KY05
156620,Eastern Kentucky University,Eastern EKU,521 Lancaster Ave,Richmond,KY,40475-3102,-84.300796,37.740845,Public,Graduate degree or certificate offering,No,Town: Distant,Doctoral/Professional Universities,Postbaccalaureate: Comprehensive programs,High undergraduate,"Four-year, large, primarily residential",3104,966,2138,63,36,27,3104,1710,1011,383,745,255,490,13,9,4,0,0,0,0,0,0,KY06
156727,Frontier Nursing University, ,2050 Lexington Road,Versailles,KY,40383,-84.692791,38.051018,Private not-for-profit,Graduate degree or certificate offering,No,Rural: Fringe,Special Focus Four-Year: Other Health Professions Schools,Postbaccalaureate: Single program-Other,Exclusively graduate,Exclusively graduate/professional,2985,177,2808,0,0,0,2985,2985,0,0,607,32,575,0,0,0,0,0,0,0,0,0,KY06
156745,Georgetown College, ,400 East College Street,Georgetown,KY,40324-1696,-84.553767,38.207615,Private not-for-profit,Graduate degree or certificate offering,No,Town: Fringe,Baccalaureate Colleges: Arts & Sciences Focus,Postbaccalaureate: Single program-Education,High undergraduate,"Four-year, small, highly residential",538,127,411,0,0,0,538,538,0,0,168,36,132,0,0,0,0,0,0,0,0,0,KY06
157058,Kentucky State University,K-State,400 East Main Street,Frankfort,KY,40601-2355,-84.855402,38.201427,Public,Graduate degree or certificate offering,Yes,Town: Distant,Baccalaureate Colleges: Diverse Fields,"Postbaccalaureate: Other-dominant, with Arts & Sciences",Very high undergraduate,"Four-year, small, highly residential",163,85,78,10,5,5,163,55,85,23,28,15,13,3,2,1,0,0,0,0,0,0,KY01
157085,University of Kentucky, ,South Limestone,Lexington,KY,40506-0032,-84.504747,38.038911,Public,Graduate degree or certificate offering,No,City: Large,Doctoral Universities: Very High Research Activity,"Research Doctoral: Comprehensive programs, with medical/veterinary school",High undergraduate,"Four-year, large, primarily residential",8905,3430,5475,792,463,329,8905,2549,3827,2529,1289,496,793,98,61,37,333,171,162,102,56,46,KY06
157100,Kentucky Christian University, ,100 Academic Pkwy,Grayson,KY,41143-1199,-82.945561,38.338805,Private not-for-profit,Graduate degree or certificate offering,No,Town: Distant,Baccalaureate Colleges: Diverse Fields,"Postbaccalaureate: Other-dominant, with other professional programs",Very high undergraduate,"Four-year, very small, highly residential",101,38,63,1,1,0,101,101,0,0,37,14,23,1,1,0,0,0,0,0,0,0,KY05
157207,Lexington Theological Seminary, ,"230 Lexington Green Circle, Suite 300",Lexington,KY,40503,-84.526079,37.996332,Private not-for-profit,Graduate degree or certificate offering,No,City: Large,Special Focus Four-Year: Faith-Related Institutions,Postbaccalaureate: Single program-Other,Exclusively graduate,Exclusively graduate/professional,124,57,67,0,0,0,124,36,88,0,8,0,8,0,0,0,0,0,0,0,0,0,KY06
157216,Lindsey Wilson College, ,210 Lindsey Wilson St,Columbia,KY,42728-1223,-85.299997,37.101502,Private not-for-profit,Graduate degree or certificate offering,No,Town: Remote,Master's Colleges & Universities: Larger Programs,Research Doctoral: Single program-Education,Majority undergraduate,"Four-year, small, highly residential",1121,326,795,169,128,41,1121,557,223,341,225,36,189,0,0,0,5,2,3,0,0,0,KY01
157289,University of Louisville, ,2301 S 3rd St,Louisville,KY,40292-0001,-85.760412,38.216862,Public,Graduate degree or certificate offering,No,City: Large,Doctoral Universities: Very High Research Activity,"Research Doctoral: Comprehensive programs, with medical/veterinary school",Majority undergraduate,"Four-year, large, primarily nonresidential",7878,3697,4181,555,327,228,7878,2819,4167,892,1456,678,778,83,44,39,150,79,71,39,29,10,KY03
157298,Louisville Presbyterian Theological Seminary,Louisville Seminary | Louisville Presbyterian Seminary,1044 Alta Vista Rd,Louisville,KY,40205-1798,-85.686411,38.237056,Private not-for-profit,Graduate degree or certificate offering,No,City: Large,Special Focus Four-Year: Faith-Related Institutions,Postbaccalaureate: Single program-Other,Exclusively graduate,Exclusively graduate/professional,156,56,100,5,3,2,156,0,0,156,26,8,18,1,1,0,0,0,0,0,0,0,KY03
157377,Midway University, ,512 E. Stephens St,Midway,KY,40347-1120,-84.678142,38.146126,Private not-for-profit,Graduate degree or certificate offering,No,Rural: Distant,Master's Colleges & Universities: Small Programs,"Postbaccalaureate: Business-dominant, with other professional programs",Very high undergraduate,"Four-year, small, primarily residential",262,73,189,0,0,0,262,262,0,0,94,22,72,0,0,0,0,0,0,0,0,0,KY06
157386,Morehead State University, ,University Blvd,Morehead,KY,40351,-83.434021,38.186768,Public,Graduate degree or certificate offering,No,Town: Remote,Master's Colleges & Universities: Larger Programs,Postbaccalaureate: Comprehensive programs,Very high undergraduate,"Four-year, medium, primarily residential",977,345,632,18,15,3,977,828,136,13,204,82,122,10,10,0,0,0,0,0,0,0,KY05
157401,Murray State University, ,218 Wells Hall,Murray,KY,42071-3318,-88.323629,36.612419,Public,Graduate degree or certificate offering,No,Town: Remote,Master's Colleges & Universities: Larger Programs,Postbaccalaureate: Comprehensive programs,High undergraduate,"Four-year, medium, primarily residential",2022,719,1303,92,52,40,2022,1035,250,737,544,179,365,39,24,15,0,0,0,0,0,0,KY01
157447,Northern Kentucky University,NKU,Nunn Drive,Highland Heights,KY,41099,-84.463483,39.029714,Public,Graduate degree or certificate offering,No,Suburb: Large,Doctoral/Professional Universities,Research Doctoral: Single program-Education,High undergraduate,"Four-year, large, primarily nonresidential",6141,1590,4551,28,12,16,6141,5117,941,83,1015,250,765,10,3,7,21,3,18,0,0,0,KY04
157535,University of Pikeville,UPIKE,147 Sycamore St,Pikeville,KY,41501,-82.521063,37.479232,Private not-for-profit,Graduate degree or certificate offering,No,Town: Remote,Doctoral/Professional Universities,"Postbaccalaureate: Other-dominant, with other professional programs",Majority undergraduate,"Four-year, small, highly residential",922,421,501,1,0,1,922,126,0,796,28,17,11,0,0,0,0,0,0,0,0,0,KY05
157748,The Southern Baptist Theological Seminary,"SBTS, Southern Seminary, Boyce College",2825 Lexington Rd,Louisville,KY,40280-0001,-85.687649,38.248216,Private not-for-profit,Graduate degree or certificate offering,No,City: Large,Special Focus Four-Year: Faith-Related Institutions,Research Doctoral: Single program-Other,Majority graduate,"Four-year, small, primarily residential",4551,3920,631,728,630,98,4551,1167,2041,1343,373,315,58,38,30,8,100,96,4,17,16,1,KY03
157757,Spalding University,Spalding,901 S Fourth Street,Louisville,KY,40203-2188,-85.757725,38.242407,Private not-for-profit,Graduate degree or certificate offering,No,City: Large,Master's Colleges & Universities: Larger Programs,Research Doctoral: Single program-Education,Majority undergraduate,"Four-year, small, primarily residential",887,174,713,1,0,1,887,161,491,235,292,50,242,1,0,1,9,4,5,0,0,0,KY03
157793,Sullivan University, ,3101 Bardstown Rd,Louisville,KY,40205-3013,-85.670489,38.212824,Private for-profit,Graduate degree or certificate offering,No,City: Large,Master's Colleges & Universities: Larger Programs,Research Doctoral: Single program-Other,High undergraduate,"Four-year, small, primarily nonresidential",682,266,416,3,2,1,682,412,13,257,157,60,97,3,2,1,7,4,3,0,0,0,KY03
157809,Thomas More University,Thomas More,333 Thomas More Parkway,Crestview Hills,KY,41017-3495,-84.568923,39.022963,Private not-for-profit,Graduate degree or certificate offering,No,Suburb: Large,Master's Colleges & Universities: Small Programs,"Postbaccalaureate: Business-dominant, with other professional programs",Very high undergraduate,"Four-year, small, primarily residential",193,92,101,1,0,1,193,156,25,12,98,49,49,0,0,0,0,0,0,0,0,0,KY04
157863,Union College, ,310 College St,Barbourville,KY,40906-1499,-83.888477,36.870875,Private not-for-profit,Graduate degree or certificate offering,No,Town: Remote,Master's Colleges & Universities: Small Programs,"Postbaccalaureate: Education-dominant, with Arts & Sciences",High undergraduate,"Four-year, small, primarily residential",332,132,200,29,18,11,332,225,95,12,78,29,49,1,0,1,0,0,0,0,0,0,KY05
157951,Western Kentucky University,"WKU, HILLTOPPERS",1906 College Heights Blvd,Bowling Green,KY,42101-1000,-86.456828,36.985035,Public,Graduate degree or certificate offering,No,City: Small,Doctoral/Professional Universities,Postbaccalaureate: Comprehensive programs,Very high undergraduate,"Four-year, large, primarily residential",2814,1023,1791,71,31,40,2814,1640,921,253,728,271,457,24,10,14,0,0,0,0,0,0,KY02
158477,Centenary College of Louisiana, ,2911 Centenary Boulevard,Shreveport,LA,71104,-93.730834,32.483335,Private not-for-profit,Graduate degree or certificate offering,No,City: Midsize,Baccalaureate Colleges: Arts & Sciences Focus,"Postbaccalaureate: Education-dominant, with other professional programs",Very high undergraduate,"Four-year, very small, highly residential",19,10,9,0,0,0,19,0,2,17,8,4,4,0,0,0,0,0,0,0,0,0,LA04
159009,Grambling State University,"GSU, Grambling",403 Main Street,Grambling,LA,71245,-92.713245,32.523797,Public,Graduate degree or certificate offering,Yes,Town: Distant,Master's Colleges & Universities: Larger Programs,Research Doctoral: Single program-Education,Very high undergraduate,"Four-year, medium, highly residential",1130,290,840,23,6,17,1130,596,407,127,198,41,157,5,0,5,11,3,8,0,0,0,LA05
159373,Louisiana State University Health Sciences Center-New Orleans,LSUHSC  LSUHSC-NO  LSUMC  LSU Medical Center  LSU Health Sciences Center  LSU Health Sciences Center at New Orleans,433 Bolivar St,New Orleans,LA,70112-2223,-90.083145,29.957272,Public,Graduate degree or certificate offering,No,City: Large,Special Focus Four-Year: Medical Schools & Centers,Research Doctoral: Single program-Other,Majority graduate,"Four-year, small, highly residential",2121,785,1336,32,17,15,2121,0,0,2121,151,36,115,6,2,4,16,7,9,1,0,1,LA02
159391,Louisiana State University and Agricultural & Mechanical College,Louisiana State University|LSU,156 Thomas Boyd Hall,Baton Rouge,LA,70803-2750,-91.178921,30.414986,Public,Graduate degree or certificate offering,No,City: Midsize,Doctoral Universities: Very High Research Activity,"Research Doctoral: Comprehensive programs, with medical/veterinary school",High undergraduate,"Four-year, large, primarily residential",7847,3249,4598,1068,620,448,7847,1941,4080,1826,1399,525,874,120,65,55,292,166,126,130,79,51,LA06
159416,Louisiana State University-Shreveport,LSUS,One University Place,Shreveport,LA,71115-2399,-93.70561,32.428465,Public,Graduate degree or certificate offering,No,City: Midsize,Master's Colleges & Universities: Larger Programs,Research Doctoral: Single program-Other,Majority graduate,"Four-year, medium, primarily nonresidential",10849,4595,6254,399,217,182,10849,10634,78,137,3243,1403,1840,130,66,64,13,3,10,1,0,1,LA04
159568,Louisiana College, ,1140 College Dr,Pineville,LA,71359,-92.425973,31.324528,Private not-for-profit,Graduate degree or certificate offering,No,Suburb: Small,Master's Colleges & Universities: Small Programs,"Postbaccalaureate: Education-dominant, with other professional programs",High undergraduate,"Four-year, very small, highly residential",346,75,271,1,1,0,346,120,65,161,69,15,54,0,0,0,0,0,0,0,0,0,LA05
159647,Louisiana Tech University,"LA Tech, Louisiana Tech, Tech",1310 West Railroad Avenue,Ruston,LA,71272,-92.649963,32.528297,Public,Graduate degree or certificate offering,No,Town: Distant,Doctoral Universities: High Research Activity,Research Doctoral: Professional-dominant,High undergraduate,"Four-year, medium, primarily residential",1536,652,884,195,122,73,1536,744,549,243,384,172,212,65,41,24,42,23,19,16,9,7,LA05
159656,Loyola University New Orleans, ,6363 Saint Charles Ave,New Orleans,LA,70118-6143,-90.120417,29.936141,Private not-for-profit,Graduate degree or certificate offering,No,City: Large,Doctoral/Professional Universities,"Postbaccalaureate: Other-dominant, with Arts & Sciences",High undergraduate,"Four-year, medium, primarily residential",1459,430,1029,18,5,13,1459,639,803,17,221,52,169,5,1,4,0,0,0,0,0,0,LA01
159717,McNeese State University,McNeese,4205 Ryan St,Lake Charles,LA,70605,-93.217222,30.178187,Public,Graduate degree or certificate offering,No,City: Small,Master's Colleges & Universities: Larger Programs,Postbaccalaureate: Comprehensive programs,Very high undergraduate,"Four-year, medium, primarily nonresidential",741,212,529,46,26,20,741,315,359,67,207,59,148,19,7,12,0,0,0,0,0,0,LA03
159939,University of New Orleans,UNO,2000 Lakeshore Drive,New Orleans,LA,70148,-90.067142,30.027704,Public,Graduate degree or certificate offering,No,City: Large,Doctoral Universities: High Research Activity,Research Doctoral: Professional-dominant,High undergraduate,"Four-year, medium, primarily residential",1751,707,1044,158,97,61,1751,566,916,269,421,174,247,40,25,15,37,21,16,11,9,2,LA02
159948,New Orleans Baptist Theological Seminary,NOBTS,3939 Gentilly Blvd,New Orleans,LA,70126,-90.043439,30.004336,Private not-for-profit,Graduate degree or certificate offering,No,City: Large,Special Focus Four-Year: Faith-Related Institutions,Research Doctoral: Single program-Other,Majority graduate,"Four-year, small, primarily nonresidential",1794,1369,425,8,8,0,1794,95,1018,681,277,197,80,3,3,0,36,25,11,0,0,0,LA02
159966,Nicholls State University, ,University Station  La Hwy 1,Thibodaux,LA,70310,-90.801571,29.794486,Public,Graduate degree or certificate offering,No,City: Small,Master's Colleges & Universities: Medium Programs,"Postbaccalaureate: Education-dominant, with Arts & Sciences",Very high undergraduate,"Four-year, medium, primarily nonresidential",855,168,687,20,9,11,855,441,231,183,185,39,146,10,4,6,0,0,0,0,0,0,LA06
159993,University of Louisiana at Monroe,ULM; University of Louisiana-Monroe; Uni of LA-Monroe; University of Louisiana Monroe; University of Louisiana at Monroe,700 University Avenue,Monroe,LA,71209-0000,-92.07374,32.527748,Public,Graduate degree or certificate offering,No,City: Small,Doctoral/Professional Universities,Research Doctoral: Professional-dominant,High undergraduate,"Four-year, medium, primarily residential",2382,554,1828,83,43,40,2382,1516,345,521,487,91,396,18,6,12,31,14,17,5,5,0,LA05
160038,Northwestern State University of Louisiana,NSU | NSULA | Northwestern State University | Northwestern | NwSU,175 Sam Sibley Drive,Natchitoches,LA,71497-0002,-93.097797,31.750666,Public,Graduate degree or certificate offering,No,Town: Remote,Master's Colleges & Universities: Larger Programs,"Postbaccalaureate: Education-dominant, with Arts & Sciences",Very high undergraduate,"Four-year, medium, primarily nonresidential",1422,276,1146,22,12,10,1422,1244,154,24,259,58,201,7,5,2,4,1,3,0,0,0,LA04
160065,University of Holy Cross, ,4123 Woodland Drive,New Orleans,LA,70131-7399,-89.99445,29.912003,Private not-for-profit,Graduate degree or certificate offering,No,City: Large,Master's Colleges & Universities: Small Programs,Research Doctoral: Professional-dominant,Majority undergraduate,"Four-year, very small, primarily nonresidential",421,77,344,0,0,0,421,47,374,0,86,15,71,0,0,0,25,4,21,0,0,0,LA02
160074,Franciscan Missionaries of Our Lady University,FranU,5414 Brittany Dr,Baton Rouge,LA,70808,-91.110587,30.401379,Private not-for-profit,Graduate degree or certificate offering,No,City: Midsize,Special Focus Four-Year: Other Health Professions Schools,"Postbaccalaureate: Other-dominant, with Arts & Sciences",Majority undergraduate,"Four-year, very small, primarily nonresidential",421,113,308,0,0,0,421,84,310,27,53,4,49,0,0,0,0,0,0,0,0,0,LA06
160612,Southeastern Louisiana University,Southeastern,548 Ned McGehee Ave.,Hammond,LA,70402,-90.468676,30.514652,Public,Graduate degree or certificate offering,No,City: Small,Master's Colleges & Universities: Larger Programs,Research Doctoral: Single program-Education,Very high undergraduate,"Four-year, large, primarily nonresidential",1204,279,925,45,18,27,1204,454,664,86,278,75,203,13,5,8,20,3,17,0,0,0,LA05
160621,Southern University and A & M College,Southern University Baton Rouge,"P.O. Box 9374, Harding Blvd",Baton Rouge,LA,70813,-91.190105,30.524558,Public,Graduate degree or certificate offering,Yes,City: Midsize,Doctoral Universities: High Research Activity,Research Doctoral: Professional-dominant,Very high undergraduate,"Four-year, medium, highly residential",1790,611,1179,1,0,1,1790,194,180,1416,262,82,180,0,0,0,17,4,13,0,0,0,LA02
160630,Southern University at New Orleans,SUNO,6400 Press Drive,New Orleans,LA,70126,-90.044912,30.026162,Public,Graduate degree or certificate offering,Yes,City: Large,Master's Colleges & Universities: Medium Programs,"Postbaccalaureate: Other-dominant, with Arts & Sciences",High undergraduate,"Four-year, small, primarily residential",395,104,291,3,1,2,395,45,295,55,113,26,87,0,0,0,0,0,0,0,0,0,LA02
160658,University of Louisiana at Lafayette,UL Lafayette,104 University Circle,Lafayette,LA,70503,-92.020165,30.212191,Public,Graduate degree or certificate offering,No,City: Midsize,Doctoral Universities: Very High Research Activity,Research Doctoral: STEM-dominant,High undergraduate,"Four-year, large, primarily residential",3083,1337,1746,289,191,98,3083,1660,210,1213,706,316,390,63,39,24,56,25,31,6,5,1,LA03
160755,Tulane University of Louisiana, ,6823 St. Charles Avenue,New Orleans,LA,70118-5698,-90.122144,29.940069,Private not-for-profit,Graduate degree or certificate offering,No,City: Large,Doctoral Universities: Very High Research Activity,"Research Doctoral: Comprehensive programs, with medical/veterinary school",Majority undergraduate,"Four-year, large, primarily residential",5925,2385,3540,1047,583,464,5925,1376,1292,3257,1572,627,945,420,227,193,150,66,84,56,33,23,LA01
160904,Xavier University of Louisiana, ,1 Drexel Drive,New Orleans,LA,70125-1098,-90.107307,29.964162,Private not-for-profit,Graduate degree or certificate offering,Yes,City: Large,Master's Colleges & Universities: Medium Programs,Research Doctoral: Single program-Education,Majority undergraduate,"Four-year, medium, highly residential",1041,287,754,27,13,14,1041,161,827,53,56,6,50,2,1,1,4,3,1,0,0,0,LA02
160959,College of the Atlantic, ,105 Eden Street,Bar Harbor,ME,04609,-68.221517,44.395258,Private not-for-profit,Graduate degree or certificate offering,No,Town: Remote,Special Focus Four-Year: Other Special Focus Institutions,Postbaccalaureate: Single program-Other,Very high undergraduate,"Four-year, very small, highly residential",4,2,2,0,0,0,4,0,1,3,0,0,0,0,0,0,0,0,0,0,0,0,ME02
160995,Beal University, ,99 Farm Road,Bangor,ME,04401,-68.785428,44.786465,Private for-profit,Graduate degree or certificate offering,No,City: Small,Associate's Colleges: High Career & Technical-High Traditional,Not classified (Exclusively Undergraduate),Exclusively undergraduate two-year,"Two-year, very small",5,1,4,0,0,0,5,5,0,0,0,0,0,0,0,0,0,0,0,0,0,0,ME02
161217,University of Maine at Augusta,UMA|UMA-Bangor|University of Maine at Augusta - Bangor,46 University Dr,Augusta,ME,04330-9410,-69.796396,44.337746,Public,Graduate degree or certificate offering,No,Town: Distant,Baccalaureate Colleges: Diverse Fields,Not classified (Exclusively Undergraduate),Very high undergraduate,"Four-year, small, primarily nonresidential",42,17,25,0,0,0,42,37,5,0,0,0,0,0,0,0,0,0,0,0,0,0,ME02
161226,University of Maine at Farmington,UMF,224 Main St.,Farmington,ME,04938-9978,-70.147121,44.666911,Public,Graduate degree or certificate offering,No,Town: Remote,Baccalaureate Colleges: Diverse Fields,Postbaccalaureate: Single program-Education,Very high undergraduate,"Four-year, small, highly residential",484,74,410,2,0,2,484,321,126,37,36,3,33,1,0,1,0,0,0,0,0,0,ME02
161253,University of Maine, ,168 College Avenue,Orono,ME,04469,-68.669332,44.899257,Public,Graduate degree or certificate offering,No,Suburb: Small,Doctoral Universities: Very High Research Activity,"Research Doctoral: Comprehensive programs, no medical/veterinary school",High undergraduate,"Four-year, medium, primarily residential",2924,1108,1816,263,147,116,2924,1371,1036,517,397,142,255,33,20,13,65,31,34,31,20,11,ME02
161299,Maine Maritime Academy, ,1 Pleasant Street,Castine,ME,04420-0001,-68.804347,44.389654,Public,Graduate degree or certificate offering,No,Rural: Distant,Baccalaureate Colleges: Diverse Fields,Postbaccalaureate: Single program-Business,Very high undergraduate,"Four-year, very small, highly residential",30,18,12,0,0,0,30,29,1,0,8,3,5,0,0,0,0,0,0,0,0,0,ME02
161457,University of New England, ,11 Hills Beach Rd,Biddeford,ME,04005-9599,-70.38535,43.458591,Private not-for-profit,Graduate degree or certificate offering,No,Suburb: Midsize,Doctoral Universities: High Research Activity,Research Doctoral: Single program-Education,Majority graduate,"Four-year, medium, highly residential",3965,1039,2926,27,16,11,3965,2177,146,1642,514,86,428,0,0,0,76,28,48,0,0,0,ME01
161509,Maine College of Art & Design,MECA   Meca  Portland School of Art,522 Congress St.,Portland,ME,04101-3494,-70.261015,43.655743,Private not-for-profit,Graduate degree or certificate offering,No,City: Small,"Special Focus Four-Year: Arts, Music & Design Schools","Postbaccalaureate: Other-dominant, with Arts & Sciences",High undergraduate,"Four-year, very small, highly residential",59,19,40,0,0,0,59,0,59,0,28,11,17,0,0,0,0,0,0,0,0,0,ME01
161518,Saint Joseph's College of Maine,Saint Joseph's College,278 Whites Bridge Rd,Standish,ME,04084-5236,-70.483373,43.826314,Private not-for-profit,Graduate degree or certificate offering,No,Rural: Fringe,Master's Colleges & Universities: Larger Programs,"Postbaccalaureate: Other-dominant, with other professional programs",High undergraduate,"Four-year, small, primarily residential",1077,359,718,0,0,0,1077,1077,0,0,191,61,130,0,0,0,0,0,0,0,0,0,ME01
161554,University of Southern Maine, ,96 Falmouth St,Portland,ME,04103,-70.274247,43.662863,Public,Graduate degree or certificate offering,No,City: Small,Master's Colleges & Universities: Larger Programs,Research Doctoral: Professional-dominant,High undergraduate,"Four-year, medium, primarily nonresidential",2714,683,2031,17,7,10,2714,1934,637,143,444,88,356,1,1,0,8,1,7,0,0,0,ME01
161563,Thomas College, ,180 W River Rd,Waterville,ME,04901-5097,-69.664734,44.524909,Private not-for-profit,Graduate degree or certificate offering,No,Rural: Fringe,Master's Colleges & Universities: Small Programs,"Postbaccalaureate: Business-dominant, with Arts & Sciences",Very high undergraduate,"Four-year, very small, highly residential",195,72,123,0,0,0,195,115,48,32,52,21,31,0,0,0,0,0,0,0,0,0,ME01
161572,Unity College, ,"70 Farm View Drive, Suite 200",New Gloucester,ME,04260,-69.332276,44.603165,Private not-for-profit,Graduate degree or certificate offering,No,Rural: Remote,Master's Colleges & Universities: Small Programs,"Postbaccalaureate: Other-dominant, with Arts & Sciences",High undergraduate,"Four-year, small, primarily nonresidential",417,118,299,1,1,0,417,417,0,0,51,20,31,0,0,0,0,0,0,0,0,0,ME02
161873,University of Baltimore,UBalt,Charles at Mount Royal,Baltimore,MD,21201-5720,-76.616591,39.305834,Public,Graduate degree or certificate offering,No,City: Large,Master's Colleges & Universities: Larger Programs,Research Doctoral: Professional-dominant,Majority graduate,"Four-year, small, primarily nonresidential",2535,948,1587,90,40,50,2535,2535,0,0,413,133,280,23,7,16,11,4,7,1,0,1,MD07
162007,Bowie State University, ,14000 Jericho Park Rd,Bowie,MD,20715-9465,-76.759721,39.018185,Public,Graduate degree or certificate offering,Yes,Suburb: Large,Master's Colleges & Universities: Larger Programs,Research Doctoral: Professional-dominant,High undergraduate,"Four-year, medium, primarily residential",1141,358,783,102,51,51,1141,859,57,225,267,71,196,39,20,19,16,5,11,1,0,1,MD05
162061,Capitol Technology University, ,11301 Springfield Rd,Laurel,MD,20708,-76.850231,39.046673,Private not-for-profit,Graduate degree or certificate offering,No,Suburb: Large,Doctoral/Professional Universities,Research Doctoral: Professional-dominant,Majority undergraduate,"Four-year, very small, highly residential",652,498,154,26,23,3,652,532,113,7,48,37,11,1,1,0,54,39,15,0,0,0,MD04
162210,Washington Adventist University,WAU,7600 Flower Ave,Takoma Park,MD,20912,-77.000608,38.986349,Private not-for-profit,Graduate degree or certificate offering,No,Suburb: Large,Master's Colleges & Universities: Small Programs,"Postbaccalaureate: Other-dominant, with other professional programs",Very high undergraduate,"Four-year, very small, highly residential",147,31,116,42,8,34,147,137,2,8,59,13,46,22,3,19,0,0,0,0,0,0,MD08
162283,Coppin State University,Coppin,2500 West North Avenue,Baltimore,MD,21216-3698,-76.658687,39.311258,Public,Graduate degree or certificate offering,Yes,City: Large,Master's Colleges & Universities: Small Programs,"Postbaccalaureate: Other-dominant, with Arts & Sciences",Very high undergraduate,"Four-year, small, primarily residential",295,66,229,68,15,53,295,26,83,186,60,12,48,7,4,3,0,0,0,0,0,0,MD07
162584,Frostburg State University, ,101 Braddock Road,Frostburg,MD,21532-1099,-78.934293,39.650918,Public,Graduate degree or certificate offering,No,Suburb: Small,Master's Colleges & Universities: Larger Programs,Research Doctoral: Single program-Education,High undergraduate,"Four-year, medium, primarily residential",904,311,593,13,9,4,904,631,190,83,244,85,159,6,4,2,10,2,8,0,0,0,MD06
162654,Goucher College, ,1021 Dulaney Valley Rd,Baltimore,MD,21204-2794,-76.594843,39.410175,Private not-for-profit,Graduate degree or certificate offering,No,City: Small,Baccalaureate Colleges: Arts & Sciences Focus,"Postbaccalaureate: Education-dominant, with Arts & Sciences",High undergraduate,"Four-year, small, highly residential",2129,533,1596,3,0,3,2129,2026,9,94,173,40,133,0,0,0,0,0,0,0,0,0,MD02
162760,Hood College,Hood,401 Rosemont Ave,Frederick,MD,21701,-77.419049,39.420631,Private not-for-profit,Graduate degree or certificate offering,No,City: Small,Master's Colleges & Universities: Larger Programs,Research Doctoral: Single program-Other,Majority undergraduate,"Four-year, small, highly residential",1072,351,721,75,42,33,1072,175,428,469,201,79,122,32,22,10,7,2,5,1,1,0,MD06
162928,Johns Hopkins University,Johns Hopkins,3400 N Charles St,Baltimore,MD,21218-2688,-76.621595,39.328977,Private not-for-profit,Graduate degree or certificate offering,No,City: Large,Doctoral Universities: Very High Research Activity,"Research Doctoral: Comprehensive programs, with medical/veterinary school",Majority graduate,"Four-year, large, primarily residential",28959,13534,15425,6467,3017,3450,28959,14816,9153,4990,6960,3066,3894,2184,933,1251,498,246,252,165,100,65,MD07
163046,Loyola University Maryland, ,4501 N Charles St,Baltimore,MD,21210-2699,-76.621872,39.346358,Private not-for-profit,Graduate degree or certificate offering,No,City: Large,Master's Colleges & Universities: Larger Programs,Research Doctoral: Single program-Other,High undergraduate,"Four-year, medium, highly residential",1984,586,1398,16,8,8,1984,1984,0,0,695,170,525,18,2,16,5,0,5,0,0,0,MD02
163204,University of Maryland Global Campus,UMGC,3501 University Blvd East,Adelphi,MD,20783-8010,-76.847584,38.912706,Public,Graduate degree or certificate offering,No,Suburb: Large,Master's Colleges & Universities: Larger Programs,"Postbaccalaureate: Business-dominant, with Arts & Sciences",High undergraduate,"Four-year, large, primarily nonresidential",16886,7845,9041,446,227,219,16886,15042,616,1228,4148,2000,2148,111,52,59,0,0,0,0,0,0,MD04
163259,"University of Maryland, Baltimore", ,620 West Lexington St,Baltimore,MD,21201-1627,-76.623983,39.286864,Public,Graduate degree or certificate offering,No,City: Large,Special Focus Four-Year: Research Institutions,Research Doctoral: STEM-dominant,Majority graduate,"Four-year, medium, primarily residential",6834,1879,4955,314,108,206,6834,1871,1780,3183,1003,203,800,44,14,30,65,23,42,10,4,6,MD07
163268,University of Maryland-Baltimore County,UMBC,1000 Hilltop Circle,Baltimore,MD,21250,-76.711607,39.256686,Public,Graduate degree or certificate offering,No,Suburb: Large,Doctoral Universities: Very High Research Activity,"Research Doctoral: Comprehensive programs, no medical/veterinary school",High undergraduate,"Four-year, large, primarily residential",3158,1596,1562,855,492,363,3158,2536,576,46,730,364,366,253,145,108,89,51,38,29,14,15,MD07
163286,University of Maryland-College Park, , ,College Park,MD,20742,-76.944721,38.988178,Public,Graduate degree or certificate offering,No,Suburb: Large,Doctoral Universities: Very High Research Activity,"Research Doctoral: Comprehensive programs, with medical/veterinary school",High undergraduate,"Four-year, large, primarily residential",11214,5611,5603,3149,1851,1298,11214,5106,3377,2731,2662,1307,1355,887,504,383,540,282,258,222,133,89,MD04
163295,Maryland Institute College of Art,MICA,1300 Mount Royal Avenue,Baltimore,MD,21217-4134,-76.621033,39.308792,Private not-for-profit,Graduate degree or certificate offering,No,City: Large,"Special Focus Four-Year: Arts, Music & Design Schools","Postbaccalaureate: Other-dominant, with Arts & Sciences",High undergraduate,"Four-year, small, highly residential",677,205,472,82,28,54,677,677,0,0,282,84,198,50,16,34,0,0,0,0,0,0,MD07
163338,University of Maryland Eastern Shore,UMES,J.T. Williams Hall,Princess Anne,MD,21853-1299,-75.686852,38.207386,Public,Graduate degree or certificate offering,Yes,Town: Fringe,Doctoral Universities: High Research Activity,Research Doctoral: STEM-dominant,High undergraduate,"Four-year, small, highly residential",649,221,428,35,17,18,649,72,39,538,59,27,32,7,3,4,15,5,10,2,1,1,MD01
163453,Morgan State University, ,1700 East Cold Spring Lane,Baltimore,MD,21251-0001,-76.585565,39.344161,Public,Graduate degree or certificate offering,Yes,City: Large,Doctoral Universities: High Research Activity,Research Doctoral: Professional-dominant,High undergraduate,"Four-year, medium, primarily residential",1523,582,941,247,117,130,1523,252,341,930,264,99,165,41,20,21,71,23,48,12,6,6,MD07
163462,Mount St. Mary's University,Mount St. Mary's | The Mount | Mount Saint Mary's University | Mount Saint Mary's,16300 Old Emmitsburg Road,Emmitsburg,MD,21727-7799,-77.351887,39.681705,Private not-for-profit,Graduate degree or certificate offering,No,Town: Fringe,Master's Colleges & Universities: Medium Programs,"Postbaccalaureate: Business-dominant, with Arts & Sciences",High undergraduate,"Four-year, small, highly residential",593,359,234,27,26,1,593,143,274,176,159,95,64,5,4,1,0,0,0,0,0,0,MD06
163532,Ner Israel Rabbinical College, ,400 Mount Wilson Ln,Baltimore,MD,21208,-76.753526,39.388021,Private not-for-profit,Graduate degree or certificate offering,No,Suburb: Large,Special Focus Four-Year: Faith-Related Institutions,Research Doctoral: Single program-Other,Majority undergraduate,"Four-year, very small, highly residential",171,171,0,4,4,0,171,0,0,171,35,35,0,0,0,0,1,1,0,0,0,0,MD02
163578,Notre Dame of Maryland University,NDMU,4701 N Charles St,Baltimore,MD,21210-2476,-76.619739,39.350612,Private not-for-profit,Graduate degree or certificate offering,No,City: Large,Master's Colleges & Universities: Larger Programs,Research Doctoral: Single program-Education,Majority graduate,"Four-year, small, primarily residential",2031,390,1641,12,2,10,2031,675,773,583,264,44,220,2,1,1,6,3,3,0,0,0,MD02
163851,Salisbury University,SU|Salisbury,1101 Camden Ave,Salisbury,MD,21801-6862,-75.604815,38.34648,Public,Graduate degree or certificate offering,No,Suburb: Small,Master's Colleges & Universities: Larger Programs,Research Doctoral: Single program-Education,Very high undergraduate,"Four-year, medium, primarily residential",1119,218,901,15,5,10,1119,995,78,46,349,70,279,7,4,3,4,1,3,0,0,0,MD01
163912,St. Mary's College of Maryland,St. Mary's or SMCM,47645 College Drive,St. Mary's City,MD,20686,-76.429097,38.190904,Public,Graduate degree or certificate offering,No,Suburb: Small,Baccalaureate Colleges: Arts & Sciences Focus,Postbaccalaureate: Single program-Education,Very high undergraduate,"Four-year, small, highly residential",30,7,23,0,0,0,30,30,0,0,21,4,17,0,0,0,0,0,0,0,0,0,MD05
163976,St. John's College,SJC,60 College Ave,Annapolis,MD,21401,-76.491359,38.981598,Private not-for-profit,Graduate degree or certificate offering,No,Suburb: Large,Baccalaureate Colleges: Arts & Sciences Focus,Postbaccalaureate: Single program-Other,High undergraduate,"Four-year, very small, highly residential",132,87,45,5,3,2,132,42,47,43,25,16,9,2,0,2,0,0,0,0,0,0,MD03
164076,Towson University, ,8000 York Rd,Towson,MD,21252-0001,-76.611164,39.393622,Public,Graduate degree or certificate offering,No,City: Small,Master's Colleges & Universities: Larger Programs,Research Doctoral: STEM-dominant,Very high undergraduate,"Four-year, large, primarily residential",3739,945,2794,155,78,77,3739,3224,355,160,989,251,738,54,23,31,13,6,7,7,4,3,MD02
164085,Maryland University of Integrative Health, ,7750 Montpelier Road,Laurel,MD,20723,-76.888025,39.165872,Private not-for-profit,Graduate degree or certificate offering,No,Suburb: Large,Special Focus Four-Year: Other Health Professions Schools,Postbaccalaureate: Single program-Other,Exclusively graduate,Exclusively graduate/professional,1266,109,1157,59,7,52,1266,770,306,190,225,8,217,9,0,9,0,0,0,0,0,0,MD03
164173,Stevenson University, ,1525 Greenspring Valley Rd,Stevenson,MD,21153-0641,-76.702092,39.421988,Private not-for-profit,Graduate degree or certificate offering,No,Rural: Fringe,Master's Colleges & Universities: Larger Programs,"Postbaccalaureate: Other-dominant, with Arts & Sciences",Very high undergraduate,"Four-year, small, highly residential",753,161,592,1,0,1,753,747,6,0,222,42,180,0,0,0,0,0,0,0,0,0,MD02
164270,McDaniel College, ,2 College Hill,Westminster,MD,21157,-77.001992,39.584231,Private not-for-profit,Graduate degree or certificate offering,No,Suburb: Small,Master's Colleges & Universities: Larger Programs,"Postbaccalaureate: Education-dominant, with Arts & Sciences",Majority undergraduate,"Four-year, small, highly residential",1676,331,1345,60,33,27,1676,1676,0,0,228,48,180,0,0,0,0,0,0,0,0,0,MD02
164368,Hult International Business School, ,1 Education Street,Cambridge,MA,02141,-71.070645,42.369968,Private not-for-profit,Graduate degree or certificate offering,No,City: Midsize,Special Focus Four-Year: Business & Management Schools,Postbaccalaureate: Single program-Business,Majority graduate,"Four-year, small, highly residential",1947,1076,871,1729,983,746,1947,719,315,913,1159,640,519,1044,596,448,0,0,0,0,0,0,MA07
164447,American International College,AIC,1000 State Street,Springfield,MA,01109,-72.558338,42.112346,Private not-for-profit,Graduate degree or certificate offering,No,City: Midsize,Doctoral/Professional Universities,Research Doctoral: Professional-dominant,Majority undergraduate,"Four-year, small, highly residential",1525,375,1150,20,14,6,1525,74,104,1347,509,130,379,8,6,2,0,0,0,0,0,0,MA01
164492,Anna Maria College, ,50 Sunset Lane,Paxton,MA,01612-1198,-71.91896,42.330542,Private not-for-profit,Graduate degree or certificate offering,No,Rural: Fringe,Master's Colleges & Universities: Medium Programs,"Postbaccalaureate: Other-dominant, with Arts & Sciences",High undergraduate,"Four-year, small, highly residential",573,383,190,4,0,4,573,253,0,320,191,127,64,2,0,2,0,0,0,0,0,0,MA02
164562,Assumption University, ,500 Salisbury St,Worcester,MA,01609-1296,-71.828991,42.294226,Private not-for-profit,Graduate degree or certificate offering,No,City: Midsize,Master's Colleges & Universities: Medium Programs,"Postbaccalaureate: Business-dominant, with other professional programs",High undergraduate,"Four-year, small, highly residential",548,154,394,9,4,5,548,548,0,0,164,69,95,3,1,2,0,0,0,0,0,0,MA02
164580,Babson College, ,231 Forest Street,Wellesley,MA,02457-0310,-71.264057,42.297017,Private not-for-profit,Graduate degree or certificate offering,No,Suburb: Large,Special Focus Four-Year: Business & Management Schools,"Postbaccalaureate: Business-dominant, with Arts & Sciences",High undergraduate,"Four-year, small, highly residential",1169,649,520,278,168,110,1169,200,837,132,395,240,155,109,70,39,0,0,0,0,0,0,MA04
164632,Bay Path University, ,588 Longmeadow Street,Longmeadow,MA,01106,-72.583382,42.055088,Private not-for-profit,Graduate degree or certificate offering,No,Suburb: Large,Master's Colleges & Universities: Larger Programs,Postbaccalaureate: Comprehensive programs,Majority undergraduate,"Four-year, small, primarily nonresidential",2180,263,1917,17,2,15,2180,1948,232,0,541,67,474,9,2,7,0,0,0,0,0,0,MA01
164739,Bentley University,Bentley,175 Forest St,Waltham,MA,02452-4705,-71.222839,42.385995,Private not-for-profit,Graduate degree or certificate offering,No,City: Small,Master's Colleges & Universities: Larger Programs,Research Doctoral: Single program-Other,High undergraduate,"Four-year, medium, highly residential",1375,655,720,338,143,195,1375,116,0,1259,499,246,253,168,70,98,1,1,0,1,1,0,MA05
164748,Berklee College of Music, ,1140 Boylston St,Boston,MA,02215,-71.089405,42.346646,Private not-for-profit,Graduate degree or certificate offering,No,City: Large,Master's Colleges & Universities: Larger Programs,"Postbaccalaureate: Other-dominant, with Arts & Sciences",High undergraduate,"Four-year, medium, primarily nonresidential",820,458,362,257,129,128,820,432,385,3,306,173,133,114,56,58,0,0,0,0,0,0,MA07
164872,Boston Architectural College,Boston Architectural Center,320 Newbury Street,Boston,MA,02115-2703,-71.085786,42.348467,Private not-for-profit,Graduate degree or certificate offering,No,City: Large,"Special Focus Four-Year: Arts, Music & Design Schools",Postbaccalaureate: Single program-Other,Majority graduate,"Four-year, very small, primarily nonresidential",491,199,292,142,56,86,491,491,0,0,115,50,65,36,17,19,0,0,0,0,0,0,MA07
164915,Boston Graduate School of Psychoanalysis Inc, ,1581 Beacon Street,Brookline,MA,02446,-71.133151,42.33912,Private not-for-profit,Graduate degree or certificate offering,No,Suburb: Large,Special Focus Four-Year: Other Health Professions Schools,"Postbaccalaureate: Other-dominant, with Arts & Sciences",Exclusively graduate,Exclusively graduate/professional,179,63,116,18,2,16,179,179,0,0,28,8,20,3,0,3,0,0,0,0,0,0,MA04
164924,Boston College, ,140 Commonwealth Avenue,Chestnut Hill,MA,02467,-71.169242,42.336213,Private not-for-profit,Graduate degree or certificate offering,No,City: Small,Doctoral Universities: Very High Research Activity,"Research Doctoral: Comprehensive programs, no medical/veterinary school",Majority undergraduate,"Four-year, large, highly residential",6218,2785,3433,1004,497,507,6218,1463,2476,2279,1437,544,893,276,112,164,126,62,64,34,18,16,MA04
164988,Boston University,BU|Boston U,One Silber Way,Boston,MA,02215,-71.107942,42.351118,Private not-for-profit,Graduate degree or certificate offering,No,City: Large,Doctoral Universities: Very High Research Activity,"Research Doctoral: Comprehensive programs, with medical/veterinary school",Majority undergraduate,"Four-year, large, highly residential",20288,8600,11688,5802,2947,2855,20288,4499,2358,13431,5148,2119,3029,1985,973,1012,525,227,298,134,72,62,MA07
165015,Brandeis University, ,415 South St,Waltham,MA,02454-9110,-71.260155,42.365727,Private not-for-profit,Graduate degree or certificate offering,No,City: Small,Doctoral Universities: Very High Research Activity,"Research Doctoral: Comprehensive programs, no medical/veterinary school",Majority undergraduate,"Four-year, medium, highly residential",2342,1036,1306,730,346,384,2342,823,1154,365,859,360,499,371,161,210,75,35,40,15,8,7,MA05
165024,Bridgewater State University,BSU|Bridgewater State,131 Summer Street,Bridgewater,MA,02325,-70.974553,41.98749,Public,Graduate degree or certificate offering,No,Suburb: Large,Master's Colleges & Universities: Larger Programs,"Postbaccalaureate: Education-dominant, with Arts & Sciences",High undergraduate,"Four-year, medium, primarily residential",2250,547,1703,35,15,20,2250,175,325,1750,427,100,327,17,9,8,0,0,0,0,0,0,MA09
165167,Cambridge College, ,500 Rutherford Avenue,Boston,MA,02129,-71.072646,42.381091,Private not-for-profit,Graduate degree or certificate offering,No,City: Large,Master's Colleges & Universities: Larger Programs,Research Doctoral: Single program-Education,Majority graduate,"Four-year, small, primarily nonresidential",2289,523,1766,129,43,86,2289,316,695,1278,629,126,503,40,7,33,8,4,4,0,0,0,MA07
165334,Clark University, ,950 Main St,Worcester,MA,01610-1477,-71.823356,42.249987,Private not-for-profit,Graduate degree or certificate offering,No,City: Midsize,Doctoral Universities: High Research Activity,Research Doctoral: Humanities/social sciences-dominant,Majority undergraduate,"Four-year, medium, highly residential",1415,686,729,821,446,375,1415,470,908,37,684,330,354,443,230,213,24,7,17,13,5,8,MA02
165495,Conway School of Landscape Design,Conway School,88 Village Hill Road,Northampton,MA,01060,-72.64875,42.313857,Private not-for-profit,Graduate degree or certificate offering,No,Suburb: Large,Special Focus Four-Year: Other Special Focus Institutions,Postbaccalaureate: Single program-Other,Exclusively graduate,Exclusively graduate/professional,9,4,5,0,0,0,9,9,0,0,0,0,0,0,0,0,0,0,0,0,0,0,MA02
165529,Curry College, ,1071 Blue Hill Ave,Milton,MA,02186-2395,-71.116539,42.238061,Private not-for-profit,Graduate degree or certificate offering,No,Suburb: Large,Master's Colleges & Universities: Small Programs,"Postbaccalaureate: Business-dominant, with other professional programs",Very high undergraduate,"Four-year, small, highly residential",231,94,137,3,1,2,231,4,190,37,95,45,50,2,1,1,0,0,0,0,0,0,MA07
165644,Eastern Nazarene College,ENC,23 E Elm Ave,Quincy,MA,02170-2999,-71.011079,42.271228,Private not-for-profit,Graduate degree or certificate offering,No,Suburb: Large,Master's Colleges & Universities: Small Programs,"Postbaccalaureate: Business-dominant, with other professional programs",High undergraduate,"Four-year, very small, highly residential",206,66,140,10,4,6,206,22,58,126,72,19,53,2,2,0,0,0,0,0,0,0,MA08
165662,Emerson College,Emerson,120 Boylston Street,Boston,MA,02116-4624,-71.065384,42.352202,Private not-for-profit,Graduate degree or certificate offering,No,City: Large,Master's Colleges & Universities: Larger Programs,"Postbaccalaureate: Other-dominant, with Arts & Sciences",High undergraduate,"Four-year, medium, highly residential",1833,242,1591,99,19,80,1833,1072,723,38,458,90,368,47,9,38,0,0,0,0,0,0,MA07
165671,Emmanuel College, ,400 The Fenway,Boston,MA,02115,-71.103634,42.340602,Private not-for-profit,Graduate degree or certificate offering,No,City: Large,Baccalaureate Colleges: Arts & Sciences Focus,"Postbaccalaureate: Business-dominant, with other professional programs",Very high undergraduate,"Four-year, small, highly residential",156,31,125,0,0,0,156,156,0,0,51,9,42,0,0,0,0,0,0,0,0,0,MA07
165699,Endicott College, ,376 Hale Street,Beverly,MA,01915,-70.840847,42.553296,Private not-for-profit,Graduate degree or certificate offering,No,Suburb: Large,Master's Colleges & Universities: Larger Programs,Research Doctoral: Professional-dominant,High undergraduate,"Four-year, medium, highly residential",1687,381,1306,29,15,14,1687,1168,365,154,573,167,406,8,6,2,21,3,18,1,0,1,MA06
165802,Fisher College, ,118 Beacon Street,Boston,MA,02116,-71.074125,42.355253,Private not-for-profit,Graduate degree or certificate offering,No,City: Large,Baccalaureate Colleges: Diverse Fields,"Postbaccalaureate: Business-dominant, with Arts & Sciences",Very high undergraduate,"Four-year, very small, primarily residential",172,67,105,17,13,4,172,44,46,82,46,24,22,11,9,2,0,0,0,0,0,0,MA08
165820,Fitchburg State University,Fitchburg State,160 Pearl St,Fitchburg,MA,01420-2697,-71.789666,42.588298,Public,Graduate degree or certificate offering,No,Suburb: Midsize,Master's Colleges & Universities: Larger Programs,"Postbaccalaureate: Business-dominant, with Arts & Sciences",Majority undergraduate,"Four-year, medium, primarily residential",5583,1486,4097,158,82,76,5583,3965,1068,550,901,308,593,48,22,26,0,0,0,0,0,0,MA03
165866,Framingham State University, ,100 State Street,Framingham,MA,01701-9101,-71.437565,42.297116,Public,Graduate degree or certificate offering,No,City: Small,Master's Colleges & Universities: Larger Programs,"Postbaccalaureate: Education-dominant, with Arts & Sciences",High undergraduate,"Four-year, medium, highly residential",3233,685,2548,20,5,15,3233,3202,31,0,435,119,316,10,2,8,0,0,0,0,0,0,MA05
165936,Gordon College, ,255 Grapevine Rd,Wenham,MA,01984,-70.82151,42.590567,Private not-for-profit,Graduate degree or certificate offering,No,Suburb: Large,Baccalaureate Colleges: Arts & Sciences Focus,"Postbaccalaureate: Education-dominant, with other professional programs",High undergraduate,"Four-year, small, highly residential",725,165,560,46,21,25,725,447,147,131,112,22,90,10,4,6,0,0,0,0,0,0,MA06
165945,Gordon-Conwell Theological Seminary,GCTS/Gordon-Conwell Seminary/Gordon Cromwell Theological Seminary,130 Essex St,South Hamilton,MA,01982,-70.846387,42.613475,Private not-for-profit,Graduate degree or certificate offering,No,Suburb: Large,Special Focus Four-Year: Faith-Related Institutions,"Postbaccalaureate: Other-dominant, with other professional programs",Exclusively graduate,Exclusively graduate/professional,1804,1168,636,120,79,41,1804,126,449,1229,288,181,107,36,22,14,0,0,0,0,0,0,MA06
166027,Harvard University, ,Massachusetts Hall,Cambridge,MA,02138,-71.118313,42.374471,Private not-for-profit,Graduate degree or certificate offering,No,City: Midsize,Doctoral Universities: Very High Research Activity,"Research Doctoral: Comprehensive programs, with medical/veterinary school",Majority graduate,"Four-year, large, highly residential",26793,12619,14174,7188,3550,3638,26793,24215,1724,854,4670,2213,2457,1334,626,708,656,364,292,207,129,78,MA05
166045,Hebrew College, ,160 Herrick Road,Newton Centre,MA,02459-2237,-71.189226,42.325677,Private not-for-profit,Graduate degree or certificate offering,No,City: Small,Special Focus Four-Year: Faith-Related Institutions,"Postbaccalaureate: Other-dominant, with Arts & Sciences",Majority graduate,"Four-year, very small, primarily residential",112,47,65,4,3,1,112,29,83,0,31,8,23,0,0,0,0,0,0,0,0,0,MA04
166054,Hellenic College-Holy Cross Greek Orthodox School of Theology, ,50 Goddard Ave,Brookline,MA,02445-7415,-71.129418,42.317018,Private not-for-profit,Graduate degree or certificate offering,No,Suburb: Large,Baccalaureate Colleges: Arts & Sciences Focus,Postbaccalaureate: Single program-Other,Majority graduate,"Four-year, very small, highly residential",95,77,18,0,0,0,95,0,0,95,23,21,2,0,0,0,0,0,0,0,0,0,MA04
166391,Lasell University, ,1844 Commonwealth Avenue,Newton,MA,02466,-71.24347,42.342148,Private not-for-profit,Graduate degree or certificate offering,No,City: Small,Master's Colleges & Universities: Larger Programs,Postbaccalaureate: Comprehensive programs,High undergraduate,"Four-year, small, highly residential",702,312,390,45,18,27,702,559,117,26,238,112,126,17,4,13,0,0,0,0,0,0,MA04
166452,Lesley University, ,29 Everett St,Cambridge,MA,02138-2790,-71.117303,42.38012,Private not-for-profit,Graduate degree or certificate offering,No,City: Midsize,Doctoral/Professional Universities,Research Doctoral: Professional-dominant,Majority undergraduate,"Four-year, small, primarily residential",3180,424,2756,120,14,106,3180,3180,0,0,648,96,552,32,4,28,31,10,21,5,1,4,MA05
166489,Longy School of Music of Bard College,Longy  Conservatory at Longy School of Music  Longy Conservatory,27 Garden Street,Cambridge,MA,02138,-71.123479,42.378657,Private not-for-profit,Graduate degree or certificate offering,No,City: Midsize,"Special Focus Four-Year: Arts, Music & Design Schools",Postbaccalaureate: Arts & sciences-dominant,Majority graduate,Exclusively graduate/professional,189,72,117,117,40,77,189,0,50,139,74,21,53,57,15,42,0,0,0,0,0,0,MA05
166513,University of Massachusetts-Lowell, ,1 University Ave,Lowell,MA,01854-5104,-71.326809,42.652864,Public,Graduate degree or certificate offering,No,Suburb: Large,Doctoral Universities: High Research Activity,Research Doctoral: STEM-dominant,High undergraduate,"Four-year, large, primarily residential",5850,3221,2629,722,435,287,5850,5223,284,343,1192,722,470,165,101,64,98,49,49,42,24,18,MA03
166629,University of Massachusetts-Amherst,UMass Amherst,374 Whitmore Building 181 Presidents Drive,Amherst,MA,01003,-72.526728,42.385999,Public,Graduate degree or certificate offering,No,Suburb: Large,Doctoral Universities: Very High Research Activity,"Research Doctoral: Comprehensive programs, no medical/veterinary school",High undergraduate,"Four-year, large, highly residential",9172,4388,4784,1964,1111,853,9172,5555,2507,1110,1697,913,784,383,246,137,258,130,128,108,61,47,MA02
166638,University of Massachusetts-Boston, ,100 Morrissey Boulevard,Boston,MA,02125-3393,-71.036865,42.312881,Public,Graduate degree or certificate offering,No,City: Large,Doctoral Universities: High Research Activity,Research Doctoral: Professional-dominant,High undergraduate,"Four-year, large, primarily nonresidential",3966,1315,2651,469,205,264,3966,3952,12,2,833,305,528,117,44,73,94,32,62,23,10,13,MA08
166656,MCPHS University,MCPHS University,179 Longwood Ave,Boston,MA,02115-5896,-71.101244,42.336825,Private not-for-profit,Graduate degree or certificate offering,No,City: Large,Special Focus Four-Year: Other Health Professions Schools,Research Doctoral: Professional-dominant,Majority undergraduate,"Four-year, medium, primarily residential",3998,1076,2922,442,149,293,3998,1526,857,1615,643,162,481,71,25,46,4,2,2,3,2,1,MA07
166674,Massachusetts College of Art and Design, ,621 Huntington Ave,Boston,MA,02115-5882,-71.099275,42.336862,Public,Graduate degree or certificate offering,No,City: Large,"Special Focus Four-Year: Arts, Music & Design Schools","Postbaccalaureate: Other-dominant, with Arts & Sciences",Very high undergraduate,"Four-year, small, highly residential",154,59,95,29,12,17,154,0,152,2,66,25,41,13,5,8,0,0,0,0,0,0,MA07
166683,Massachusetts Institute of Technology,"MIT, M.I.T.",77 Massachusetts Avenue,Cambridge,MA,02139-4307,-71.093226,42.359243,Private not-for-profit,Graduate degree or certificate offering,No,City: Midsize,Doctoral Universities: Very High Research Activity,"Research Doctoral: Comprehensive programs, no medical/veterinary school",Majority graduate,"Four-year, large, highly residential",7717,4849,2868,3174,2162,1012,7717,4245,3472,0,1803,1099,704,727,461,266,568,402,166,259,191,68,MA07
166692,Massachusetts Maritime Academy, ,101 Academy Dr,Buzzards Bay,MA,02532-1803,-70.624084,41.739072,Public,Graduate degree or certificate offering,No,Suburb: Midsize,Master's Colleges & Universities: Small Programs,"Postbaccalaureate: Other-dominant, with Arts & Sciences",Very high undergraduate,"Four-year, small, highly residential",106,76,30,3,1,2,106,106,0,0,50,33,17,1,0,1,0,0,0,0,0,0,MA09
166708,University of Massachusetts Medical School Worcester, ,55 Lake Ave North,Worcester,MA,01655,-71.762144,42.278002,Public,Graduate degree or certificate offering,No,City: Midsize,Special Focus Four-Year: Research Institutions,Research Doctoral: STEM-dominant,Exclusively graduate,Exclusively graduate/professional,1339,491,848,117,52,65,1339,63,28,1248,59,10,49,2,1,1,45,20,25,6,2,4,MA02
166717,William James College,William James College,One Wells Avenue,Newton,MA,02459,-71.203256,42.294995,Private not-for-profit,Graduate degree or certificate offering,No,City: Small,Special Focus Four-Year: Other Health Professions Schools,"Postbaccalaureate: Other-dominant, with Arts & Sciences",Majority graduate,"Four-year, very small, primarily nonresidential",887,169,718,0,0,0,887,47,137,703,156,31,125,0,0,0,0,0,0,0,0,0,MA04
166850,Merrimack College,Merrimack,315 Turnpike St,North Andover,MA,01845,-71.124216,42.668344,Private not-for-profit,Graduate degree or certificate offering,No,Suburb: Large,Master's Colleges & Universities: Larger Programs,"Postbaccalaureate: Education-dominant, with Arts & Sciences",High undergraduate,"Four-year, medium, highly residential",1711,461,1250,32,18,14,1711,267,1117,327,663,207,456,21,14,7,0,0,0,0,0,0,MA06
166869,MGH Institute of Health Professions, ,36 1st Avenue,Boston,MA,02129-4557,-71.054002,42.375018,Private not-for-profit,Graduate degree or certificate offering,No,City: Large,Special Focus Four-Year: Other Health Professions Schools,Research Doctoral: Single program-Other,Majority graduate,"Four-year, small, primarily nonresidential",1312,246,1066,0,0,0,1312,51,1261,0,242,48,194,0,0,0,3,0,3,0,0,0,MA07
166939,Mount Holyoke College,MHC,50 College Street,South Hadley,MA,01075-1489,-72.575511,42.256838,Private not-for-profit,Graduate degree or certificate offering,No,Suburb: Large,Baccalaureate Colleges: Arts & Sciences Focus,Postbaccalaureate: Single program-Education,Very high undergraduate,"Four-year, small, highly residential",189,23,166,10,0,10,189,172,17,0,58,8,50,4,0,4,0,0,0,0,0,0,MA01
167057,The New England Conservatory of Music, ,290 Huntington Ave,Boston,MA,02115-5018,-71.08629,42.340946,Private not-for-profit,Graduate degree or certificate offering,No,City: Large,"Special Focus Four-Year: Arts, Music & Design Schools",Research Doctoral: Single program-Other,Majority undergraduate,"Four-year, very small, highly residential",347,182,165,152,67,85,347,85,225,37,122,62,60,55,26,29,6,4,2,4,2,2,MA07
167093,New England College of Optometry,New England College of Optometry/NECO/NEEI/New England Eye Institute,424 Beacon St,Boston,MA,02115,-71.086829,42.351853,Private not-for-profit,Graduate degree or certificate offering,No,City: Large,Special Focus Four-Year: Other Health Professions Schools,"Postbaccalaureate: Other-dominant, with Arts & Sciences",Exclusively graduate,Exclusively graduate/professional,549,131,418,162,41,121,549,0,0,549,4,0,4,2,0,2,0,0,0,0,0,0,MA07
167215,New England Law-Boston,New England Law | Boston,154 Stuart St,Boston,MA,02116,-71.0665,42.350833,Private not-for-profit,Graduate degree or certificate offering,No,City: Large,Special Focus Four-Year: Law Schools,Postbaccalaureate: Single program-Other,Exclusively graduate,Exclusively graduate/professional,908,325,583,18,6,12,908,282,625,1,0,0,0,0,0,0,0,0,0,0,0,0,MA07
167260,Nichols College,Nichols,Center Rd,Dudley,MA,01571-5000,-71.930283,42.044033,Private not-for-profit,Graduate degree or certificate offering,No,Suburb: Large,Master's Colleges & Universities: Medium Programs,"Postbaccalaureate: Business-dominant, with other professional programs",Very high undergraduate,"Four-year, small, highly residential",356,187,169,7,7,0,356,356,0,0,144,66,78,3,3,0,0,0,0,0,0,0,MA01
167288,Massachusetts College of Liberal Arts,MCLA,375 Church Street,North Adams,MA,01247-4100,-73.102817,42.691361,Public,Graduate degree or certificate offering,No,Town: Fringe,Baccalaureate Colleges: Arts & Sciences Focus,"Postbaccalaureate: Education-dominant, with other professional programs",Very high undergraduate,"Four-year, small, highly residential",346,107,239,0,0,0,346,31,141,174,32,7,25,0,0,0,0,0,0,0,0,0,MA01
167358,Northeastern University, ,360 Huntington Ave,Boston,MA,02115-5005,-71.088782,42.339992,Private not-for-profit,Graduate degree or certificate offering,No,City: Large,Doctoral Universities: Very High Research Activity,"Research Doctoral: Comprehensive programs, no medical/veterinary school",Majority undergraduate,"Four-year, large, highly residential",10817,6172,4645,6335,4071,2264,10817,700,4219,5898,3193,1956,1237,2210,1430,780,196,141,55,95,77,18,MA07
167394,College of Our Lady of the Elms,Elms College,291 Springfield St,Chicopee,MA,01013,-72.60154,42.141781,Private not-for-profit,Graduate degree or certificate offering,No,Suburb: Large,Master's Colleges & Universities: Medium Programs,"Postbaccalaureate: Education-dominant, with Arts & Sciences",High undergraduate,"Four-year, small, primarily residential",437,85,352,6,2,4,437,89,154,194,93,28,65,4,1,3,0,0,0,0,0,0,MA01
167455,Pine Manor College, ,400 Heath St,Chestnut Hill,MA,02467,-71.156464,42.320827,Private not-for-profit,Graduate degree or certificate offering,No,Suburb: Large,Baccalaureate Colleges: Diverse Fields,Postbaccalaureate: Single program-Other,Very high undergraduate,"Four-year, very small, highly residential",29,8,21,0,0,0,29,0,29,0,9,1,8,0,0,0,0,0,0,0,0,0,MA04
167464,Pope St John XXIII National Seminary, ,558 South Ave,Weston,MA,02493-2699,-71.311059,42.339408,Private not-for-profit,Graduate degree or certificate offering,No,Suburb: Large,Special Focus Four-Year: Faith-Related Institutions,Postbaccalaureate: Single program-Other,Exclusively graduate,Exclusively graduate/professional,55,55,0,5,5,0,55,0,0,55,17,17,0,0,0,0,0,0,0,0,0,0,MA05
167598,Regis College, ,235 Wellesley St,Weston,MA,02493-1571,-71.310561,42.351291,Private not-for-profit,Graduate degree or certificate offering,No,Suburb: Large,Master's Colleges & Universities: Larger Programs,"Postbaccalaureate: Other-dominant, with Arts & Sciences",Majority undergraduate,"Four-year, small, highly residential",2970,366,2604,9,4,5,2970,2392,333,245,470,73,397,2,0,2,0,0,0,0,0,0,MA05
167677,Saint John's Seminary, ,127 Lake Street,Brighton,MA,02135-3846,-71.161998,42.344146,Private not-for-profit,Graduate degree or certificate offering,No,City: Large,Special Focus Four-Year: Faith-Related Institutions,Postbaccalaureate: Single program-Other,Majority graduate,"Four-year, very small, highly residential",104,76,28,17,17,0,104,0,0,104,24,23,1,8,8,0,0,0,0,0,0,0,MA07
167729,Salem State University, ,352 Lafayette St,Salem,MA,01970,-70.890234,42.503575,Public,Graduate degree or certificate offering,No,Suburb: Large,Master's Colleges & Universities: Larger Programs,Postbaccalaureate: Comprehensive programs,High undergraduate,"Four-year, medium, primarily residential",1919,424,1495,47,16,31,1919,1314,578,27,461,89,372,11,3,8,0,0,0,0,0,0,MA06
167783,Simmons University, ,300 The Fenway,Boston,MA,02115-5898,-71.099967,42.3393,Private not-for-profit,Graduate degree or certificate offering,No,City: Large,Doctoral/Professional Universities,Research Doctoral: Professional-dominant,Majority graduate,"Four-year, medium, highly residential",5550,597,4953,45,4,41,5550,4559,991,0,1773,193,1580,13,0,13,11,4,7,1,0,1,MA07
167835,Smith College, ,Elm St,Northampton,MA,01063,-72.638097,42.318111,Private not-for-profit,Graduate degree or certificate offering,No,Suburb: Large,Baccalaureate Colleges: Arts & Sciences Focus,Research Doctoral: Single program-Other,High undergraduate,"Four-year, small, highly residential",599,92,507,24,7,17,599,358,241,0,143,21,122,4,2,2,6,0,6,0,0,0,MA02
167899,Springfield College, ,263 Alden St,Springfield,MA,01109-3797,-72.556647,42.1022,Private not-for-profit,Graduate degree or certificate offering,No,City: Midsize,Doctoral/Professional Universities,Research Doctoral: STEM-dominant,Majority undergraduate,"Four-year, small, highly residential",1012,282,730,35,20,15,1012,6,67,939,314,82,232,19,10,9,7,2,5,0,0,0,MA01
167987,University of Massachusetts-Dartmouth,UMass Dartmouth,285 Old Westport Rd,North Dartmouth,MA,02747-2300,-71.004552,41.62869,Public,Graduate degree or certificate offering,No,Suburb: Midsize,Doctoral Universities: High Research Activity,Research Doctoral: STEM-dominant,High undergraduate,"Four-year, medium, highly residential",2156,1003,1153,264,156,108,2156,1633,337,186,424,208,216,96,53,43,32,10,22,14,5,9,MA09
167996,Stonehill College, ,320 Washington Street,Easton,MA,02357-6110,-71.080632,42.05905,Private not-for-profit,Graduate degree or certificate offering,No,Suburb: Large,Baccalaureate Colleges: Arts & Sciences Focus,"Postbaccalaureate: Business-dominant, with other professional programs",Very high undergraduate,"Four-year, small, highly residential",92,29,63,0,0,0,92,0,44,48,15,1,14,0,0,0,0,0,0,0,0,0,MA08
168005,Suffolk University, ,73 Tremont St.,Boston,MA,02108-3901,-71.060917,42.357945,Private not-for-profit,Graduate degree or certificate offering,No,City: Large,Doctoral/Professional Universities,Research Doctoral: Single program-Other,Majority undergraduate,"Four-year, medium, primarily residential",2662,1055,1607,357,156,201,2662,1070,390,1202,584,226,358,186,90,96,2,1,1,0,0,0,MA08
168148,Tufts University, , ,Medford,MA,02155-5555,-71.118293,42.40855,Private not-for-profit,Graduate degree or certificate offering,No,Suburb: Large,Doctoral Universities: Very High Research Activity,"Research Doctoral: Comprehensive programs, with medical/veterinary school",Majority undergraduate,"Four-year, large, highly residential",7108,2771,4337,974,487,487,7108,3221,3306,581,1459,593,866,340,154,186,115,56,59,29,19,10,MA05
168227,Wentworth Institute of Technology, ,550 Huntington Ave,Boston,MA,02115,-71.094983,42.336632,Private not-for-profit,Graduate degree or certificate offering,No,City: Large,Master's Colleges & Universities: Small Programs,"Postbaccalaureate: Other-dominant, with Arts & Sciences",Very high undergraduate,"Four-year, medium, highly residential",190,129,61,11,8,3,190,110,80,0,99,64,35,6,3,3,0,0,0,0,0,0,MA07
168254,Western New England University,WNE,1215 Wilbraham Rd,Springfield,MA,01119-2684,-72.520466,42.115017,Private not-for-profit,Graduate degree or certificate offering,No,City: Midsize,Doctoral/Professional Universities,Research Doctoral: Humanities/social sciences-dominant,High undergraduate,"Four-year, medium, highly residential",1249,476,773,39,22,17,1249,273,641,335,187,92,95,14,8,6,5,3,2,0,0,0,MA01
168263,Westfield State University, ,577 Western Ave,Westfield,MA,01086-1630,-72.796503,42.132698,Public,Graduate degree or certificate offering,No,Suburb: Large,Master's Colleges & Universities: Larger Programs,"Postbaccalaureate: Other-dominant, with Arts & Sciences",High undergraduate,"Four-year, medium, highly residential",1152,361,791,10,3,7,1152,937,111,104,240,69,171,0,0,0,0,0,0,0,0,0,MA01
168342,Williams College,Williams|William College|William|Williams College|Wiliams College|Wiliams,880 Main St,Williamstown,MA,01267,-73.203132,42.712725,Private not-for-profit,Graduate degree or certificate offering,No,Town: Fringe,Baccalaureate Colleges: Arts & Sciences Focus,"Postbaccalaureate: Other-dominant, with Arts & Sciences",Very high undergraduate,"Four-year, small, highly residential",25,10,15,2,0,2,25,0,0,25,14,5,9,2,0,2,0,0,0,0,0,0,MA01
168421,Worcester Polytechnic Institute,WPI,100 Institute Road,Worcester,MA,01609-2280,-71.808339,42.274853,Private not-for-profit,Graduate degree or certificate offering,No,City: Midsize,Doctoral Universities: High Research Activity,Research Doctoral: STEM-dominant,High undergraduate,"Four-year, medium, primarily residential",2481,1726,755,731,498,233,2481,1376,855,250,742,518,224,262,182,80,62,42,20,36,25,11,MA02
168430,Worcester State University, ,486 Chandler St,Worcester,MA,01602-2597,-71.844018,42.267526,Public,Graduate degree or certificate offering,No,City: Midsize,Master's Colleges & Universities: Larger Programs,"Postbaccalaureate: Education-dominant, with Arts & Sciences",Very high undergraduate,"Four-year, medium, primarily residential",1926,385,1541,12,4,8,1926,469,481,976,243,43,200,6,2,4,0,0,0,0,0,0,MA02
168528,Adrian College, ,110 S Madison St,Adrian,MI,49221-2575,-84.061481,41.898591,Private not-for-profit,Graduate degree or certificate offering,No,Town: Distant,Baccalaureate Colleges: Diverse Fields,"Postbaccalaureate: Other-dominant, with other professional programs",Very high undergraduate,"Four-year, small, highly residential",92,37,55,5,2,3,92,55,18,19,51,18,33,5,2,3,0,0,0,0,0,0,MI05
168740,Andrews University,Andrews,"4150 Administration Drive, Room 136",Berrien Springs,MI,49104,-86.355815,41.963859,Private not-for-profit,Graduate degree or certificate offering,No,Town: Fringe,Doctoral/Professional Universities,Research Doctoral: Professional-dominant,Majority undergraduate,"Four-year, small, highly residential",2234,1454,780,458,333,125,2234,470,387,1377,360,227,133,37,23,14,93,57,36,3,2,1,MI05
168786,Aquinas College,AQ,1700 Fulton St. E,Grand Rapids,MI,49506-1801,-85.628785,42.96019,Private not-for-profit,Graduate degree or certificate offering,No,City: Midsize,Baccalaureate Colleges: Arts & Sciences Focus,"Postbaccalaureate: Education-dominant, with other professional programs",Very high undergraduate,"Four-year, small, highly residential",193,45,148,1,0,1,193,21,76,96,36,8,28,0,0,0,0,0,0,0,0,0,MI03
168847,Baker College, ,1020 S Washington St,Owosso,MI,48867,-84.172404,42.984804,Private not-for-profit,Graduate degree or certificate offering,No,Town: Distant,Master's Colleges & Universities: Medium Programs,Research Doctoral: Single program-Other,Very high undergraduate,"Four-year, medium, primarily nonresidential",432,127,305,0,0,0,432,380,47,5,170,52,118,0,0,0,5,2,3,0,0,0,MI07
169080,Calvin University,Calvin,3201 Burton Street SE,Grand Rapids,MI,49546,-85.587548,42.929916,Private not-for-profit,Graduate degree or certificate offering,No,City: Midsize,Master's Colleges & Universities: Small Programs,"Postbaccalaureate: Other-dominant, with other professional programs",Very high undergraduate,"Four-year, medium, highly residential",229,54,175,36,12,24,229,91,88,50,69,19,50,12,4,8,0,0,0,0,0,0,MI03
169099,Calvin Theological Seminary, ,3233 Burton St SE,Grand Rapids,MI,49546-4387,-85.586439,42.927951,Private not-for-profit,Graduate degree or certificate offering,No,City: Midsize,Special Focus Four-Year: Faith-Related Institutions,Research Doctoral: Single program-Other,Exclusively graduate,Exclusively graduate/professional,325,233,92,128,103,25,325,132,12,181,64,46,18,26,20,6,3,3,0,2,2,0,MI03
169220,Michigan School of Psychology,MSP,26811 Orchard Lake Rd.,Farmington Hills,MI,48334-4512,-83.359575,42.491427,Private not-for-profit,Graduate degree or certificate offering,No,City: Small,Special Focus Four-Year: Other Health Professions Schools,Postbaccalaureate: Single program-Other,Exclusively graduate,Exclusively graduate/professional,268,58,210,0,0,0,268,0,0,268,60,14,46,0,0,0,0,0,0,0,0,0,MI11
169248,Central Michigan University, ,106 Warriner Hall,Mount Pleasant,MI,48859,-84.77525,43.591203,Public,Graduate degree or certificate offering,No,Town: Distant,Doctoral Universities: High Research Activity,"Research Doctoral: Comprehensive programs, with medical/veterinary school",High undergraduate,"Four-year, large, primarily residential",5812,2358,3454,400,243,157,5812,3439,291,2082,1506,651,855,151,107,44,70,35,35,10,7,3,MI02
169327,Cleary University,Cleary College,3750 Cleary Drive,Howell,MI,48843,-83.879987,42.586638,Private not-for-profit,Graduate degree or certificate offering,No,Suburb: Midsize,Special Focus Four-Year: Business & Management Schools,"Postbaccalaureate: Business-dominant, with other professional programs",High undergraduate,"Four-year, very small, primarily residential",191,77,114,2,2,0,191,163,25,3,83,28,55,0,0,0,0,0,0,0,0,0,MI07
169363,Concordia University Ann Arbor,CUAA Concordia University Concordia University Ann ArborConcordia University Michigan Concordia (Michigan) C.U.A.A,4090 Geddes Rd,Ann Arbor,MI,48105,-83.68268,42.273157,Private not-for-profit,Graduate degree or certificate offering,No,City: Midsize,Master's Colleges & Universities: Small Programs,"Postbaccalaureate: Education-dominant, with other professional programs",High undergraduate,"Four-year, very small, highly residential",235,57,178,3,2,1,235,147,0,88,46,20,26,1,1,0,0,0,0,0,0,0,MI06
169424,Cranbrook Academy of Art, ,39221  Woodward Avenue,Bloomfield Hills,MI,48304,-83.250681,42.568904,Private not-for-profit,Graduate degree or certificate offering,No,Suburb: Large,"Special Focus Four-Year: Arts, Music & Design Schools","Postbaccalaureate: Other-dominant, with Arts & Sciences",Exclusively graduate,Exclusively graduate/professional,126,48,78,15,8,7,126,0,0,126,65,26,39,11,7,4,0,0,0,0,0,0,MI11
169442,College for Creative Studies,CCS,201 E Kirby,Detroit,MI,48202,-83.062352,42.361839,Private not-for-profit,Graduate degree or certificate offering,No,City: Large,"Special Focus Four-Year: Arts, Music & Design Schools","Postbaccalaureate: Other-dominant, with Arts & Sciences",Very high undergraduate,"Four-year, small, primarily residential",50,21,29,25,14,11,50,11,39,0,12,4,8,8,4,4,0,0,0,0,0,0,MI13
169479,Davenport University, ,6191 Kraft Avenue S.E.,Grand Rapids,MI,49512-9396,-85.533519,42.850013,Private not-for-profit,Graduate degree or certificate offering,No,Suburb: Large,Master's Colleges & Universities: Larger Programs,"Postbaccalaureate: Business-dominant, with Arts & Sciences",High undergraduate,"Four-year, medium, primarily nonresidential",1427,556,871,71,40,31,1427,1179,206,42,404,170,234,25,14,11,0,0,0,0,0,0,MI02
169716,University of Detroit Mercy,"Detroit Mercy, UDM, U of D, University of Detroit",4001 W McNichols Rd,Detroit,MI,48221-3038,-83.139158,42.414222,Private not-for-profit,Graduate degree or certificate offering,No,City: Large,Doctoral/Professional Universities,Research Doctoral: Professional-dominant,Majority undergraduate,"Four-year, medium, primarily residential",2542,1103,1439,535,293,242,2542,172,2287,83,458,215,243,91,66,25,9,5,4,1,1,0,MI13
169798,Eastern Michigan University, ,900 Oakwood St.,Ypsilanti,MI,48197,-83.627443,42.251675,Public,Graduate degree or certificate offering,No,Suburb: Large,Doctoral Universities: High Research Activity,Research Doctoral: Professional-dominant,High undergraduate,"Four-year, large, primarily residential",3358,1095,2263,166,67,99,3358,2074,1153,131,977,312,665,64,27,37,32,10,22,4,2,2,MI06
169910,Ferris State University, ,1201 S State St,Big Rapids,MI,49307-2251,-85.481925,43.687724,Public,Graduate degree or certificate offering,No,Town: Distant,Doctoral/Professional Universities,Research Doctoral: Professional-dominant,High undergraduate,"Four-year, medium, primarily residential",1442,506,936,31,13,18,1442,403,159,880,189,55,134,5,0,5,30,13,17,0,0,0,MI02
169983,Kettering University,GMI Engineering & Management Institute,1700 University Avenue,Flint,MI,48504-6214,-83.71282,43.012468,Private not-for-profit,Graduate degree or certificate offering,No,City: Small,Master's Colleges & Universities: Medium Programs,"Postbaccalaureate: Business-dominant, with Arts & Sciences",High undergraduate,"Four-year, small, primarily residential",558,406,152,89,76,13,558,480,0,78,202,140,62,26,25,1,0,0,0,0,0,0,MI08
170000,Grace Christian University, ,1011 Aldon SW,Wyoming,MI,49509,-85.692077,42.919541,Private not-for-profit,Graduate degree or certificate offering,No,Suburb: Large,Baccalaureate Colleges: Diverse Fields,"Postbaccalaureate: Business-dominant, with other professional programs",Very high undergraduate,"Four-year, very small, primarily nonresidential",78,31,47,0,0,0,78,77,1,0,22,12,10,0,0,0,0,0,0,0,0,0,MI03
170037,Cornerstone University, ,1001 E Beltline Ave NE,Grand Rapids,MI,49525-5897,-85.595328,42.979966,Private not-for-profit,Graduate degree or certificate offering,No,City: Midsize,Master's Colleges & Universities: Larger Programs,Research Doctoral: Single program-Education,High undergraduate,"Four-year, small, primarily residential",678,300,378,30,14,16,678,411,135,132,169,77,92,24,14,10,7,5,2,0,0,0,MI03
170082,Grand Valley State University,Grand Valley|GVSU|Grand Valley State|,1 Campus Dr,Allendale,MI,49401-9403,-85.889826,42.963001,Public,Graduate degree or certificate offering,No,Suburb: Large,Doctoral/Professional Universities,"Postbaccalaureate: Other-dominant, with Arts & Sciences",Very high undergraduate,"Four-year, large, primarily residential",3891,1096,2795,162,81,81,3891,1232,2284,375,927,269,658,58,28,30,0,0,0,0,0,0,MI03
170286,Hillsdale College, ,33 E College St,Hillsdale,MI,49242,-84.633195,41.933682,Private not-for-profit,Graduate degree or certificate offering,No,Town: Distant,Baccalaureate Colleges: Arts & Sciences Focus,Research Doctoral: Single program-Other,Very high undergraduate,"Four-year, small, highly residential",87,57,30,0,0,0,87,0,0,87,13,7,6,0,0,0,2,2,0,0,0,0,MI05
170639,Lake Superior State University, ,650 W Easterday Ave,Sault Ste Marie,MI,49783,-84.365573,46.492849,Public,No graduate offering,No,Town: Remote,Baccalaureate Colleges: Diverse Fields,Not classified (Exclusively Undergraduate),Exclusively undergraduate four-year,"Four-year, small, highly residential",5,0,5,0,0,0,5,5,0,0,0,0,0,0,0,0,0,0,0,0,0,0,MI01
170675,Lawrence Technological University, ,21000 West Ten Mile Road,Southfield,MI,48075-1058,-83.25003,42.474072,Private not-for-profit,Graduate degree or certificate offering,No,City: Small,Master's Colleges & Universities: Larger Programs,Research Doctoral: STEM-dominant,High undergraduate,"Four-year, small, highly residential",817,543,274,217,168,49,817,724,49,44,266,172,94,107,78,29,10,8,2,5,4,1,MI12
170806,Madonna University, ,36600 Schoolcraft Rd,Livonia,MI,48150-1176,-83.404722,42.384323,Private not-for-profit,Graduate degree or certificate offering,No,City: Small,Master's Colleges & Universities: Medium Programs,"Postbaccalaureate: Other-dominant, with Arts & Sciences",High undergraduate,"Four-year, small, primarily nonresidential",789,171,618,47,26,21,789,188,314,287,215,43,172,27,15,12,0,0,0,0,0,0,MI12
170967,Rochester University, ,800 West Avon Road,Rochester Hills,MI,48307,-83.144959,42.667521,Private not-for-profit,Graduate degree or certificate offering,No,Suburb: Large,Baccalaureate Colleges: Diverse Fields,Postbaccalaureate: Single program-Other,Very high undergraduate,"Four-year, very small, primarily residential",43,34,9,0,0,0,43,0,43,0,17,15,2,0,0,0,0,0,0,0,0,0,MI10
170976,University of Michigan-Ann Arbor,U of Michigan|U of M|Univ of Michigan|U Michigan Ann Arbor|University of Michigan Ann Arbor,503 Thompson Street,Ann Arbor,MI,48109,-83.742769,42.275921,Public,Graduate degree or certificate offering,No,City: Midsize,Doctoral Universities: Very High Research Activity,"Research Doctoral: Comprehensive programs, with medical/veterinary school",Majority undergraduate,"Four-year, large, primarily residential",17528,8849,8679,4754,2910,1844,17528,3571,10956,3001,4821,2389,2432,1481,883,598,793,428,365,272,185,87,MI06
171100,Michigan State University,MSU|Spartans|MI State University|State|MI State U, ,East Lansing,MI,48824-1046,-84.476111,42.73212,Public,Graduate degree or certificate offering,No,City: Small,Doctoral Universities: Very High Research Activity,"Research Doctoral: Comprehensive programs, with medical/veterinary school",High undergraduate,"Four-year, large, primarily residential",12931,5557,7374,2200,1225,975,12931,4393,8538,0,2227,887,1340,350,165,185,583,301,282,224,131,93,MI07
171128,Michigan Technological University,Michigan Tech|MTU|Michigan Tech University|Mich Tech|Michigan Technological Univ|Michigan Tech Univ|MT,1400 Townsend Drive,Houghton,MI,49931-1295,-88.548092,47.11866,Public,Graduate degree or certificate offering,No,Town: Remote,Doctoral Universities: High Research Activity,"Research Doctoral: Comprehensive programs, no medical/veterinary school",High undergraduate,"Four-year, medium, highly residential",1374,947,427,625,450,175,1374,290,161,923,424,290,134,202,155,47,84,58,26,53,36,17,MI01
171137,University of Michigan-Dearborn,UM-Dearborn,4901 Evergreen Rd,Dearborn,MI,48128-1491,-83.231417,42.317287,Public,Graduate degree or certificate offering,No,City: Midsize,Master's Colleges & Universities: Larger Programs,Research Doctoral: STEM-dominant,High undergraduate,"Four-year, medium, primarily nonresidential",2615,1601,1014,618,402,216,2615,1780,754,81,764,460,304,231,152,79,8,6,2,3,3,0,MI12
171146,University of Michigan-Flint,UM-Flint,303 E. Kearsley Street,Flint,MI,48502-1950,-83.690276,43.01875,Public,Graduate degree or certificate offering,No,City: Small,Doctoral/Professional Universities,Research Doctoral: Single program-Education,High undergraduate,"Four-year, medium, primarily nonresidential",1744,562,1182,84,38,46,1744,871,719,154,335,102,233,23,12,11,7,3,4,0,0,0,MI08
171456,Northern Michigan University, ,1401 Presque Isle Avenue,Marquette,MI,49855-5301,-87.406568,46.559751,Public,Graduate degree or certificate offering,No,Town: Remote,Master's Colleges & Universities: Medium Programs,Postbaccalaureate: Comprehensive programs,Very high undergraduate,"Four-year, medium, primarily residential",840,220,620,11,7,4,840,448,247,145,151,37,114,3,2,1,0,0,0,0,0,0,MI01
171492,Northwood University,NU,4000 Whiting Dr,Midland,MI,48640-2398,-84.27682,43.628717,Private not-for-profit,Graduate degree or certificate offering,No,City: Small,Special Focus Four-Year: Business & Management Schools,Postbaccalaureate: Single program-Business,Very high undergraduate,"Four-year, small, primarily residential",431,236,195,13,6,7,431,344,87,0,155,71,84,7,4,3,0,0,0,0,0,0,MI08
171571,Oakland University,Oakland|OU|O.U.,2200 North Squirrel Road,Rochester Hills,MI,48309-4401,-83.216418,42.674573,Public,Graduate degree or certificate offering,No,Suburb: Large,Doctoral Universities: High Research Activity,Research Doctoral: STEM-dominant,High undergraduate,"Four-year, large, primarily nonresidential",4094,1801,2293,639,356,283,4094,2102,1359,633,819,337,482,156,77,79,71,32,39,16,8,8,MI11
171599,Olivet College,OC Comets,320 South Main Street,Olivet,MI,49076,-84.923891,42.442891,Private not-for-profit,Graduate degree or certificate offering,No,Rural: Distant,Baccalaureate Colleges: Diverse Fields,Postbaccalaureate: Single program-Business,Very high undergraduate,"Four-year, very small, highly residential",78,37,41,0,0,0,78,64,0,14,34,12,22,0,0,0,0,0,0,0,0,0,MI07
171881,Kuyper College, ,3333 East Beltline Ave NE,Grand Rapids,MI,49525-9781,-85.592657,43.02195,Private not-for-profit,Graduate degree or certificate offering,No,Suburb: Large,Baccalaureate Colleges: Diverse Fields,Not classified (Exclusively Undergraduate),Very high undergraduate,"Four-year, very small, primarily residential",20,16,4,0,0,0,20,0,0,20,2,2,0,0,0,0,0,0,0,0,0,0,MI03
172033,Sacred Heart Major Seminary,"SHMS; Sacred Heart; Sacred Heart Seminary; Sacred Heart Major Seminary, Inc.",2701 Chicago Blvd,Detroit,MI,48206-1799,-83.111682,42.375248,Private not-for-profit,Graduate degree or certificate offering,No,City: Large,Baccalaureate Colleges: Arts & Sciences Focus,Postbaccalaureate: Single program-Other,Majority undergraduate,"Four-year, very small, primarily nonresidential",176,140,36,15,13,2,176,60,105,11,23,18,5,2,2,0,0,0,0,0,0,0,MI13
172051,Saginaw Valley State University, ,7400 Bay Rd,University Center,MI,48710,-83.964273,43.51176,Public,Graduate degree or certificate offering,No,Suburb: Midsize,Master's Colleges & Universities: Larger Programs,"Postbaccalaureate: Other-dominant, with Arts & Sciences",Very high undergraduate,"Four-year, medium, primarily residential",997,204,793,50,22,28,997,390,489,118,292,57,235,19,7,12,0,0,0,0,0,0,MI08
172264,Siena Heights University, ,1247 E. Siena Heights Dr.,Adrian,MI,49221,-84.018841,41.905624,Private not-for-profit,Graduate degree or certificate offering,No,Town: Distant,Master's Colleges & Universities: Medium Programs,"Postbaccalaureate: Business-dominant, with other professional programs",Very high undergraduate,"Four-year, small, primarily residential",241,87,154,0,0,0,241,159,34,48,95,36,59,0,0,0,0,0,0,0,0,0,MI05
172334,Spring Arbor University,SAU | SAC | Spring Arbor College | Spring Arber Unviversity | Spring Arbor | Spring Arber | Spring Arbor Collage,106 E. Main St,Spring Arbor,MI,49283-9799,-84.556074,42.206568,Private not-for-profit,Graduate degree or certificate offering,No,Suburb: Small,Master's Colleges & Universities: Larger Programs,"Postbaccalaureate: Other-dominant, with Arts & Sciences",Majority graduate,"Four-year, small, primarily residential",2094,266,1828,6,1,5,2094,1629,364,101,671,100,571,0,0,0,0,0,0,0,0,0,MI05
172477,Western Michigan University-Thomas M. Cooley Law School,Western Michigan University Cooley Law School,300 S Capitol Ave,Lansing,MI,48933,-84.554429,42.731,Private not-for-profit,Graduate degree or certificate offering,No,City: Midsize,Special Focus Four-Year: Law Schools,Postbaccalaureate: Single program-Other,Exclusively graduate,Exclusively graduate/professional,1178,472,706,33,15,18,1178,1178,0,0,26,10,16,0,0,0,0,0,0,0,0,0,MI07
172608,Walsh College,Walsh,3838 Livernois,Troy,MI,48083-5066,-83.147197,42.573888,Private not-for-profit,Graduate degree or certificate offering,No,City: Small,Special Focus Four-Year: Business & Management Schools,"Postbaccalaureate: Business-dominant, with Arts & Sciences",Majority graduate,"Four-year, very small, primarily nonresidential",1436,677,759,75,26,49,1436,1436,0,0,386,194,192,22,8,14,0,0,0,0,0,0,MI11
172644,Wayne State University,WSU,42 W. Warren Ave.,Detroit,MI,48202,-83.068998,42.358994,Public,Graduate degree or certificate offering,No,City: Large,Doctoral Universities: Very High Research Activity,"Research Doctoral: Comprehensive programs, with medical/veterinary school",Majority undergraduate,"Four-year, large, primarily nonresidential",10163,4061,6102,1005,576,429,10163,6025,1896,2242,2062,740,1322,183,111,72,180,90,90,47,27,20,MI13
172699,Western Michigan University,WMU,1903 W Michigan Ave,Kalamazoo,MI,49008-5200,-85.613759,42.282194,Public,Graduate degree or certificate offering,No,City: Small,Doctoral Universities: High Research Activity,"Research Doctoral: Comprehensive programs, no medical/veterinary school",High undergraduate,"Four-year, large, primarily residential",4718,1759,2959,656,389,267,4718,2133,1857,728,1210,413,797,185,118,67,116,61,55,43,31,12,MI04
172705,Western Theological Seminary, ,101 E 13th St,Holland,MI,49423-3622,-86.10324,42.786246,Private not-for-profit,Graduate degree or certificate offering,No,City: Small,Special Focus Four-Year: Faith-Related Institutions,Postbaccalaureate: Single program-Other,Exclusively graduate,Exclusively graduate/professional,460,289,171,22,19,3,460,49,357,54,28,12,16,2,0,2,0,0,0,0,0,0,MI04
173045,Augsburg University, ,2211 Riverside Ave,Minneapolis,MN,55454,-93.240436,44.966307,Private not-for-profit,Graduate degree or certificate offering,No,City: Large,Master's Colleges & Universities: Larger Programs,"Postbaccalaureate: Business-dominant, with Arts & Sciences",High undergraduate,"Four-year, small, primarily residential",1198,344,854,21,8,13,1198,109,682,407,296,92,204,3,1,2,0,0,0,0,0,0,MN05
173124,Bemidji State University, ,1500 Birchmont Dr,Bemidji,MN,56601,-94.874119,47.482341,Public,Graduate degree or certificate offering,No,Town: Remote,Master's Colleges & Universities: Small Programs,"Postbaccalaureate: Education-dominant, with Arts & Sciences",Very high undergraduate,"Four-year, medium, primarily residential",610,229,381,7,3,4,610,476,76,58,99,41,58,4,1,3,0,0,0,0,0,0,MN08
173160,Bethel University, ,3900 Bethel Dr,Saint Paul,MN,55112,-93.161663,45.057655,Private not-for-profit,Graduate degree or certificate offering,No,Suburb: Large,Doctoral/Professional Universities,Research Doctoral: Single program-Education,High undergraduate,"Four-year, small, highly residential",1595,557,1038,24,14,10,1595,1059,252,284,340,115,225,11,3,8,19,6,13,0,0,0,MN04
173300,Concordia College at Moorhead, ,901 S 8th St,Moorhead,MN,56562,-96.76749,46.862482,Private not-for-profit,Graduate degree or certificate offering,No,Suburb: Midsize,Baccalaureate Colleges: Arts & Sciences Focus,"Postbaccalaureate: Education-dominant, with other professional programs",Very high undergraduate,"Four-year, small, highly residential",71,8,63,0,0,0,71,56,7,8,9,0,9,0,0,0,0,0,0,0,0,0,MN07
173328,Concordia University-Saint Paul,Concordia-St. Paul,1282 Concordia Ave,Saint Paul,MN,55104-5494,-93.154861,44.949759,Private not-for-profit,Graduate degree or certificate offering,No,City: Large,Master's Colleges & Universities: Larger Programs,Research Doctoral: Single program-Education,Majority undergraduate,"Four-year, medium, primarily nonresidential",2892,901,1991,120,65,55,2892,2473,291,128,763,232,531,50,30,20,16,2,14,0,0,0,MN04
173452,Martin Luther College,MLC,1995 Luther Ct,New Ulm,MN,56073-3965,-94.472326,44.30526,Private not-for-profit,Graduate degree or certificate offering,No,Town: Distant,Special Focus Four-Year: Other Special Focus Institutions,Postbaccalaureate: Single program-Education,Very high undergraduate,"Four-year, very small, highly residential",216,105,111,5,1,4,216,216,0,0,13,9,4,0,0,0,0,0,0,0,0,0,MN01
173665,Hamline University, ,1536 Hewitt Avenue,Saint Paul,MN,55104-1284,-93.164479,44.966246,Private not-for-profit,Graduate degree or certificate offering,No,City: Large,Master's Colleges & Universities: Larger Programs,Research Doctoral: Professional-dominant,High undergraduate,"Four-year, small, primarily residential",2043,539,1504,33,6,27,2043,1080,595,368,392,103,289,6,2,4,14,5,9,0,0,0,MN04
173683,Hazelden Betty Ford Graduate School of Addiction Studies, ,15251 Pleasant Valley Rd,Center City,MN,55012-0011,-92.805285,45.375319,Private not-for-profit,Graduate degree or certificate offering,No,Rural: Fringe,Special Focus Four-Year: Other Health Professions Schools,Postbaccalaureate: Single program-Other,Exclusively graduate,Exclusively graduate/professional,236,75,161,0,0,0,236,164,53,19,49,11,38,0,0,0,0,0,0,0,0,0,MN08
173896,Luther Seminary, ,2481 Como Ave,Saint Paul,MN,55108-1496,-93.196422,44.984629,Private not-for-profit,Graduate degree or certificate offering,No,City: Large,Special Focus Four-Year: Faith-Related Institutions,Postbaccalaureate: Single program-Other,Exclusively graduate,Exclusively graduate/professional,540,229,311,44,28,16,540,540,0,0,111,39,72,8,5,3,1,1,0,0,0,0,MN04
173920,Minnesota State University-Mankato, ,South Rd and Ellis Ave,Mankato,MN,56001,-93.99945,44.146712,Public,Graduate degree or certificate offering,No,City: Small,Master's Colleges & Universities: Larger Programs,Research Doctoral: Professional-dominant,Very high undergraduate,"Four-year, large, primarily nonresidential",2494,783,1711,192,99,93,2494,752,760,982,587,191,396,58,30,28,9,2,7,1,1,0,MN01
173957,Mayo Clinic College of Medicine and Science, ,200 1st St SW,Rochester,MN,55905,-92.466428,44.02215,Private not-for-profit,Graduate degree or certificate offering,No,City: Midsize,Special Focus Four-Year: Research Institutions,Research Doctoral: STEM-dominant,Majority graduate,Exclusively graduate/professional,1146,524,622,168,83,85,1146,0,0,1146,21,11,10,14,8,6,35,15,20,5,3,2,MN01
174020,Metropolitan State University, ,700 East Seventh Street,Saint Paul,MN,55106-5000,-93.074361,44.957256,Public,Graduate degree or certificate offering,No,City: Large,Master's Colleges & Universities: Medium Programs,Research Doctoral: Single program-Other,High undergraduate,"Four-year, medium, primarily nonresidential",1089,472,617,70,31,39,1089,326,628,135,190,76,114,10,4,6,2,2,0,0,0,0,MN04
174066,University of Minnesota-Twin Cities, ,100 Church Street SE,Minneapolis,MN,55455-0213,-93.235464,44.972851,Public,Graduate degree or certificate offering,No,City: Large,Doctoral Universities: Very High Research Activity,"Research Doctoral: Comprehensive programs, with medical/veterinary school",Majority undergraduate,"Four-year, large, primarily nonresidential",17531,7716,9815,3242,1826,1416,17531,4145,10031,3355,2946,1258,1688,541,306,235,699,390,309,279,177,102,MN05
174127,Minneapolis College of Art and Design,MCAD,2501 Stevens Ave,Minneapolis,MN,55404,-93.274705,44.956988,Private not-for-profit,Graduate degree or certificate offering,No,City: Large,"Special Focus Four-Year: Arts, Music & Design Schools",Postbaccalaureate: Single program-Other,Very high undergraduate,"Four-year, very small, primarily residential",117,30,87,13,3,10,117,93,13,11,29,8,21,3,1,2,0,0,0,0,0,0,MN05
174154,Herzing University-Minneapolis, ,435 Ford Road,St. Louis Park,MN,55426,-93.404863,44.975225,Private not-for-profit,Graduate degree or certificate offering,No,Suburb: Large,Special Focus Four-Year: Other Health Professions Schools,Postbaccalaureate: Single program-Business,Very high undergraduate,"Four-year, very small, primarily nonresidential",15,2,13,0,0,0,15,12,3,0,2,0,2,0,0,0,0,0,0,0,0,0,MN05
174233,University of Minnesota-Duluth, ,515 Darland Administration Bldg,Duluth,MN,55812,-92.084385,46.817126,Public,Graduate degree or certificate offering,No,City: Small,Master's Colleges & Universities: Larger Programs,Postbaccalaureate: Comprehensive programs,Very high undergraduate,"Four-year, medium, primarily residential",1046,473,573,84,52,32,1046,173,756,117,230,105,125,35,20,15,0,0,0,0,0,0,MN08
174358,Minnesota State University Moorhead,MSU Moorhead or MSUM,1104 Seventh Avenue South,Moorhead,MN,56563,-96.759532,46.867153,Public,Graduate degree or certificate offering,No,Suburb: Midsize,Master's Colleges & Universities: Larger Programs,Research Doctoral: Single program-Education,High undergraduate,"Four-year, medium, primarily residential",1644,488,1156,17,9,8,1644,1335,205,104,278,60,218,5,3,2,17,2,15,0,0,0,MN07
174437,North Central University, ,910 Elliot Ave,Minneapolis,MN,55404-1391,-93.261511,44.968625,Private not-for-profit,Graduate degree or certificate offering,No,City: Large,Baccalaureate Colleges: Diverse Fields,Postbaccalaureate: Single program-Business,Very high undergraduate,"Four-year, very small, highly residential",85,35,50,0,0,0,85,35,36,14,33,18,15,0,0,0,0,0,0,0,0,0,MN05
174491,University of Northwestern-St Paul,University of Northwestern (MN) | Northwestern,3003 Snelling Ave N,Saint Paul,MN,55113-1598,-93.167822,45.033703,Private not-for-profit,Graduate degree or certificate offering,No,Suburb: Large,Master's Colleges & Universities: Small Programs,"Postbaccalaureate: Business-dominant, with other professional programs",Very high undergraduate,"Four-year, small, highly residential",185,99,86,8,6,2,185,144,33,8,52,24,28,2,1,1,0,0,0,0,0,0,MN04
174507,Northwestern Health Sciences University, ,2501 W 84th St,Bloomington,MN,55431,-93.311222,44.850963,Private not-for-profit,Graduate degree or certificate offering,No,City: Small,Special Focus Four-Year: Other Health Professions Schools,Postbaccalaureate: Single program-Other,Majority graduate,"Four-year, very small, primarily nonresidential",848,382,466,88,43,45,848,3,594,251,21,3,18,0,0,0,0,0,0,0,0,0,MN03
174783,Saint Cloud State University,St. Cloud State University; St. Cloud State; SCSU,720 Fourth Ave. South,Saint Cloud,MN,56301-4498,-94.152657,45.553227,Public,Graduate degree or certificate offering,No,City: Small,Master's Colleges & Universities: Larger Programs,Research Doctoral: Single program-Education,High undergraduate,"Four-year, medium, primarily residential",2237,885,1352,396,208,188,2237,496,740,1001,515,198,317,106,50,56,24,6,18,2,0,2,MN06
174792,Saint Johns University,Saint John's,2850 Abbey Plaza,Collegeville,MN,56321,-94.393621,45.580075,Private not-for-profit,Graduate degree or certificate offering,No,Rural: Fringe,Baccalaureate Colleges: Arts & Sciences Focus,Postbaccalaureate: Single program-Other,Very high undergraduate,"Four-year, small, highly residential",151,83,68,34,22,12,151,68,61,22,26,15,11,6,5,1,0,0,0,0,0,0,MN06
174817,Saint Mary's University of Minnesota, ,700 Terrace Heights,Winona,MN,55987-1399,-91.695449,44.044736,Private not-for-profit,Graduate degree or certificate offering,No,Town: Distant,Doctoral/Professional Universities,Research Doctoral: Professional-dominant,Majority graduate,"Four-year, medium, primarily residential",4992,1464,3528,72,30,42,4992,2297,2249,446,1275,366,909,19,6,13,22,11,11,4,3,1,MN01
174862,Crown College, ,8700 College View Drive,Saint Bonifacius,MN,55375-9001,-93.743019,44.885393,Private not-for-profit,Graduate degree or certificate offering,No,Rural: Fringe,Master's Colleges & Universities: Medium Programs,"Postbaccalaureate: Other-dominant, with Arts & Sciences",Majority undergraduate,"Four-year, very small, primarily residential",450,213,237,3,3,0,450,450,0,0,127,66,61,1,1,0,0,0,0,0,0,0,MN06
174899,The College of Saint Scholastica, ,1200 Kenwood Ave,Duluth,MN,55811-4199,-92.106134,46.816082,Private not-for-profit,Graduate degree or certificate offering,No,City: Small,Doctoral/Professional Universities,"Postbaccalaureate: Other-dominant, with Arts & Sciences",Majority undergraduate,"Four-year, medium, primarily residential",2041,478,1563,3,2,1,2041,1063,178,800,308,66,242,1,1,0,0,0,0,0,0,0,MN08
174914,University of St Thomas,University of Saint Thomas,2115 Summit Ave,Saint Paul,MN,55105-1078,-93.188986,44.943439,Private not-for-profit,Graduate degree or certificate offering,No,City: Large,Doctoral/Professional Universities,Research Doctoral: Professional-dominant,High undergraduate,"Four-year, medium, primarily residential",4220,1901,2319,363,191,172,4220,1882,1996,342,971,455,516,114,64,50,52,11,41,7,1,6,MN04
175005,St Catherine University,St. Kate's,2004 Randolph Ave,Saint Paul,MN,55105,-93.183761,44.924926,Private not-for-profit,Graduate degree or certificate offering,No,City: Large,Doctoral/Professional Universities,"Postbaccalaureate: Other-dominant, with Arts & Sciences",High undergraduate,"Four-year, small, primarily residential",1553,157,1396,14,1,13,1553,373,1003,177,403,29,374,5,0,5,0,0,0,0,0,0,MN04
175014,Rasmussen University-Minnesota, ,226 Park Avenue South,St. Cloud,MN,56301-3713,-94.206254,45.548117,Private for-profit,Graduate degree or certificate offering,No,City: Small,Baccalaureate/Associate's Colleges: Mixed Baccalaureate/Associate's,"Postbaccalaureate: Other-dominant, with other professional programs",Very high undergraduate,"Four-year, small, primarily nonresidential",211,48,163,0,0,0,211,211,0,0,20,4,16,0,0,0,0,0,0,0,0,0,MN06
175078,Southwest Minnesota State University, ,1501 State St,Marshall,MN,56258-5468,-95.759548,44.45373,Public,Graduate degree or certificate offering,No,Town: Remote,Master's Colleges & Universities: Larger Programs,"Postbaccalaureate: Education-dominant, with other professional programs",High undergraduate,"Four-year, small, primarily residential",583,182,401,44,30,14,583,164,117,302,169,46,123,27,16,11,0,0,0,0,0,0,MN07
175139,United Theological Seminary of the Twin Cities,United Theological Seminary of the Twin Cities,767 Eustis St. Suite 140,St. Paul,MN,55114,-93.203624,44.962913,Private not-for-profit,Graduate degree or certificate offering,No,City: Large,Special Focus Four-Year: Faith-Related Institutions,Postbaccalaureate: Single program-Other,Exclusively graduate,Exclusively graduate/professional,165,69,96,0,0,0,165,0,165,0,19,2,17,0,0,0,0,0,0,0,0,0,MN04
175272,Winona State University, ,175 West Mark Street,Winona,MN,55987-5838,-91.643723,44.046159,Public,Graduate degree or certificate offering,No,Town: Distant,Master's Colleges & Universities: Medium Programs,"Postbaccalaureate: Other-dominant, with Arts & Sciences",Very high undergraduate,"Four-year, medium, primarily residential",912,172,740,14,2,12,912,273,508,131,146,26,120,5,0,5,7,1,6,0,0,0,MN01
175281,Mitchell Hamline School of Law, ,875 Summit Ave,Saint Paul,MN,55105-3076,-93.138224,44.94202,Private not-for-profit,Graduate degree or certificate offering,No,City: Large,Special Focus Four-Year: Law Schools,Postbaccalaureate: Single program-Other,Exclusively graduate,Exclusively graduate/professional,1270,573,697,15,7,8,1270,14,767,489,0,0,0,0,0,0,0,0,0,0,0,0,MN04
175342,Alcorn State University, ,1000 ASU Dr Ste 359,Alcorn State,MS,39096-7500,-91.142854,31.877216,Public,Graduate degree or certificate offering,Yes,Rural: Remote,Master's Colleges & Universities: Small Programs,"Postbaccalaureate: Education-dominant, with Arts & Sciences",High undergraduate,"Four-year, small, highly residential",630,156,474,16,10,6,630,388,197,45,102,32,70,7,6,1,0,0,0,0,0,0,MS02
175421,Belhaven University, ,1500 Peachtree St,Jackson,MS,39202,-90.169228,32.318415,Private not-for-profit,Graduate degree or certificate offering,No,City: Midsize,Doctoral/Professional Universities,Research Doctoral: Single program-Education,Majority undergraduate,"Four-year, small, primarily residential",3998,1046,2952,12,7,5,3998,3706,156,136,885,276,609,2,1,1,32,6,26,0,0,0,MS03
175430,Blue Mountain College, ,201 W Main St,Blue Mountain,MS,38610,-89.02924,34.67209,Private not-for-profit,Graduate degree or certificate offering,No,Rural: Distant,Baccalaureate Colleges: Diverse Fields,Postbaccalaureate: Single program-Education,Very high undergraduate,"Four-year, very small, highly residential",44,17,27,0,0,0,44,40,3,1,14,3,11,0,0,0,0,0,0,0,0,0,MS01
175616,Delta State University, ,1003 W Sunflower Road,Cleveland,MS,38733,-90.735365,33.744745,Public,Graduate degree or certificate offering,No,Town: Remote,Master's Colleges & Universities: Larger Programs,Research Doctoral: Single program-Education,High undergraduate,"Four-year, small, highly residential",1331,420,911,31,21,10,1331,1174,149,8,336,107,229,19,13,6,6,2,4,0,0,0,MS02
175856,Jackson State University, ,1400 John R. Lynch Street,Jackson,MS,39217,-90.207405,32.296105,Public,Graduate degree or certificate offering,Yes,City: Midsize,Doctoral Universities: High Research Activity,Research Doctoral: Professional-dominant,High undergraduate,"Four-year, medium, highly residential",2737,648,2089,125,59,66,2737,20,2569,148,394,79,315,14,7,7,97,31,66,17,7,10,MS02
175980,Millsaps College,Millsaps,1701 N State St,Jackson,MS,39210-0001,-90.179957,32.322746,Private not-for-profit,Graduate degree or certificate offering,No,City: Midsize,Baccalaureate Colleges: Arts & Sciences Focus,Postbaccalaureate: Single program-Business,Very high undergraduate,"Four-year, very small, highly residential",70,45,25,2,1,1,70,0,49,21,36,25,11,2,2,0,0,0,0,0,0,0,MS02
176017,University of Mississippi,Ole Miss,"Oxford, Mississippi",University,MS,38677-1848,-89.537434,34.365529,Public,Graduate degree or certificate offering,No,Town: Remote,Doctoral Universities: Very High Research Activity,"Research Doctoral: Comprehensive programs, with medical/veterinary school",High undergraduate,"Four-year, large, primarily residential",5549,2208,3341,492,287,205,5549,870,1108,3571,999,376,623,58,28,30,182,78,104,37,23,14,MS01
176035,Mississippi University for Women,MUW,1100 College Street,Columbus,MS,39701,-88.418601,33.493305,Public,Graduate degree or certificate offering,No,Town: Remote,Master's Colleges & Universities: Small Programs,"Postbaccalaureate: Other-dominant, with Arts & Sciences",Very high undergraduate,"Four-year, small, primarily residential",370,54,316,2,1,1,370,232,107,31,104,13,91,1,0,1,0,0,0,0,0,0,MS01
176044,Mississippi Valley State University, ,14000 Highway 82 West,Itta Bena,MS,38941-1400,-90.341274,33.514142,Public,Graduate degree or certificate offering,Yes,Town: Remote,Master's Colleges & Universities: Small Programs,"Postbaccalaureate: Other-dominant, with Arts & Sciences",High undergraduate,"Four-year, small, highly residential",433,130,303,0,0,0,433,288,58,87,92,23,69,0,0,0,0,0,0,0,0,0,MS02
176053,Mississippi College,MC,200 South Capitol Street,Clinton,MS,39058,-90.329821,32.335515,Private not-for-profit,Graduate degree or certificate offering,No,Suburb: Large,Doctoral/Professional Universities,Research Doctoral: Professional-dominant,Majority undergraduate,"Four-year, medium, highly residential",2507,820,1687,59,23,36,2507,1072,166,1269,581,173,408,23,7,16,46,5,41,2,1,1,MS02
176080,Mississippi State University, ,Lee Boulevard,Mississippi State,MS,39762,-88.790139,33.454852,Public,Graduate degree or certificate offering,No,Town: Remote,Doctoral Universities: Very High Research Activity,"Research Doctoral: Comprehensive programs, with medical/veterinary school",High undergraduate,"Four-year, large, primarily residential",5189,2330,2859,647,395,252,5189,2643,2155,391,841,368,473,89,46,43,145,78,67,60,32,28,MS03
176372,University of Southern Mississippi, ,118 College Drive # 0001,Hattiesburg,MS,39406-0001,-89.331236,31.32661,Public,Graduate degree or certificate offering,No,City: Small,Doctoral Universities: Very High Research Activity,"Research Doctoral: Comprehensive programs, no medical/veterinary school",High undergraduate,"Four-year, large, primarily residential",3828,1310,2518,203,106,97,3828,2183,1535,110,663,190,473,50,28,22,147,56,91,0,0,0,MS04
176406,Tougaloo College, ,500 W County Line Rd,Tougaloo,MS,39174,-90.16076,32.403014,Private not-for-profit,Graduate degree or certificate offering,Yes,City: Midsize,Baccalaureate Colleges: Arts & Sciences Focus,Postbaccalaureate: Single program-Other,Very high undergraduate,"Four-year, very small, highly residential",21,3,18,0,0,0,21,0,0,21,1,0,1,0,0,0,0,0,0,0,0,0,MS02
176451,Wesley Biblical Seminary, ,1880 E County Line Road,Ridgeland,MS,39157-1920,-90.111379,32.400142,Private not-for-profit,Graduate degree or certificate offering,No,Suburb: Large,Special Focus Four-Year: Faith-Related Institutions,"Postbaccalaureate: Other-dominant, with Arts & Sciences",Exclusively graduate,Exclusively graduate/professional,245,133,112,0,0,0,245,238,7,0,20,12,8,0,0,0,0,0,0,0,0,0,MS03
176479,William Carey University, ,710 William Carey Parkway,Hattiesburg,MS,39401,-89.291815,31.305264,Private not-for-profit,Graduate degree or certificate offering,No,City: Small,Doctoral/Professional Universities,Research Doctoral: Professional-dominant,Majority undergraduate,"Four-year, medium, primarily residential",3175,926,2249,65,37,28,3175,1111,857,1207,538,122,416,5,3,2,59,11,48,1,0,1,MS04
176600,Aquinas Institute of Theology,"Aquinas Institute, A.I., A.I.T.",23 South Spring Avenue,Saint Louis,MO,63108-3323,-90.237795,38.634329,Private not-for-profit,Graduate degree or certificate offering,No,City: Large,Special Focus Four-Year: Faith-Related Institutions,Research Doctoral: Single program-Other,Exclusively graduate,Exclusively graduate/professional,136,76,60,9,5,4,136,60,18,58,27,10,17,7,2,5,4,2,2,0,0,0,MO01
176628,Avila University, ,11901 Wornall Rd,Kansas City,MO,64145-1698,-94.591758,38.91339,Private not-for-profit,Graduate degree or certificate offering,No,City: Large,Master's Colleges & Universities: Medium Programs,"Postbaccalaureate: Business-dominant, with Arts & Sciences",High undergraduate,"Four-year, small, primarily residential",457,110,347,23,11,12,457,457,0,0,125,39,86,17,9,8,0,0,0,0,0,0,MO05
176664,Baptist Bible College, ,628 E Kearney,Springfield,MO,65803-3498,-93.284286,37.239696,Private not-for-profit,Graduate degree or certificate offering,No,City: Midsize,Special Focus Four-Year: Faith-Related Institutions,Postbaccalaureate: Single program-Other,Very high undergraduate,"Four-year, very small, highly residential",36,29,7,0,0,0,36,36,0,0,12,11,1,0,0,0,0,0,0,0,0,0,MO07
176770,Cox College,Lester L Cox College of Nursing and Health Sciences,1423 N Jefferson,Springfield,MO,65802-1917,-93.290233,37.225116,Private not-for-profit,Graduate degree or certificate offering,No,City: Midsize,Special Focus Four-Year: Other Health Professions Schools,Postbaccalaureate: Single program-Other,High undergraduate,"Four-year, very small, primarily nonresidential",244,39,205,0,0,0,244,134,110,0,82,14,68,0,0,0,0,0,0,0,0,0,MO07
176789,Calvary University, ,15800 Calvary Road,Kansas City,MO,64147-1341,-94.547927,38.839578,Private not-for-profit,Graduate degree or certificate offering,No,City: Large,Baccalaureate Colleges: Diverse Fields,"Postbaccalaureate: Other-dominant, with other professional programs",High undergraduate,"Four-year, very small, primarily residential",120,91,29,1,0,1,120,82,28,10,15,12,3,0,0,0,0,0,0,0,0,0,MO04
176910,Central Christian College of the Bible, ,911 E Urbandale Dr,Moberly,MO,65270-1997,-92.427259,39.395963,Private not-for-profit,Graduate degree or certificate offering,No,Town: Distant,Special Focus Four-Year: Faith-Related Institutions,Not classified (Exclusively Undergraduate),Very high undergraduate,"Four-year, very small, highly residential",22,19,3,0,0,0,22,1,0,21,1,1,0,0,0,0,0,0,0,0,0,0,MO06
176965,University of Central Missouri,Central,108 W South Street,Warrensburg,MO,64093,-93.737428,38.759111,Public,Graduate degree or certificate offering,No,Town: Distant,Master's Colleges & Universities: Larger Programs,Postbaccalaureate: Comprehensive programs,High undergraduate,"Four-year, medium, highly residential",3713,1218,2495,842,433,409,3713,960,785,1968,1027,410,617,463,244,219,0,0,0,0,0,0,MO04
177038,Cleveland University-Kansas City, ,10850 Lowell Avenue,Overland Park,KS,66210,-94.679076,38.932019,Private not-for-profit,Graduate degree or certificate offering,No,City: Midsize,Special Focus Four-Year: Other Health Professions Schools,Postbaccalaureate: Single program-Other,Majority graduate,"Four-year, very small, primarily nonresidential",642,344,298,2,2,0,642,0,181,461,0,0,0,0,0,0,0,0,0,0,0,0,KS03
177065,Columbia College, ,1001 Rogers Street,Columbia,MO,65216,-92.326354,38.957388,Private not-for-profit,Graduate degree or certificate offering,No,City: Midsize,Master's Colleges & Universities: Larger Programs,"Postbaccalaureate: Business-dominant, with other professional programs",Very high undergraduate,"Four-year, medium, primarily nonresidential",599,213,386,43,19,24,599,464,40,95,211,71,140,18,8,10,0,0,0,0,0,0,MO04
177092,Concordia Seminary, ,801 Seminary Place,Saint Louis,MO,63105-3196,-90.311324,38.637181,Private not-for-profit,Graduate degree or certificate offering,No,Suburb: Large,Special Focus Four-Year: Faith-Related Institutions,Research Doctoral: Single program-Other,Exclusively graduate,Exclusively graduate/professional,611,573,38,34,31,3,611,169,0,442,73,69,4,6,6,0,8,8,0,1,1,0,MO01
177126,Covenant Theological Seminary,Covenant|Covenant Seminary|CTS|Francis Schaeffer Institute|FSI|Center for Ministry Leadership|CML,12330 Conway Road,Saint Louis,MO,63141-8609,-90.451323,38.643066,Private not-for-profit,Graduate degree or certificate offering,No,Suburb: Large,Special Focus Four-Year: Faith-Related Institutions,Research Doctoral: Single program-Other,Exclusively graduate,Exclusively graduate/professional,718,453,265,17,11,6,718,201,225,292,106,67,39,6,4,2,0,0,0,0,0,0,MO02
177144,Culver-Stockton College,CULVER|C-SC|,One College Hill,Canton,MO,63435-1299,-91.529374,40.128993,Private not-for-profit,Graduate degree or certificate offering,No,Rural: Remote,Baccalaureate Colleges: Diverse Fields,"Postbaccalaureate: Business-dominant, with Arts & Sciences",Very high undergraduate,"Four-year, very small, highly residential",74,26,48,3,2,1,74,59,15,0,23,9,14,1,0,1,0,0,0,0,0,0,MO06
177214,Drury University, ,900 N. Benton Ave,Springfield,MO,65802-3791,-93.286192,37.219681,Private not-for-profit,Graduate degree or certificate offering,No,City: Midsize,Master's Colleges & Universities: Small Programs,"Postbaccalaureate: Education-dominant, with Arts & Sciences",Very high undergraduate,"Four-year, small, highly residential",365,111,254,17,8,9,365,198,101,66,87,27,60,7,4,3,0,0,0,0,0,0,MO07
177278,Eden Theological Seminary, ,475 E Lockwood Ave,Webster Groves,MO,63119-3192,-90.345605,38.592307,Private not-for-profit,Graduate degree or certificate offering,No,Suburb: Large,Special Focus Four-Year: Faith-Related Institutions,Research Doctoral: Single program-Other,Exclusively graduate,Exclusively graduate/professional,140,65,75,2,1,1,140,140,0,0,30,12,18,2,1,1,3,3,0,0,0,0,MO01
177339,Evangel University, ,1111 N Glenstone,Springfield,MO,65802-2125,-93.262614,37.220956,Private not-for-profit,Graduate degree or certificate offering,No,City: Midsize,Master's Colleges & Universities: Medium Programs,Research Doctoral: Professional-dominant,High undergraduate,"Four-year, small, highly residential",687,335,352,16,10,6,687,95,24,568,133,59,74,0,0,0,15,4,11,0,0,0,MO07
177418,Fontbonne University, ,6800 Wydown Blvd,Saint Louis,MO,63105-3098,-90.315712,38.642697,Private not-for-profit,Graduate degree or certificate offering,No,Suburb: Large,Master's Colleges & Universities: Medium Programs,"Postbaccalaureate: Education-dominant, with Arts & Sciences",High undergraduate,"Four-year, very small, primarily residential",363,86,277,36,15,21,363,170,161,32,140,34,106,17,8,9,1,0,1,0,0,0,MO01
177542,Hannibal-LaGrange University, ,2800 Palmyra Rd,Hannibal,MO,63401,-91.39094,39.729015,Private not-for-profit,Graduate degree or certificate offering,No,Town: Remote,Baccalaureate Colleges: Diverse Fields,"Postbaccalaureate: Education-dominant, with other professional programs",Very high undergraduate,"Four-year, very small, highly residential",104,35,69,0,0,0,104,104,0,0,31,8,23,0,0,0,0,0,0,0,0,0,MO06
177719,Barnes-Jewish College Goldfarb School of Nursing,Barnes-Jewish College of Nursing  Barnes-Jewish College of Nursing and Allied Health   Jewish Hospital College of Nursing,"4483 Duncan Avenue, Mailstop 90-36-697",Saint Louis,MO,63110,-90.258772,38.637165,Private not-for-profit,Graduate degree or certificate offering,No,City: Large,Special Focus Four-Year: Other Health Professions Schools,Postbaccalaureate: Single program-Other,High undergraduate,"Four-year, very small, primarily nonresidential",155,37,118,0,0,0,155,44,98,13,33,8,25,0,0,0,5,1,4,0,0,0,MO01
177816,Kenrick Glennon Seminary, ,5200 Glennon Dr,Saint Louis,MO,63119-4399,-90.324024,38.584608,Private not-for-profit,Graduate degree or certificate offering,No,Suburb: Large,Special Focus Four-Year: Faith-Related Institutions,Postbaccalaureate: Single program-Other,Exclusively graduate,Exclusively graduate/professional,87,87,0,6,6,0,87,0,0,87,18,18,0,0,0,0,0,0,0,0,0,0,MO02
177834,A T Still University of Health Sciences, ,800 W Jefferson,Kirksville,MO,63501,-92.589183,40.193648,Private not-for-profit,Graduate degree or certificate offering,No,Town: Remote,Special Focus Four-Year: Medical Schools & Centers,Research Doctoral: Professional-dominant,Exclusively graduate,Exclusively graduate/professional,4346,1675,2671,170,57,113,4346,2002,2344,0,355,113,242,8,2,6,176,56,120,5,4,1,MO06
177940,Lincoln University,Lincoln University of Missouri,820 Chestnut Street,Jefferson City,MO,65101,-92.166724,38.564431,Public,Graduate degree or certificate offering,Yes,City: Small,Baccalaureate Colleges: Diverse Fields,"Postbaccalaureate: Education-dominant, with Arts & Sciences",Very high undergraduate,"Four-year, small, highly residential",168,79,89,20,9,11,168,51,90,27,47,20,27,2,1,1,0,0,0,0,0,0,MO03
177968,Lindenwood University, ,209 S Kingshighway,Saint Charles,MO,63301-1695,-90.501286,38.785425,Private not-for-profit,Graduate degree or certificate offering,No,City: Small,Master's Colleges & Universities: Larger Programs,Research Doctoral: Single program-Education,High undergraduate,"Four-year, medium, highly residential",4976,1141,3835,96,44,52,4976,2106,323,2547,816,234,582,35,12,23,53,15,38,0,0,0,MO03
177986,Logan University,Logan University,1851 Schoettler Rd,Chesterfield,MO,63017,-90.542333,38.63133,Private not-for-profit,Graduate degree or certificate offering,No,Suburb: Large,Special Focus Four-Year: Other Health Professions Schools,Research Doctoral: Single program-Other,Majority graduate,"Four-year, small, primarily nonresidential",1937,859,1078,22,11,11,1937,860,804,273,231,75,156,0,0,0,13,4,9,0,0,0,MO02
178059,Maryville University of Saint Louis, ,650 Maryville University Drive,Saint Louis,MO,63141-7299,-90.505998,38.644774,Private not-for-profit,Graduate degree or certificate offering,No,Suburb: Large,Doctoral/Professional Universities,Research Doctoral: Professional-dominant,Majority undergraduate,"Four-year, medium, primarily nonresidential",7277,1610,5667,71,33,38,7277,6479,372,426,1553,409,1144,44,24,20,201,42,159,0,0,0,MO02
178208,Midwestern Baptist Theological Seminary,"MBTS|MBC|MBC,SBC|Midwestern Baptist Seminary|Midwestern|Midwestern Baptist College, SBC|Midwestern Baptist College|MBCSBC, Spurgeon College",5001 N. Oak Trafficway,Kansas City,MO,64118-4697,-94.573185,39.185691,Private not-for-profit,Graduate degree or certificate offering,No,City: Large,Special Focus Four-Year: Faith-Related Institutions,Research Doctoral: Single program-Other,Majority graduate,"Four-year, small, primarily nonresidential",3263,2789,474,291,249,42,3263,1254,936,1073,324,265,59,9,9,0,87,84,3,3,3,0,MO05
178244,Missouri Baptist University,MBU,One College Park Dr,Saint Louis,MO,63141-8698,-90.462586,38.641526,Private not-for-profit,Graduate degree or certificate offering,No,Suburb: Large,Master's Colleges & Universities: Larger Programs,Research Doctoral: Single program-Education,High undergraduate,"Four-year, small, primarily residential",986,247,739,21,14,7,986,466,296,224,243,73,170,12,8,4,19,8,11,0,0,0,MO02
178341,Missouri Southern State University,Missouri Southern,3950 E. Newman Road,Joplin,MO,64801-1595,-94.461689,37.095155,Public,Graduate degree or certificate offering,No,City: Small,Master's Colleges & Universities: Small Programs,"Postbaccalaureate: Business-dominant, with other professional programs",Very high undergraduate,"Four-year, medium, primarily nonresidential",142,43,99,1,0,1,142,119,20,3,41,11,30,1,0,1,0,0,0,0,0,0,MO07
178369,Missouri Valley College, ,500 E College St,Marshall,MO,65340,-93.190654,39.108522,Private not-for-profit,Graduate degree or certificate offering,No,Town: Remote,Baccalaureate Colleges: Diverse Fields,Postbaccalaureate: Single program-Other,Very high undergraduate,"Four-year, small, highly residential",48,20,28,2,2,0,48,4,1,43,16,7,9,1,1,0,0,0,0,0,0,0,MO04
178387,Missouri Western State University,Western|MWSU|MWSC|Missouri Western State College,4525 Downs Dr,Saint Joseph,MO,64507,-94.785643,39.7575,Public,Graduate degree or certificate offering,No,City: Small,Master's Colleges & Universities: Small Programs,"Postbaccalaureate: Business-dominant, with Arts & Sciences",Very high undergraduate,"Four-year, medium, primarily residential",232,80,152,15,5,10,232,105,89,38,91,38,53,12,4,8,0,0,0,0,0,0,MO06
178396,University of Missouri-Columbia, ,105 Jesse Hall,Columbia,MO,65211,-92.328843,38.94531,Public,Graduate degree or certificate offering,No,City: Midsize,Doctoral Universities: Very High Research Activity,"Research Doctoral: Comprehensive programs, with medical/veterinary school",High undergraduate,"Four-year, large, primarily residential",9095,3530,5565,1103,606,497,9095,3938,3831,1326,1423,573,850,156,73,83,366,173,193,126,87,39,MO03
178402,University of Missouri-Kansas City, ,5000 Holmes St.,Kansas City,MO,64110,-94.582141,39.034179,Public,Graduate degree or certificate offering,No,City: Large,Doctoral Universities: High Research Activity,Research Doctoral: Professional-dominant,Majority undergraduate,"Four-year, medium, primarily nonresidential",6032,2524,3508,771,459,312,6032,1998,2950,1084,1102,450,652,224,127,97,135,63,72,28,20,8,MO05
178411,Missouri University of Science and Technology, ,300 W.13th Street,Rolla,MO,65409,-91.775583,37.953426,Public,Graduate degree or certificate offering,No,Town: Remote,Doctoral Universities: High Research Activity,Research Doctoral: STEM-dominant,High undergraduate,"Four-year, medium, primarily residential",1862,1416,446,588,458,130,1862,832,786,244,413,323,90,75,49,26,118,94,24,81,65,16,MO08
178420,University of Missouri-St Louis, ,One University Boulevard,Saint Louis,MO,63121-4400,-90.311091,38.710312,Public,Graduate degree or certificate offering,No,Suburb: Large,Doctoral Universities: High Research Activity,Research Doctoral: Professional-dominant,High undergraduate,"Four-year, medium, primarily nonresidential",3442,1117,2325,206,100,106,3442,1211,1736,495,719,242,477,74,41,33,125,42,83,13,8,5,MO01
178518,Nazarene Theological Seminary, ,1700 E Meyer Blvd,Kansas City,MO,64131-1246,-94.565781,39.009265,Private not-for-profit,Graduate degree or certificate offering,No,City: Large,Special Focus Four-Year: Faith-Related Institutions,Postbaccalaureate: Single program-Other,Exclusively graduate,Exclusively graduate/professional,253,157,96,0,0,0,253,46,207,0,52,33,19,0,0,0,0,0,0,0,0,0,MO05
178615,Truman State University,Truman,100 E Normal Avenue,Kirksville,MO,63501-4221,-92.581658,40.188267,Public,Graduate degree or certificate offering,No,Town: Remote,Master's Colleges & Universities: Medium Programs,"Postbaccalaureate: Education-dominant, with Arts & Sciences",Very high undergraduate,"Four-year, medium, highly residential",389,116,273,14,8,6,389,99,202,88,170,56,114,7,4,3,0,0,0,0,0,0,MO06
178624,Northwest Missouri State University,Northwest,800 University Drive,Maryville,MO,64468-6001,-94.883339,40.351692,Public,Graduate degree or certificate offering,No,Town: Remote,Master's Colleges & Universities: Larger Programs,Postbaccalaureate: Comprehensive programs,High undergraduate,"Four-year, medium, highly residential",2849,973,1876,310,191,119,2849,2282,33,534,845,267,578,139,86,53,0,0,0,0,0,0,MO06
178721,Park University, ,8700 NW River Park Dr,Parkville,MO,64152-3795,-94.679041,39.189256,Private not-for-profit,Graduate degree or certificate offering,No,Suburb: Large,Master's Colleges & Universities: Larger Programs,"Postbaccalaureate: Business-dominant, with Arts & Sciences",High undergraduate,"Four-year, medium, primarily nonresidential",2046,909,1137,123,75,48,2046,1564,288,194,595,239,356,23,14,9,0,0,0,0,0,0,MO06
178989,Research College of Nursing, ,2525 E. Meyer Boulevard,Kansas City,MO,64132,-94.556762,39.006611,Private for-profit,Graduate degree or certificate offering,No,City: Large,Special Focus Four-Year: Other Health Professions Schools,Postbaccalaureate: Single program-Other,High undergraduate,"Four-year, very small, primarily nonresidential",176,19,157,0,0,0,176,118,58,0,34,2,32,0,0,0,0,0,0,0,0,0,MO05
179043,Rockhurst University,Rockhurst,1100 Rockhurst Rd,Kansas City,MO,64110-2561,-94.573003,39.032318,Private not-for-profit,Graduate degree or certificate offering,No,City: Large,Master's Colleges & Universities: Larger Programs,"Postbaccalaureate: Business-dominant, with Arts & Sciences",High undergraduate,"Four-year, small, primarily residential",1217,447,770,7,6,1,1217,337,730,150,370,132,238,2,2,0,0,0,0,0,0,0,MO05
179159,Saint Louis University, ,One North Grand Blvd,Saint Louis,MO,63103-2097,-90.2351,38.636801,Private not-for-profit,Graduate degree or certificate offering,No,City: Large,Doctoral Universities: High Research Activity,"Research Doctoral: Comprehensive programs, with medical/veterinary school",Majority undergraduate,"Four-year, large, highly residential",4994,1976,3018,446,214,232,4994,1034,2272,1688,868,303,565,86,43,43,226,75,151,35,16,19,MO01
179265,University of Health Sciences and Pharmacy in St. Louis,St. Louis College of Pharmacy,1 Pharmacy Place,Saint Louis,MO,63110-1088,-90.260617,38.636904,Private not-for-profit,Graduate degree or certificate offering,No,City: Large,Special Focus Four-Year: Other Health Professions Schools,Postbaccalaureate: Single program-Other,Majority graduate,"Four-year, very small, highly residential",717,263,454,23,6,17,717,8,197,512,0,0,0,0,0,0,0,0,0,0,0,0,MO01
179317,Saint Paul School of Theology, ,13720 Roe Avenue,Leawood,KS,66224,-94.641277,38.880458,Private not-for-profit,Graduate degree or certificate offering,No,Suburb: Large,Special Focus Four-Year: Faith-Related Institutions,Postbaccalaureate: Single program-Other,Exclusively graduate,Exclusively graduate/professional,107,46,61,1,0,1,107,1,106,0,17,5,12,0,0,0,0,0,0,0,0,0,KS03
179326,Southwest Baptist University, ,1600 University Ave,Bolivar,MO,65613-2596,-93.407056,37.602425,Private not-for-profit,Graduate degree or certificate offering,No,Town: Distant,Master's Colleges & Universities: Larger Programs,Research Doctoral: Single program-Education,High undergraduate,"Four-year, small, highly residential",815,298,517,11,6,5,815,156,247,412,137,43,94,7,4,3,9,2,7,0,0,0,MO04
179548,Stephens College,Stephens,1200 E Broadway,Columbia,MO,65215,-92.319204,38.95204,Private not-for-profit,Graduate degree or certificate offering,No,City: Midsize,Master's Colleges & Universities: Small Programs,"Postbaccalaureate: Other-dominant, with Arts & Sciences",Majority undergraduate,"Four-year, very small, highly residential",188,33,155,0,0,0,188,57,5,126,66,14,52,0,0,0,0,0,0,0,0,0,MO04
179557,Southeast Missouri State University, ,"One University Plaza, MS2025",Cape Girardeau,MO,63701,-89.531187,37.311107,Public,Graduate degree or certificate offering,No,City: Small,Master's Colleges & Universities: Larger Programs,Postbaccalaureate: Comprehensive programs,Very high undergraduate,"Four-year, medium, primarily residential",1402,489,913,299,158,141,1402,417,395,590,444,156,288,128,63,65,0,0,0,0,0,0,MO08
179566,Missouri State University-Springfield, ,901 S National Avenue,Springfield,MO,65897,-93.281281,37.199258,Public,Graduate degree or certificate offering,No,City: Midsize,Doctoral/Professional Universities,Postbaccalaureate: Comprehensive programs,High undergraduate,"Four-year, large, primarily nonresidential",5109,1907,3202,494,240,254,5109,2484,1836,789,1279,489,790,238,121,117,0,0,0,0,0,0,MO07
179812,Kansas City University,KCU - Kansas City,1750 Independence Ave,Kansas City,MO,64106-1453,-94.561374,39.107553,Private not-for-profit,Graduate degree or certificate offering,No,City: Large,Special Focus Four-Year: Medical Schools & Centers,"Postbaccalaureate: Other-dominant, with Arts & Sciences",Exclusively graduate,Exclusively graduate/professional,1292,695,597,64,36,28,1292,0,0,1292,113,55,58,3,2,1,0,0,0,0,0,0,MO05
179867,Washington University in St Louis,WashU,One Brookings Drive,Saint Louis,MO,63130-4899,-90.310604,38.647929,Private not-for-profit,Graduate degree or certificate offering,No,Suburb: Large,Doctoral Universities: Very High Research Activity,"Research Doctoral: Comprehensive programs, with medical/veterinary school",Majority undergraduate,"Four-year, large, highly residential",9235,4427,4808,3726,1942,1784,9235,1373,6276,1586,2220,990,1230,1116,533,583,263,146,117,115,71,44,MO01
179894,Webster University, ,470 E Lockwood Ave.,Saint Louis,MO,63119-3194,-90.345151,38.588875,Private not-for-profit,Graduate degree or certificate offering,No,Suburb: Large,Master's Colleges & Universities: Larger Programs,Research Doctoral: Single program-Education,Majority graduate,"Four-year, medium, primarily residential",7382,3110,4272,171,97,74,7382,3033,1996,2353,2518,1095,1423,97,41,56,2,0,2,0,0,0,MO01
179955,William Jewell College, ,500 College Hill,Liberty,MO,64068-1896,-94.413126,39.247844,Private not-for-profit,Graduate degree or certificate offering,No,Suburb: Large,Baccalaureate Colleges: Diverse Fields,Postbaccalaureate: Single program-Education,Very high undergraduate,"Four-year, very small, highly residential",21,10,11,1,1,0,21,0,0,21,4,4,0,1,1,0,0,0,0,0,0,0,MO06
179964,William Woods University,WWU/William Woods/The Woods,One University Avenue,Fulton,MO,65251-2388,-91.950416,38.860287,Private not-for-profit,Graduate degree or certificate offering,No,Town: Distant,Doctoral/Professional Universities,Research Doctoral: Single program-Education,Majority undergraduate,"Four-year, small, highly residential",1509,562,947,18,13,5,1509,676,155,678,390,133,257,3,2,1,68,20,48,0,0,0,MO03
180106,Carroll College,Carroll Montana  CC,1601 N Benton Ave,Helena,MT,59625-0002,-112.040285,46.600771,Private not-for-profit,Graduate degree or certificate offering,No,Town: Remote,Baccalaureate Colleges: Diverse Fields,Postbaccalaureate: Single program-Business,Very high undergraduate,"Four-year, small, highly residential",10,5,5,0,0,0,10,10,0,0,9,5,4,0,0,0,0,0,0,0,0,0,MT02
180179,Montana State University Billings,MSU Billings,1500 University Drive,Billings,MT,59101-0298,-108.523009,45.796896,Public,Graduate degree or certificate offering,No,City: Midsize,Master's Colleges & Universities: Medium Programs,"Postbaccalaureate: Education-dominant, with Arts & Sciences",Very high undergraduate,"Four-year, small, primarily nonresidential",474,118,356,6,2,4,474,251,195,28,104,22,82,1,0,1,0,0,0,0,0,0,MT02
180258,University of Providence,Previously known as the University of Great Falls (prior to July 2018),1301 20th St S,Great Falls,MT,59405-4996,-111.270604,47.490713,Private not-for-profit,Graduate degree or certificate offering,No,City: Small,Master's Colleges & Universities: Small Programs,"Postbaccalaureate: Other-dominant, with Arts & Sciences",High undergraduate,"Four-year, very small, primarily residential",260,65,195,0,0,0,260,260,0,0,51,8,43,0,0,0,0,0,0,0,0,0,MT02
180416,Montana Technological University, ,1300 W Park St,Butte,MT,59701-8997,-112.559511,46.012868,Public,Graduate degree or certificate offering,No,Town: Remote,Master's Colleges & Universities: Small Programs,Research Doctoral: Single program-Other,Very high undergraduate,"Four-year, small, primarily residential",286,181,105,14,11,3,286,164,26,96,80,45,35,4,4,0,2,2,0,1,1,0,MT01
180461,Montana State University,MSU,Montana State University,Bozeman,MT,59717,-111.048812,45.666726,Public,Graduate degree or certificate offering,No,Town: Remote,Doctoral Universities: Very High Research Activity,Research Doctoral: STEM-dominant,Very high undergraduate,"Four-year, large, primarily residential",2522,1034,1488,188,108,80,2522,700,1036,786,408,188,220,22,14,8,64,33,31,11,8,3,MT01
180489,The University of Montana,University of Montana,"Missoula, Montana",Missoula,MT,59812,-113.982912,46.859312,Public,Graduate degree or certificate offering,No,City: Small,Doctoral Universities: Very High Research Activity,"Research Doctoral: Comprehensive programs, no medical/veterinary school",High undergraduate,"Four-year, medium, primarily residential",3482,1270,2212,210,83,127,3482,464,700,2318,465,166,299,7,4,3,49,25,24,4,2,2,MT01
180522,Montana State University-Northern, ,300 W 11th St,Havre,MT,59501,-109.687806,48.54149,Public,Graduate degree or certificate offering,No,Town: Remote,Baccalaureate Colleges: Diverse Fields,Postbaccalaureate: Single program-Education,Very high undergraduate,"Four-year, very small, primarily residential",54,11,43,0,0,0,54,32,15,7,15,3,12,0,0,0,0,0,0,0,0,0,MT02
180595,Rocky Mountain College,RMC,1511 Poly Drive,Billings,MT,59102-1796,-108.554075,45.796522,Private not-for-profit,Graduate degree or certificate offering,No,City: Midsize,Master's Colleges & Universities: Small Programs,"Postbaccalaureate: Other-dominant, with other professional programs",High undergraduate,"Four-year, very small, highly residential",220,60,160,0,0,0,220,27,15,178,55,22,33,0,0,0,0,0,0,0,0,0,MT02
180814,Bellevue University, ,1000 Galvin Rd S,Bellevue,NE,68005-3098,-95.91764,41.150225,Private not-for-profit,Graduate degree or certificate offering,No,Suburb: Large,Master's Colleges & Universities: Larger Programs,Research Doctoral: Single program-Other,Majority undergraduate,"Four-year, large, primarily nonresidential",4495,1991,2504,16,12,4,4495,4011,457,27,1164,480,684,6,2,4,10,6,4,0,0,0,NE01
180832,Clarkson College, ,101 S 42nd St,Omaha,NE,68131-2739,-95.974847,41.259165,Private not-for-profit,Graduate degree or certificate offering,No,City: Large,Special Focus Four-Year: Other Health Professions Schools,"Postbaccalaureate: Other-dominant, with other professional programs",Majority undergraduate,"Four-year, very small, primarily nonresidential",708,98,610,0,0,0,708,643,44,21,111,19,92,0,0,0,0,0,0,0,0,0,NE02
180878,Bryan College of Health Sciences, ,1535 S 52nd St,Lincoln,NE,68506,-96.651532,40.796768,Private not-for-profit,Graduate degree or certificate offering,No,City: Large,Special Focus Four-Year: Other Health Professions Schools,Research Doctoral: Professional-dominant,High undergraduate,"Four-year, very small, primarily nonresidential",149,29,120,0,0,0,149,12,24,113,13,0,13,0,0,0,23,8,15,0,0,0,NE01
180948,Chadron State College, ,1000 Main St,Chadron,NE,69337-2690,-103.001615,42.8199,Public,Graduate degree or certificate offering,No,Town: Remote,Master's Colleges & Universities: Medium Programs,"Postbaccalaureate: Education-dominant, with Arts & Sciences",High undergraduate,"Four-year, small, highly residential",684,242,442,11,4,7,684,672,12,0,151,68,83,6,1,5,0,0,0,0,0,0,NE03
180984,Concordia University-Nebraska,"Concordia Teachers College  Concordia College  Concordia University, Seward",800 N Columbia Ave,Seward,NE,68434-1556,-97.089054,40.914853,Private not-for-profit,Graduate degree or certificate offering,No,Town: Distant,Master's Colleges & Universities: Larger Programs,"Postbaccalaureate: Education-dominant, with other professional programs",Majority undergraduate,"Four-year, small, highly residential",1539,295,1244,26,11,15,1539,1513,25,1,964,184,780,7,2,5,0,0,0,0,0,0,NE01
181002,Creighton University, ,2500 California Plaza,Omaha,NE,68178,-95.947811,41.265361,Private not-for-profit,Graduate degree or certificate offering,No,City: Large,Doctoral Universities: High Research Activity,Research Doctoral: Professional-dominant,Majority undergraduate,"Four-year, medium, highly residential",5275,2196,3079,144,76,68,5275,2371,674,2230,404,180,224,41,22,19,87,39,48,0,0,0,NE02
181020,Doane University, ,1014 Boswell Avenue,Crete,NE,68333,-96.950932,40.622952,Private not-for-profit,Graduate degree or certificate offering,No,Town: Distant,Master's Colleges & Universities: Larger Programs,Research Doctoral: Single program-Education,Majority undergraduate,"Four-year, small, highly residential",1571,416,1155,9,6,3,1571,58,0,1513,325,88,237,0,0,0,17,7,10,0,0,0,NE03
181127,Hastings College,Hastings College,710 N Turner Ave,Hastings,NE,68901,-98.374403,40.59025,Private not-for-profit,Graduate degree or certificate offering,No,Town: Distant,Baccalaureate Colleges: Diverse Fields,Postbaccalaureate: Single program-Education,Very high undergraduate,"Four-year, very small, highly residential",40,20,20,4,3,1,40,0,7,33,14,12,2,3,2,1,0,0,0,0,0,0,NE03
181215,University of Nebraska at Kearney,UNK|University of Nebraska - Kearney|Nebraska - Kearney|Nebraska Kearney|,2504 9th Avenue,Kearney,NE,68849-1212,-99.098699,40.701452,Public,Graduate degree or certificate offering,No,Town: Distant,Master's Colleges & Universities: Larger Programs,"Postbaccalaureate: Education-dominant, with Arts & Sciences",High undergraduate,"Four-year, medium, highly residential",2739,803,1936,40,15,25,2739,2455,261,23,511,141,370,11,5,6,0,0,0,0,0,0,NE03
181297,Nebraska Methodist College of Nursing & Allied Health,Nebraska Methodist College,720 North 87th Street,Omaha,NE,68114-2852,-96.048511,41.265973,Private not-for-profit,Graduate degree or certificate offering,No,City: Large,Special Focus Four-Year: Other Health Professions Schools,"Postbaccalaureate: Other-dominant, with other professional programs",Majority undergraduate,"Four-year, very small, primarily nonresidential",455,58,397,0,0,0,455,401,54,0,92,10,82,0,0,0,0,0,0,0,0,0,NE02
181330,Midland University,MidlandU,900 N. Clarkson St.,Fremont,NE,68025,-96.488008,41.43674,Private not-for-profit,Graduate degree or certificate offering,No,Town: Distant,Master's Colleges & Universities: Small Programs,"Postbaccalaureate: Education-dominant, with Arts & Sciences",Very high undergraduate,"Four-year, small, highly residential",311,85,226,0,0,0,311,29,124,158,70,27,43,0,0,0,0,0,0,0,0,0,NE01
181394,University of Nebraska at Omaha,UNOMAHA,6001 Dodge St,Omaha,NE,68182-0225,-96.008516,41.258769,Public,Graduate degree or certificate offering,No,City: Large,Doctoral Universities: High Research Activity,Research Doctoral: Professional-dominant,High undergraduate,"Four-year, large, primarily nonresidential",4049,1570,2479,338,206,132,4049,1040,2915,94,833,280,553,59,37,22,41,15,26,5,3,2,NE02
181428,University of Nebraska Medical Center,UNMC,42nd & Dewey Ave,Omaha,NE,68198-7815,-95.973966,41.256312,Public,Graduate degree or certificate offering,No,City: Large,Special Focus Four-Year: Research Institutions,Research Doctoral: STEM-dominant,Majority graduate,"Four-year, medium, primarily nonresidential",2932,1015,1917,248,88,160,2932,398,229,2305,251,63,188,11,3,8,66,30,36,24,10,14,NE02
181446,Nebraska Wesleyan University, ,5000 St Paul Ave,Lincoln,NE,68504-2794,-96.64831,40.839098,Private not-for-profit,Graduate degree or certificate offering,No,City: Large,Master's Colleges & Universities: Small Programs,"Postbaccalaureate: Business-dominant, with other professional programs",Very high undergraduate,"Four-year, small, highly residential",186,39,147,1,1,0,186,0,162,24,76,18,58,0,0,0,0,0,0,0,0,0,NE01
181464,University of Nebraska-Lincoln, ,1400 R Street,Lincoln,NE,68588-0419,-96.700508,40.817598,Public,Graduate degree or certificate offering,No,City: Large,Doctoral Universities: Very High Research Activity,"Research Doctoral: Comprehensive programs, no medical/veterinary school",High undergraduate,"Four-year, large, primarily residential",5950,2813,3137,1049,628,421,5950,2277,2418,1255,918,451,467,134,80,54,282,141,141,108,66,42,NE01
181534,Peru State College,Peru State,600 Hoyt Street,Peru,NE,68421-0010,-95.732731,40.474689,Public,Graduate degree or certificate offering,No,Rural: Distant,Master's Colleges & Universities: Medium Programs,"Postbaccalaureate: Education-dominant, with other professional programs",Very high undergraduate,"Four-year, small, primarily residential",542,149,393,1,0,1,542,540,2,0,110,35,75,0,0,0,0,0,0,0,0,0,NE03
181604,College of Saint Mary, ,7000 Mercy Rd.,Omaha,NE,68106,-96.021425,41.240028,Private not-for-profit,Graduate degree or certificate offering,No,City: Large,Master's Colleges & Universities: Medium Programs,Research Doctoral: Single program-Other,Majority undergraduate,"Four-year, very small, primarily residential",398,41,357,2,0,2,398,116,71,211,101,8,93,1,0,1,9,1,8,0,0,0,NE02
181738,Union College, ,3800 S 48th Street,Lincoln,NE,68506,-96.651095,40.774778,Private not-for-profit,Graduate degree or certificate offering,No,City: Large,Baccalaureate Colleges: Diverse Fields,Postbaccalaureate: Single program-Other,High undergraduate,"Four-year, very small, highly residential",89,21,68,0,0,0,89,0,0,89,29,7,22,0,0,0,0,0,0,0,0,0,NE01
181783,Wayne State College,WSC,1111 Main St,Wayne,NE,68787,-97.015122,42.241556,Public,Graduate degree or certificate offering,No,Town: Distant,Master's Colleges & Universities: Larger Programs,"Postbaccalaureate: Education-dominant, with other professional programs",High undergraduate,"Four-year, medium, highly residential",1186,436,750,3,2,1,1186,832,220,134,237,80,157,1,0,1,0,0,0,0,0,0,NE03
181853,York College, ,1125 E 8th St,York,NE,68467-2699,-97.579352,40.869526,Private not-for-profit,Graduate degree or certificate offering,No,Town: Remote,Baccalaureate Colleges: Diverse Fields,"Postbaccalaureate: Business-dominant, with other professional programs",High undergraduate,"Four-year, very small, highly residential",247,76,171,4,2,2,247,237,0,10,7,4,3,0,0,0,0,0,0,0,0,0,NE03
182281,University of Nevada-Las Vegas,UNLV,4505 S Maryland Pky,Las Vegas,NV,89154,-115.138462,36.106047,Public,Graduate degree or certificate offering,No,City: Midsize,Doctoral Universities: Very High Research Activity,"Research Doctoral: Comprehensive programs, with medical/veterinary school",High undergraduate,"Four-year, large, primarily nonresidential",6071,2432,3639,362,169,193,6071,760,1658,3653,1130,408,722,80,35,45,180,77,103,30,13,17,NV01
182290,University of Nevada-Reno, ,North Virginia Street,Reno,NV,89557,-119.815377,39.543642,Public,Graduate degree or certificate offering,No,City: Large,Doctoral Universities: Very High Research Activity,"Research Doctoral: Comprehensive programs, with medical/veterinary school",High undergraduate,"Four-year, large, primarily nonresidential",4690,1794,2896,400,254,146,4690,1366,495,2829,869,311,558,74,41,33,161,74,87,43,30,13,NV02
182458,Sierra Nevada University,SNU,999 Tahoe Blvd.,Incline Village,NV,89451,-119.939125,39.244278,Private not-for-profit,Graduate degree or certificate offering,No,Town: Distant,Master's Colleges & Universities: Medium Programs,"Postbaccalaureate: Education-dominant, with Arts & Sciences",Majority undergraduate,"Four-year, very small, highly residential",551,126,425,0,0,0,551,0,0,551,125,34,91,0,0,0,0,0,0,0,0,0,NV02
182634,Colby-Sawyer College,Colby-Sawyer,541 Main St,New London,NH,03257-7835,-71.975805,43.411663,Private not-for-profit,Graduate degree or certificate offering,No,Rural: Distant,Baccalaureate Colleges: Diverse Fields,Not classified (Exclusively Undergraduate),Very high undergraduate,"Four-year, very small, highly residential",40,9,31,0,0,0,40,25,0,15,0,0,0,0,0,0,0,0,0,0,0,0,NH02
182670,Dartmouth College,"Dartmouth, Big Green",207 Parkhurst Hall,Hanover,NH,03755-3529,-72.289949,43.704115,Private not-for-profit,Graduate degree or certificate offering,No,Town: Remote,Doctoral Universities: Very High Research Activity,Research Doctoral: STEM-dominant,Majority undergraduate,"Four-year, medium, highly residential",2271,1170,1101,587,326,261,2271,513,1408,350,662,378,284,168,88,80,75,47,28,31,21,10,NH02
182795,Franklin Pierce University,"Franklin Pierce College, Franklin Pierce, FPU, Pierce",40 University Drive,Rindge,NH,03461-0060,-72.058011,42.78014,Private not-for-profit,Graduate degree or certificate offering,No,Rural: Fringe,Master's Colleges & Universities: Medium Programs,"Postbaccalaureate: Other-dominant, with other professional programs",High undergraduate,"Four-year, small, highly residential",620,227,393,23,18,5,620,264,25,331,100,32,68,3,2,1,0,0,0,0,0,0,NH02
182829,University of New Hampshire-Franklin Pierce School of Law, ,2 White St,Concord,NH,03301-4197,-71.545152,43.207371,Public,Graduate degree or certificate offering,No,Town: Fringe,Special Focus Four-Year: Law Schools,Postbaccalaureate: Single program-Other,Exclusively graduate,Exclusively graduate/professional,468,259,209,31,15,16,468,27,265,176,17,14,3,2,2,0,0,0,0,0,0,0,NH02
182980,New England College,NEC,98 Bridge St,Henniker,NH,03242,-71.822282,43.176403,Private not-for-profit,Graduate degree or certificate offering,No,Rural: Distant,Master's Colleges & Universities: Larger Programs,Postbaccalaureate: Comprehensive programs,Majority graduate,"Four-year, medium, highly residential",3223,2195,1028,2534,1901,633,3223,445,2778,0,691,466,225,446,346,100,10,6,4,0,0,0,NH02
183026,Southern New Hampshire University,SNHU,2500 North River Road,Manchester,NH,03106-1045,-71.451842,43.038922,Private not-for-profit,Graduate degree or certificate offering,No,Suburb: Midsize,Master's Colleges & Universities: Larger Programs,Research Doctoral: Professional-dominant,High undergraduate,"Four-year, large, primarily nonresidential",34053,11291,22762,283,136,147,34053,34053,0,0,7381,2609,4772,130,72,58,5,3,2,1,0,1,NH01
183044,University of New Hampshire-Main Campus, ,"105 Main St., Thompson Hall",Durham,NH,03824-3547,-70.932465,43.135934,Public,Graduate degree or certificate offering,No,Suburb: Small,Doctoral Universities: Very High Research Activity,"Research Doctoral: Comprehensive programs, no medical/veterinary school",High undergraduate,"Four-year, large, highly residential",3013,1138,1875,331,203,128,3013,1016,1258,739,766,287,479,80,52,28,73,40,33,24,17,7,NH01
183062,Keene State College,KSC,229 Main Street,Keene,NH,03435-1506,-72.279276,42.926452,Public,Graduate degree or certificate offering,No,Town: Distant,Baccalaureate Colleges: Diverse Fields,"Postbaccalaureate: Education-dominant, with Arts & Sciences",Very high undergraduate,"Four-year, medium, highly residential",194,62,132,1,0,1,194,109,59,26,32,14,18,0,0,0,0,0,0,0,0,0,NH02
183071,University of New Hampshire at Manchester,UNH Manchester,88 Commercial Street,Manchester,NH,03101-1113,-71.468755,42.987209,Public,No graduate offering,No,City: Midsize,Baccalaureate Colleges: Arts & Sciences Focus,Not classified (Exclusively Undergraduate),Very high undergraduate,"Four-year, very small, primarily nonresidential",263,131,132,49,29,20,263,87,126,50,0,0,0,0,0,0,0,0,0,0,0,0,NH01
183080,Plymouth State University,Plymouth | Plymouth State | PSU | Plymout | Plimout | Plymoth | Plimoth | Plymot | Plimot,17 High Street,Plymouth,NH,03264-1595,-71.690164,43.759573,Public,Graduate degree or certificate offering,No,Town: Remote,Master's Colleges & Universities: Larger Programs,Research Doctoral: Single program-Education,High undergraduate,"Four-year, medium, highly residential",1123,312,811,14,5,9,1123,640,375,108,222,82,140,2,1,1,22,9,13,3,1,2,NH02
183211,Rivier University, ,420 South Main St,Nashua,NH,03060,-71.45626,42.738676,Private not-for-profit,Graduate degree or certificate offering,No,City: Small,Master's Colleges & Universities: Medium Programs,Research Doctoral: Single program-Education,Majority undergraduate,"Four-year, small, primarily residential",1170,241,929,0,0,0,1170,649,364,157,206,50,156,0,0,0,2,0,2,0,0,0,NH02
183257,Granite State College,GSC,25 Hall Street,Concord,NH,03301-3471,-71.527241,43.19291,Public,Graduate degree or certificate offering,No,Town: Fringe,Master's Colleges & Universities: Small Programs,"Postbaccalaureate: Business-dominant, with other professional programs",High undergraduate,"Four-year, small, primarily nonresidential",445,119,326,0,0,0,445,445,0,0,53,20,33,0,0,0,0,0,0,0,0,0,NH02
183789,Berkeley College-Woodland Park,Berkeley College Woodland Park Campus | Berkeley College Paramus Campus | Berkeley College Woodbridge Campus | Berkeley College Newark Campus | Berkeley College Online,44 Rifle Camp Rd,Woodland Park,NJ,07424,-74.189483,40.898587,Private for-profit,Graduate degree or certificate offering,No,Suburb: Large,Master's Colleges & Universities: Small Programs,Postbaccalaureate: Single program-Business,Very high undergraduate,"Four-year, small, primarily nonresidential",260,86,174,21,12,9,260,170,66,24,72,24,48,12,10,2,0,0,0,0,0,0,NJ11
183804,Beth Medrash Govoha, ,617 6th St,Lakewood,NJ,08701-2754,-74.221328,40.095672,Private not-for-profit,Graduate degree or certificate offering,No,City: Small,Special Focus Four-Year: Faith-Related Institutions,Postbaccalaureate: Single program-Other,Majority graduate,"Four-year, medium, highly residential",4408,4408,0,31,31,0,4408,0,0,4408,219,219,0,1,1,0,0,0,0,0,0,0,NJ04
183910,Caldwell University,formerly Caldwell College,120 Bloomfield Avenue,Caldwell,NJ,07006-6195,-74.272571,40.832753,Private not-for-profit,Graduate degree or certificate offering,No,Suburb: Large,Master's Colleges & Universities: Medium Programs,Research Doctoral: Professional-dominant,High undergraduate,"Four-year, small, primarily residential",661,117,544,13,9,4,661,123,148,390,120,23,97,2,1,1,7,1,6,0,0,0,NJ10
183974,Centenary University, ,400 Jefferson St,Hackettstown,NJ,07840,-74.833644,40.84764,Private not-for-profit,Graduate degree or certificate offering,No,Suburb: Large,Master's Colleges & Universities: Medium Programs,Research Doctoral: Single program-Education,High undergraduate,"Four-year, small, highly residential",568,147,421,1,0,1,568,147,230,191,143,49,94,0,0,0,19,11,8,0,0,0,NJ07
184348,Drew University, ,36 Madison Ave,Madison,NJ,07940,-74.424584,40.761829,Private not-for-profit,Graduate degree or certificate offering,No,Suburb: Large,Baccalaureate Colleges: Arts & Sciences Focus,Research Doctoral: Professional-dominant,High undergraduate,"Four-year, small, highly residential",789,366,423,150,108,42,789,3,91,695,111,57,54,31,25,6,20,8,12,2,1,1,NJ11
184603,Fairleigh Dickinson University-Metropolitan Campus,FDU,1000 River Rd,Teaneck,NJ,07666,-74.028986,40.897209,Private not-for-profit,Graduate degree or certificate offering,No,Suburb: Large,Master's Colleges & Universities: Larger Programs,"Postbaccalaureate: Business-dominant, with Arts & Sciences",Majority undergraduate,"Four-year, medium, primarily residential",2380,824,1556,135,59,76,2380,2380,0,0,582,302,280,65,27,38,0,0,0,0,0,0,NJ05
184612,Felician University, ,262 S Main St,Lodi,NJ,07644,-74.096452,40.867272,Private not-for-profit,Graduate degree or certificate offering,No,Suburb: Large,Master's Colleges & Universities: Medium Programs,"Postbaccalaureate: Other-dominant, with Arts & Sciences",High undergraduate,"Four-year, small, primarily residential",507,114,393,18,14,4,507,206,76,225,117,29,88,6,3,3,1,0,1,0,0,0,NJ09
184694,Fairleigh Dickinson University-Florham Campus,FDU,285 Madison Ave,Madison,NJ,07940,-74.432121,40.774498,Private not-for-profit,Graduate degree or certificate offering,No,Suburb: Large,Master's Colleges & Universities: Larger Programs,Postbaccalaureate: Comprehensive programs,High undergraduate,"Four-year, medium, highly residential",864,299,565,17,7,10,864,864,0,0,232,89,143,5,2,3,0,0,0,0,0,0,NJ11
184773,Georgian Court University, ,900 Lakewood Ave,Lakewood,NJ,08701-2697,-74.228186,40.099617,Private not-for-profit,Graduate degree or certificate offering,No,City: Small,Master's Colleges & Universities: Larger Programs,"Postbaccalaureate: Education-dominant, with Arts & Sciences",High undergraduate,"Four-year, small, primarily residential",769,168,601,1,0,1,769,692,74,3,205,43,162,1,0,1,0,0,0,0,0,0,NJ04
184782,Rowan University,Rowan College of New Jersey   Glassboro State College,201 Mullica Hill Road,Glassboro,NJ,08028,-75.119119,39.709108,Public,Graduate degree or certificate offering,No,Suburb: Large,Doctoral Universities: High Research Activity,Research Doctoral: Professional-dominant,High undergraduate,"Four-year, large, primarily residential",4555,1848,2707,232,137,95,4555,1438,841,2276,753,302,451,58,32,26,29,14,15,5,3,2,NJ01
185129,New Jersey City University, ,2039 Kennedy Blvd,Jersey City,NJ,07305,-74.08727,40.709937,Public,Graduate degree or certificate offering,No,City: Large,Master's Colleges & Universities: Larger Programs,Research Doctoral: Professional-dominant,High undergraduate,"Four-year, medium, primarily nonresidential",2325,615,1710,69,26,43,2325,1855,409,61,487,139,348,26,11,15,13,5,8,0,0,0,NJ10
185262,Kean University,Kean,1000 Morris Avenue,Union,NJ,07083,-74.233503,40.677981,Public,Graduate degree or certificate offering,No,Suburb: Large,Doctoral/Professional Universities,Research Doctoral: Professional-dominant,High undergraduate,"Four-year, large, primarily nonresidential",2902,623,2279,47,14,33,2902,221,292,2389,598,143,455,14,7,7,25,4,21,1,0,1,NJ10
185572,Monmouth University, ,400 Cedar Ave,West Long Branch,NJ,07764-1898,-74.006447,40.280066,Private not-for-profit,Graduate degree or certificate offering,No,Suburb: Large,Master's Colleges & Universities: Larger Programs,Postbaccalaureate: Comprehensive programs,High undergraduate,"Four-year, medium, primarily residential",1697,390,1307,46,22,24,1697,773,819,105,535,128,407,22,8,14,0,0,0,0,0,0,NJ06
185590,Montclair State University, ,1 Normal Avenue,Montclair,NJ,07043-1624,-74.198141,40.860414,Public,Graduate degree or certificate offering,No,Suburb: Large,Doctoral Universities: High Research Activity,Research Doctoral: Professional-dominant,High undergraduate,"Four-year, large, primarily residential",5938,1750,4188,241,104,137,5938,3845,1806,287,1405,417,988,57,26,31,29,18,11,3,2,1,NJ11
185758,New Brunswick Theological Seminary, ,35 Seminary Place,New Brunswick,NJ,08901-1107,-74.449368,40.501314,Private not-for-profit,Graduate degree or certificate offering,No,City: Small,Special Focus Four-Year: Faith-Related Institutions,Research Doctoral: Single program-Other,Exclusively graduate,Exclusively graduate/professional,128,62,66,1,1,0,128,0,128,0,16,7,9,0,0,0,11,5,6,0,0,0,NJ06
185828,New Jersey Institute of Technology,NJIT,University Heights,Newark,NJ,07102,-74.177113,40.741997,Public,Graduate degree or certificate offering,No,City: Large,Doctoral Universities: Very High Research Activity,Research Doctoral: STEM-dominant,High undergraduate,"Four-year, medium, primarily nonresidential",3246,2218,1028,1210,825,385,3246,1381,1682,183,939,651,288,413,293,120,96,66,30,76,50,26,NJ10
186122,Princeton Theological Seminary,"Princeton Seminary, PTS",64 Mercer St,Princeton,NJ,08542-0803,-74.66645,40.345849,Private not-for-profit,Graduate degree or certificate offering,No,City: Small,Special Focus Four-Year: Faith-Related Institutions,Research Doctoral: Single program-Other,Exclusively graduate,Exclusively graduate/professional,354,177,177,31,13,18,354,354,0,0,108,52,56,11,5,6,6,2,4,0,0,0,NJ12
186131,Princeton University, ,1 Nassau Hall,Princeton,NJ,08544-0070,-74.659365,40.348732,Private not-for-profit,Graduate degree or certificate offering,No,City: Small,Doctoral Universities: Very High Research Activity,"Research Doctoral: Comprehensive programs, no medical/veterinary school",Majority undergraduate,"Four-year, medium, highly residential",3097,1836,1261,1279,802,477,3097,922,985,1190,605,367,238,254,159,95,293,182,111,139,94,45,NJ12
186186,Rabbinical College of America, ,226 Sussex Ave,Morristown,NJ,07960-3600,-74.49878,40.805705,Private not-for-profit,Graduate degree or certificate offering,No,Suburb: Large,Special Focus Four-Year: Faith-Related Institutions,Postbaccalaureate: Single program-Other,Very high undergraduate,"Four-year, very small, highly residential",12,12,0,2,2,0,12,0,0,12,1,1,0,0,0,0,0,0,0,0,0,0,NJ11
186201,Ramapo College of New Jersey, ,505 Ramapo Valley Rd,Mahwah,NJ,07430-1680,-74.174086,41.080942,Public,Graduate degree or certificate offering,No,Suburb: Large,Master's Colleges & Universities: Larger Programs,"Postbaccalaureate: Education-dominant, with other professional programs",Very high undergraduate,"Four-year, medium, highly residential",807,198,609,3,1,2,807,543,228,36,265,74,191,1,0,1,0,0,0,0,0,0,NJ05
186283,Rider University, ,2083 Lawrence Road,Lawrenceville,NJ,08648-3099,-74.737833,40.278796,Private not-for-profit,Graduate degree or certificate offering,No,Suburb: Large,Master's Colleges & Universities: Larger Programs,"Postbaccalaureate: Business-dominant, with Arts & Sciences",High undergraduate,"Four-year, medium, highly residential",1332,441,891,67,33,34,1332,523,624,185,282,79,203,23,13,10,18,6,12,0,0,0,NJ03
186371,Rutgers University-Camden,"Rutgers, The State University of New Jersey; Rutgers, The State University; Rutgers University; Rutgers U; Rutgers; RutgersCamden; Rutgers, Camden; Rutgers Camden",406 Penn,Camden,NJ,08102,-75.12224,39.948064,Public,Graduate degree or certificate offering,No,City: Small,Doctoral Universities: High Research Activity,Research Doctoral: Professional-dominant,High undergraduate,"Four-year, medium, primarily nonresidential",1799,787,1012,75,32,43,1799,525,90,1184,322,154,168,28,19,9,21,6,15,6,1,5,NJ01
186380,Rutgers University-New Brunswick,"Rutgers, The State University of New Jersey; Rutgers, The State University; Rutgers University; Rutgers U; Rutgers; RutgersNew Brunswick; Rutgers, New Brunswick; Rutgers New Brunswick",83 Somerset St,New Brunswick,NJ,08901-1281,-74.446251,40.498769,Public,Graduate degree or certificate offering,No,City: Small,Doctoral Universities: Very High Research Activity,"Research Doctoral: Comprehensive programs, with medical/veterinary school",High undergraduate,"Four-year, large, primarily residential",16305,5777,10528,2857,1502,1355,16305,3493,1734,11078,3092,982,2110,559,293,266,686,271,415,166,108,58,NJ06
186399,Rutgers University-Newark,"Rutgers, The State University of New Jersey; Rutgers, The State University; Rutgers University; Rutgers U; Rutgers; RutgersNewark; Rutgers, Newark; Rutgers Newark","249 University Avenue, Blumenthal Hall",Newark,NJ,07102,-74.175809,40.739122,Public,Graduate degree or certificate offering,No,City: Large,Doctoral Universities: High Research Activity,"Research Doctoral: Comprehensive programs, no medical/veterinary school",High undergraduate,"Four-year, large, primarily residential",4761,2420,2341,847,462,385,4761,693,426,3642,1266,680,586,386,211,175,69,30,39,27,17,10,NJ10
186432,Saint Peter's University,"Saint Peter's, SPU",2641 Kennedy Blvd,Jersey City,NJ,07306-5997,-74.071541,40.727105,Private not-for-profit,Graduate degree or certificate offering,No,City: Large,Master's Colleges & Universities: Larger Programs,Research Doctoral: Single program-Education,High undergraduate,"Four-year, small, primarily residential",1233,470,763,192,117,75,1233,884,317,32,264,80,184,31,9,22,31,10,21,1,1,0,NJ10
186584,Seton Hall University, ,400 S Orange Ave,South Orange,NJ,07079-2697,-74.246027,40.742336,Private not-for-profit,Graduate degree or certificate offering,No,Suburb: Large,Doctoral Universities: High Research Activity,Research Doctoral: Professional-dominant,Majority undergraduate,"Four-year, medium, primarily residential",4656,1825,2831,165,89,76,4656,1472,2354,830,1067,419,648,50,15,35,67,23,44,10,3,7,NJ11
186618,Saint Elizabeth University,SEU,2 Convent Road,Morristown,NJ,07960,-74.438221,40.78182,Private not-for-profit,Graduate degree or certificate offering,No,Suburb: Large,Master's Colleges & Universities: Medium Programs,Research Doctoral: Professional-dominant,Majority undergraduate,"Four-year, very small, primarily residential",552,115,437,7,0,7,552,110,214,228,121,20,101,1,0,1,19,3,16,0,0,0,NJ11
186867,Stevens Institute of Technology,Stevens,Castle Point On Hudson,Hoboken,NJ,07030-5991,-74.025334,40.744776,Private not-for-profit,Graduate degree or certificate offering,No,Suburb: Large,Doctoral Universities: High Research Activity,Research Doctoral: STEM-dominant,Majority undergraduate,"Four-year, medium, primarily residential",4549,3240,1309,2296,1640,656,4549,815,2118,1616,1611,1132,479,1051,759,292,54,39,15,38,26,12,NJ08
186876,Stockton University, ,101 Vera King Farris Drive,Galloway,NJ,08205-9441,-74.531087,39.492036,Public,Graduate degree or certificate offering,No,Suburb: Midsize,Doctoral/Professional Universities,Research Doctoral: Single program-Other,Very high undergraduate,"Four-year, medium, primarily residential",1167,303,864,8,3,5,1167,481,564,122,314,75,239,1,0,1,17,2,15,1,0,1,NJ02
187046,Thomas Edison State University,"TESU, Thomas Edison State University, (old name:Thomas Edison State College), (old abbreviation:TESC)",111 W State St,Trenton,NJ,08608,-74.768562,40.220487,Public,Graduate degree or certificate offering,No,City: Small,Master's Colleges & Universities: Medium Programs,"Postbaccalaureate: Business-dominant, with Arts & Sciences",Very high undergraduate,"Four-year, medium, primarily nonresidential",1194,500,694,9,2,7,1194,1194,0,0,181,90,91,1,0,1,0,0,0,0,0,0,NJ12
187134,The College of New Jersey,TCNJ,2000 Pennington Road,Ewing,NJ,08628-7718,-74.778791,40.268651,Public,Graduate degree or certificate offering,No,Suburb: Large,Master's Colleges & Universities: Larger Programs,"Postbaccalaureate: Education-dominant, with Arts & Sciences",Very high undergraduate,"Four-year, medium, highly residential",1353,268,1085,0,0,0,1353,1350,3,0,377,70,307,0,0,0,0,0,0,0,0,0,NJ12
187444,William Paterson University of New Jersey, ,300 Pompton Rd,Wayne,NJ,07470,-74.200248,40.945255,Public,Graduate degree or certificate offering,No,Suburb: Large,Master's Colleges & Universities: Larger Programs,Postbaccalaureate: Comprehensive programs,High undergraduate,"Four-year, medium, primarily residential",2384,598,1786,31,15,16,2384,324,974,1086,419,122,297,11,6,5,0,0,0,0,0,0,NJ11
187596,Navajo Technical University,Navajo Tech,"Lower Point Road, State Road 371",Crownpoint,NM,87313-0849,-108.149392,35.687431,Public,Graduate degree or certificate offering,No,Rural: Remote,Tribal Colleges,Postbaccalaureate: Single program-Other,Very high undergraduate,"Four-year, very small, primarily residential",13,3,10,0,0,0,13,0,13,0,0,0,0,0,0,0,0,0,0,0,0,0,NM03
187648,Eastern New Mexico University-Main Campus,ENMU-Portales,"ENMU Station 2, 1500 S Ave K",Portales,NM,88130,-103.34819,34.175592,Public,Graduate degree or certificate offering,No,Town: Remote,Master's Colleges & Universities: Larger Programs,Postbaccalaureate: Comprehensive programs,High undergraduate,"Four-year, medium, primarily residential",1838,440,1398,43,15,28,1838,1658,167,13,293,89,204,13,8,5,0,0,0,0,0,0,NM03
187745,Institute of American Indian and Alaska Native Culture and Arts Development,Institute of American Indian Arts,83 Avan Nu Po Road,Santa Fe,NM,87508-1300,-106.010015,35.586563,Public,Graduate degree or certificate offering,No,Rural: Fringe,Tribal Colleges,Postbaccalaureate: Single program-Other,High undergraduate,"Four-year, very small, primarily residential",44,12,32,0,0,0,44,44,0,0,14,2,12,0,0,0,0,0,0,0,0,0,NM03
187897,New Mexico Highlands University, ,803 University Ave,Las Vegas,NM,87701,-105.219197,35.596233,Public,Graduate degree or certificate offering,No,Town: Remote,Master's Colleges & Universities: Larger Programs,Postbaccalaureate: Comprehensive programs,Majority undergraduate,"Four-year, small, primarily residential",1269,347,922,58,21,37,1269,841,342,86,314,79,235,19,8,11,0,0,0,0,0,0,NM03
187967,New Mexico Institute of Mining and Technology,New Mexico Tech,801 Leroy Place,Socorro,NM,87801,-106.905211,34.067041,Public,Graduate degree or certificate offering,No,Town: Remote,Master's Colleges & Universities: Small Programs,Research Doctoral: STEM-dominant,High undergraduate,"Four-year, small, highly residential",570,337,233,75,58,17,570,214,243,113,97,63,34,19,13,6,16,12,4,9,9,0,NM02
187985,University of New Mexico-Main Campus,UNM,1700 Lomas Blvd NE,Albuquerque,NM,87106,-106.620155,35.083868,Public,Graduate degree or certificate offering,No,City: Large,Doctoral Universities: Very High Research Activity,"Research Doctoral: Comprehensive programs, with medical/veterinary school",High undergraduate,"Four-year, large, primarily nonresidential",6760,2959,3801,664,395,269,6760,722,2649,3389,1080,469,611,118,72,46,170,81,89,41,25,16,NM01
188030,New Mexico State University-Main Campus,NMSU,2850 Weddell Street,Las Cruces,NM,88003-8001,-106.752069,32.281568,Public,Graduate degree or certificate offering,No,Suburb: Midsize,Doctoral Universities: High Research Activity,"Research Doctoral: Comprehensive programs, no medical/veterinary school",High undergraduate,"Four-year, large, primarily residential",3173,1303,1870,511,294,217,3173,824,1630,719,644,249,395,77,41,36,105,64,41,44,33,11,NM02
188182,University of the Southwest,USW,6610 North Lovington Hwy,Hobbs,NM,88240,-103.186948,32.775496,Private not-for-profit,Graduate degree or certificate offering,No,Rural: Fringe,Master's Colleges & Universities: Larger Programs,Research Doctoral: Single program-Other,Majority undergraduate,"Four-year, very small, highly residential",559,180,379,0,0,0,559,559,0,0,238,65,173,0,0,0,5,2,3,0,0,0,NM03
188207,Southwestern College, ,3960  San Felipe Road,Santa Fe,NM,87507,-106.052585,35.636241,Private not-for-profit,Graduate degree or certificate offering,No,City: Small,Special Focus Four-Year: Other Health Professions Schools,"Postbaccalaureate: Other-dominant, with other professional programs",Exclusively graduate,Exclusively graduate/professional,238,22,216,2,0,2,238,219,19,0,41,7,34,1,0,1,0,0,0,0,0,0,NM03
188304,Western New Mexico University, ,1000 W. College Ave,Silver City,NM,88061,-108.283284,32.7767,Public,Graduate degree or certificate offering,No,Town: Remote,Master's Colleges & Universities: Larger Programs,"Postbaccalaureate: Other-dominant, with Arts & Sciences",Majority undergraduate,"Four-year, small, primarily nonresidential",1269,291,978,9,1,8,1269,1106,163,0,253,68,185,4,1,3,0,0,0,0,0,0,NM02
188340,Vaughn College of Aeronautics and Technology, ,86-01 23rd Avenue,Flushing,NY,11369,-73.881721,40.768348,Private not-for-profit,Graduate degree or certificate offering,No,City: Large,Baccalaureate Colleges: Diverse Fields,Postbaccalaureate: Single program-Business,Very high undergraduate,"Four-year, small, primarily nonresidential",4,2,2,0,0,0,4,0,4,0,2,0,2,0,0,0,0,0,0,0,0,0,NY14
188429,Adelphi University, ,South Ave,Garden City,NY,11530-0701,-73.653321,40.721439,Private not-for-profit,Graduate degree or certificate offering,No,Suburb: Large,Doctoral/Professional Universities,Research Doctoral: Professional-dominant,Majority undergraduate,"Four-year, medium, primarily nonresidential",3062,839,2223,349,191,158,3062,1278,1648,136,1015,287,728,156,86,70,54,12,42,3,0,3,NY04
188526,Albany College of Pharmacy and Health Sciences, ,106 New Scotland Avenue,Albany,NY,12208-3492,-73.779063,42.650371,Private not-for-profit,Graduate degree or certificate offering,No,City: Small,Special Focus Four-Year: Other Health Professions Schools,"Postbaccalaureate: Other-dominant, with Arts & Sciences",Majority undergraduate,"Four-year, small, highly residential",446,160,286,42,15,27,446,7,254,185,14,7,7,1,1,0,0,0,0,0,0,0,NY20
188535,Albany Law School, ,80 New Scotland Avenue,Albany,NY,12208,-73.777495,42.651818,Private not-for-profit,Graduate degree or certificate offering,No,City: Small,Special Focus Four-Year: Law Schools,Postbaccalaureate: Single program-Other,Exclusively graduate,Exclusively graduate/professional,656,296,360,13,6,7,656,107,153,396,26,11,15,0,0,0,0,0,0,0,0,0,NY20
188580,Albany Medical College, ,47 New Scotland Ave,Albany,NY,12208-3479,-73.777289,42.65382,Private not-for-profit,Graduate degree or certificate offering,No,City: Small,Special Focus Four-Year: Medical Schools & Centers,Research Doctoral: Single program-Other,Exclusively graduate,Exclusively graduate/professional,903,379,524,13,6,7,903,64,0,839,73,27,46,1,1,0,9,4,5,1,0,1,NY20
188641,Alfred University, ,One Saxon Drive,Alfred,NY,14802-1205,-77.788106,42.254476,Private not-for-profit,Graduate degree or certificate offering,No,Town: Remote,Master's Colleges & Universities: Larger Programs,Research Doctoral: Professional-dominant,High undergraduate,"Four-year, small, highly residential",917,228,689,25,12,13,917,128,423,366,132,45,87,7,3,4,7,1,6,2,0,2,NY23
188854,American Musical and Dramatic Academy, ,211 West 61st Street,New York,NY,10023,-73.987549,40.772275,Private not-for-profit,Graduate degree or certificate offering,No,City: Large,"Special Focus Four-Year: Arts, Music & Design Schools",Not classified (Exclusively Undergraduate),Very high undergraduate,"Four-year, small, highly residential",4,0,4,0,0,0,4,0,0,4,0,0,0,0,0,0,0,0,0,0,0,0,NY12
189015,Bank Street College of Education, ,610 W 112 St,New York,NY,10025,-73.966643,40.805604,Private not-for-profit,Graduate degree or certificate offering,No,City: Large,Special Focus Four-Year: Other Special Focus Institutions,"Postbaccalaureate: Education-dominant, with other professional programs",Exclusively graduate,Exclusively graduate/professional,978,125,853,1,0,1,978,160,10,808,361,55,306,0,0,0,0,0,0,0,0,0,NY12
189088,Bard College, ,Annandale Road,Annandale-On-Hudson,NY,12504-5000,-73.909927,42.020386,Private not-for-profit,Graduate degree or certificate offering,No,Town: Fringe,Baccalaureate Colleges: Arts & Sciences Focus,Research Doctoral: Single program-Other,High undergraduate,"Four-year, small, highly residential",417,165,252,85,33,52,417,0,0,417,125,56,69,25,14,11,6,2,4,4,1,3,NY18
189413,Boricua College, ,3755 Broadway,New York,NY,10032-1560,-73.9458,40.833434,Private not-for-profit,Graduate degree or certificate offering,No,City: Large,Baccalaureate Colleges: Diverse Fields,"Postbaccalaureate: Education-dominant, with other professional programs",High undergraduate,"Four-year, very small, primarily nonresidential",98,8,90,0,0,0,98,0,0,98,26,1,25,0,0,0,0,0,0,0,0,0,NY13
189501,Brooklyn Law School, ,250 Joralemon St,Brooklyn,NY,11201,-73.989623,40.691836,Private not-for-profit,Graduate degree or certificate offering,No,City: Large,Special Focus Four-Year: Law Schools,Postbaccalaureate: Single program-Other,Exclusively graduate,Exclusively graduate/professional,1228,502,726,95,38,57,1228,0,0,1228,13,3,10,11,3,8,0,0,0,0,0,0,NY10
189705,Canisius College,Canisius,2001 Main Street,Buffalo,NY,14208-1098,-78.852577,42.925206,Private not-for-profit,Graduate degree or certificate offering,No,City: Large,Master's Colleges & Universities: Larger Programs,"Postbaccalaureate: Education-dominant, with Arts & Sciences",High undergraduate,"Four-year, small, primarily residential",1119,449,670,41,25,16,1119,403,643,73,396,176,220,16,9,7,0,0,0,0,0,0,NY26
189848,Cazenovia College, ,22 Sullivan St,Cazenovia,NY,13035,-75.854882,42.932489,Private not-for-profit,Graduate degree or certificate offering,No,Town: Fringe,Baccalaureate Colleges: Diverse Fields,Not classified (Exclusively Undergraduate),Very high undergraduate,"Four-year, very small, highly residential",26,1,25,0,0,0,26,0,0,26,0,0,0,0,0,0,0,0,0,0,0,0,NY22
189857,Central Yeshiva Tomchei Tmimim Lubavitz, ,841 Ocean Pky,Brooklyn,NY,11230-2798,-73.938778,40.669694,Private not-for-profit,Graduate degree or certificate offering,No,City: Large,Special Focus Four-Year: Faith-Related Institutions,Postbaccalaureate: Single program-Other,High undergraduate,"Four-year, very small, highly residential",105,105,0,14,14,0,105,0,0,105,27,27,0,4,4,0,0,0,0,0,0,0,NY09
190044,Clarkson University, ,8 Clarkson Ave,Potsdam,NY,13699,-74.999359,44.662716,Private not-for-profit,Graduate degree or certificate offering,No,Town: Remote,Doctoral Universities: High Research Activity,Research Doctoral: STEM-dominant,High undergraduate,"Four-year, medium, highly residential",1445,792,653,264,156,108,1445,555,335,555,389,211,178,54,34,20,28,19,9,20,15,5,NY21
190080,Colgate Rochester Crozer Divinity School, ,"320 North Goodman St, Suite 207",Rochester,NY,14607,-77.584292,43.159775,Private not-for-profit,Graduate degree or certificate offering,No,City: Midsize,Special Focus Four-Year: Faith-Related Institutions,Postbaccalaureate: Arts & sciences-dominant,Exclusively graduate,Exclusively graduate/professional,54,32,22,1,1,0,54,0,0,54,3,1,2,0,0,0,0,0,0,0,0,0,NY25
190099,Colgate University, ,13 Oak Drive,Hamilton,NY,13346-1398,-75.536346,42.819475,Private not-for-profit,Graduate degree or certificate offering,No,Town: Distant,Baccalaureate Colleges: Arts & Sciences Focus,Postbaccalaureate: Single program-Education,Very high undergraduate,"Four-year, medium, highly residential",17,7,10,1,0,1,17,7,9,1,3,1,2,0,0,0,0,0,0,0,0,0,NY22
190114,Metropolitan College of New York,MCNY,60 West Street,New York,NY,10006-1742,-74.014702,40.708706,Private not-for-profit,Graduate degree or certificate offering,No,City: Large,Master's Colleges & Universities: Medium Programs,"Postbaccalaureate: Business-dominant, with other professional programs",Majority undergraduate,"Four-year, very small, primarily nonresidential",500,132,368,33,15,18,500,130,344,26,217,54,163,15,6,9,0,0,0,0,0,0,NY10
190150,Columbia University in the City of New York,Columbia University,West 116 St and Broadway,New York,NY,10027,-73.961885,40.808286,Private not-for-profit,Graduate degree or certificate offering,No,City: Large,Doctoral Universities: Very High Research Activity,"Research Doctoral: Comprehensive programs, with medical/veterinary school",Majority graduate,"Four-year, large, highly residential",25007,11191,13816,10524,5174,5350,25007,19699,2606,2702,8527,3652,4875,4469,2076,2393,585,327,258,215,136,79,NY13
190372,Cooper Union for the Advancement of Science and Art,The Cooper Union,7 East 7th Street,New York,NY,10003-7120,-73.991609,40.728148,Private not-for-profit,Graduate degree or certificate offering,No,City: Large,Baccalaureate Colleges: Diverse Fields,"Postbaccalaureate: Other-dominant, with Arts & Sciences",Very high undergraduate,"Four-year, very small, primarily nonresidential",90,69,21,15,8,7,90,0,0,90,46,31,15,9,5,4,0,0,0,0,0,0,NY10
190415,Cornell University, ,300 Day Hall,Ithaca,NY,14853,-76.483084,42.4472,Private not-for-profit,Graduate degree or certificate offering,No,City: Small,Doctoral Universities: Very High Research Activity,"Research Doctoral: Comprehensive programs, with medical/veterinary school",Majority undergraduate,"Four-year, large, primarily residential",9303,4903,4400,3949,2097,1852,9303,1110,7377,816,2888,1628,1260,1334,726,608,476,270,206,205,132,73,NY19
190424,Weill Medical College of Cornell University,"Weill Cornell Medical College, Joan and Sanford I. Weill Medical College of Cornell University, Weill Medical College, Cornell Medical College, Cornell Medical Campus",1300 York Avenue,New York,NY,10065,-73.954839,40.764738,Private not-for-profit,Graduate degree or certificate offering,No,City: Large,Special Focus Four-Year: Research Institutions,Research Doctoral: STEM-dominant,Exclusively graduate,Exclusively graduate/professional,1392,606,786,218,105,113,1392,73,906,413,194,62,132,52,16,36,63,33,30,23,14,9,NY12
190503,Culinary Institute of America,The Culinary Institute of America   CIA  The Culinary Institute of America at Greystone  The Culinary Institute of America at San Antonio,1946 Campus Drive,Hyde Park,NY,12538-1499,-73.933231,41.745806,Private not-for-profit,Graduate degree or certificate offering,No,Suburb: Large,"Special Focus Four-Year: Arts, Music & Design Schools",Postbaccalaureate: Single program-Business,Very high undergraduate,"Four-year, medium, highly residential",129,55,74,4,1,3,129,59,70,0,44,18,26,1,0,1,0,0,0,0,0,0,NY18
190512,CUNY Bernard M Baruch College,Baruch | Baruch College,One Bernard Baruch Way (55 Lexington Ave at 24th St),New York,NY,10010,-73.983417,40.740238,Public,Graduate degree or certificate offering,No,City: Large,Master's Colleges & Universities: Larger Programs,"Postbaccalaureate: Business-dominant, with Arts & Sciences",High undergraduate,"Four-year, large, primarily nonresidential",4842,2180,2662,803,327,476,4842,4601,239,2,1474,655,819,354,140,214,0,0,0,0,0,0,NY12
190549,CUNY Brooklyn College,Brooklyn | Brooklyn College,2900 Bedford Ave,Brooklyn,NY,11210,-73.949898,40.631517,Public,Graduate degree or certificate offering,No,City: Large,Master's Colleges & Universities: Larger Programs,Postbaccalaureate: Comprehensive programs,Very high undergraduate,"Four-year, large, primarily nonresidential",3382,1125,2257,104,41,63,3382,3241,136,5,1061,354,707,56,23,33,0,0,0,0,0,0,NY09
190558,College of Staten Island CUNY,Staten Island | CSI | College of Staten Island,2800 Victory Blvd,Staten Island,NY,10314,-74.14849,40.601831,Public,Graduate degree or certificate offering,No,City: Large,Master's Colleges & Universities: Larger Programs,"Postbaccalaureate: Education-dominant, with Arts & Sciences",Very high undergraduate,"Four-year, large, primarily nonresidential",1173,338,835,20,8,12,1173,1018,152,3,299,93,206,12,5,7,0,0,0,0,0,0,NY11
190567,CUNY City College,City | City College | CCNY | City College of New York,160 Convent Ave,New York,NY,10031,-73.948542,40.819846,Public,Graduate degree or certificate offering,No,City: Large,Doctoral Universities: High Research Activity,Research Doctoral: Single program-Other,High undergraduate,"Four-year, large, primarily nonresidential",3246,1244,2002,277,139,138,3246,2665,412,169,903,331,572,97,44,53,21,12,9,16,7,9,NY13
190576,CUNY Graduate School and University Center,The Graduate Center | CUNY Graduate Center | The Graduate Center of the City University of New York,365 Fifth Ave,New York,NY,10016,-73.983822,40.748612,Public,Graduate degree or certificate offering,No,City: Large,Doctoral Universities: Very High Research Activity,"Research Doctoral: Comprehensive programs, no medical/veterinary school",Majority graduate,"Four-year, medium, primarily nonresidential",7220,2606,4614,1015,473,542,7220,7136,76,8,1480,579,901,279,132,147,350,141,209,103,50,53,NY12
190594,CUNY Hunter College,Hunter | Hunter College,695 Park Ave,New York,NY,10065,-73.964795,40.768669,Public,Graduate degree or certificate offering,No,City: Large,Master's Colleges & Universities: Larger Programs,Postbaccalaureate: Comprehensive programs,High undergraduate,"Four-year, large, primarily nonresidential",7678,1762,5916,231,57,174,7678,4888,2691,99,2089,449,1640,58,13,45,1,0,1,0,0,0,NY12
190600,CUNY John Jay College of Criminal Justice,John Jay | John Jay College of Criminal Justice,524 W 59th St,New York,NY,10019,-73.98841,40.770351,Public,Graduate degree or certificate offering,No,City: Large,Master's Colleges & Universities: Larger Programs,"Postbaccalaureate: Other-dominant, with Arts & Sciences",Very high undergraduate,"Four-year, large, primarily nonresidential",2702,1239,1463,86,54,32,2702,2590,109,3,692,345,347,30,19,11,0,0,0,0,0,0,NY12
190637,CUNY Lehman College,Lehman | Lehman College,250 Bedford Park Blvd West,Bronx,NY,10468,-73.895379,40.872962,Public,Graduate degree or certificate offering,No,City: Large,Master's Colleges & Universities: Larger Programs,Postbaccalaureate: Comprehensive programs,Very high undergraduate,"Four-year, large, primarily nonresidential",2720,734,1986,50,18,32,2720,2253,458,9,832,243,589,11,1,10,0,0,0,0,0,0,NY13
190664,CUNY Queens College,Queens | Queens College,65-30 Kissena Blvd,Queens,NY,11367,-73.816098,40.735182,Public,Graduate degree or certificate offering,No,City: Large,Master's Colleges & Universities: Larger Programs,Postbaccalaureate: Comprehensive programs,Very high undergraduate,"Four-year, large, primarily nonresidential",3581,1072,2509,133,43,90,3581,2910,653,18,1024,311,713,44,13,31,0,0,0,0,0,0,NY06
190682,CUNY School of Law,Law School | CUNY Law School,2 Court Square,Long Island City,NY,11101,-73.943621,40.747797,Public,Graduate degree or certificate offering,No,City: Large,Special Focus Four-Year: Law Schools,Postbaccalaureate: Single program-Other,Exclusively graduate,Exclusively graduate/professional,690,262,428,19,6,13,690,606,83,1,0,0,0,0,0,0,0,0,0,0,0,0,NY07
190691,CUNY York College,York | York College,94-20 Guy R. Brewer Blvd,Jamaica,NY,11451,-73.796313,40.701576,Public,Graduate degree or certificate offering,No,City: Large,Master's Colleges & Universities: Small Programs,"Postbaccalaureate: Other-dominant, with Arts & Sciences",Very high undergraduate,"Four-year, medium, primarily nonresidential",266,67,199,17,5,12,266,126,140,0,96,25,71,7,2,5,0,0,0,0,0,0,NY05
190716,D'Youville College, ,320 Porter Ave,Buffalo,NY,14201-1084,-78.890868,42.902636,Private not-for-profit,Graduate degree or certificate offering,No,City: Large,Doctoral/Professional Universities,Research Doctoral: Professional-dominant,Majority undergraduate,"Four-year, small, primarily residential",1479,409,1070,165,55,110,1479,325,1154,0,316,67,249,23,4,19,10,5,5,1,1,0,NY26
190725,Daemen University, ,4380 Main St,Amherst,NY,14226-3592,-78.788111,42.965605,Private not-for-profit,Graduate degree or certificate offering,No,Suburb: Large,Doctoral/Professional Universities,"Postbaccalaureate: Other-dominant, with other professional programs",Majority undergraduate,"Four-year, small, primarily residential",1060,210,850,14,3,11,1060,343,494,223,388,61,327,1,1,0,0,0,0,0,0,0,NY26
190761,Dominican College of Blauvelt,Dominican College,470 Western Highway,Orangeburg,NY,10962-1210,-73.950555,41.047419,Private not-for-profit,Graduate degree or certificate offering,No,Suburb: Large,Doctoral/Professional Universities,"Postbaccalaureate: Other-dominant, with other professional programs",High undergraduate,"Four-year, small, primarily residential",584,144,440,27,17,10,584,132,0,452,146,17,129,0,0,0,0,0,0,0,0,0,NY17
190983,Elmira College,EC,One Park Place,Elmira,NY,14901,-76.813459,42.0961,Private not-for-profit,Graduate degree or certificate offering,No,City: Small,Baccalaureate Colleges: Diverse Fields,"Postbaccalaureate: Business-dominant, with other professional programs",Very high undergraduate,"Four-year, very small, highly residential",73,24,49,0,0,0,73,8,32,33,34,12,22,0,0,0,0,0,0,0,0,0,NY23
191126,Fashion Institute of Technology,FIT,227 W 27th St,New York,NY,10001-5992,-73.994781,40.74731,Public,Graduate degree or certificate offering,No,City: Large,Master's Colleges & Universities: Small Programs,"Postbaccalaureate: Other-dominant, with Arts & Sciences",Very high undergraduate,"Four-year, medium, primarily nonresidential",253,37,216,80,11,69,253,40,194,19,93,13,80,36,5,31,0,0,0,0,0,0,NY12
191205,Five Towns College, ,305 North Service Road,Dix Hills,NY,11746-5871,-73.369348,40.794506,Private for-profit,Graduate degree or certificate offering,No,Suburb: Large,"Special Focus Four-Year: Arts, Music & Design Schools",Research Doctoral: Single program-Other,Very high undergraduate,"Four-year, very small, primarily residential",29,21,8,5,3,2,29,1,18,10,6,3,3,0,0,0,2,1,1,1,0,1,NY01
191241,Fordham University, ,441 E Fordham Rd,Bronx,NY,10458,-73.882705,40.859354,Private not-for-profit,Graduate degree or certificate offering,No,City: Large,Doctoral Universities: High Research Activity,"Research Doctoral: Comprehensive programs, no medical/veterinary school",Majority undergraduate,"Four-year, large, highly residential",8424,2794,5630,1252,569,683,8424,6102,2059,263,2617,802,1815,659,313,346,114,39,75,15,4,11,NY15
191320,The General Theological Seminary,GTS,440 West 21st Street,New York,NY,10011,-74.00378,40.745563,Private not-for-profit,Graduate degree or certificate offering,No,City: Large,Special Focus Four-Year: Faith-Related Institutions,"Postbaccalaureate: Other-dominant, with Arts & Sciences",Exclusively graduate,Exclusively graduate/professional,65,22,43,3,2,1,65,26,26,13,17,7,10,3,2,1,1,0,1,0,0,0,NY12
191533,Hartwick College, ,One Hartwick Drive,Oneonta,NY,13820-4020,-75.071994,42.457599,Private not-for-profit,Graduate degree or certificate offering,No,Town: Remote,Baccalaureate Colleges: Arts & Sciences Focus,Not classified (Exclusively Undergraduate),Very high undergraduate,"Four-year, small, highly residential",3,2,1,0,0,0,3,3,0,0,0,0,0,0,0,0,0,0,0,0,0,0,NY19
191621,Hilbert College,Hilbert,5200 S Park Ave,Hamburg,NY,14075-1597,-78.820257,42.75464,Private not-for-profit,Graduate degree or certificate offering,No,Suburb: Large,Baccalaureate Colleges: Diverse Fields,"Postbaccalaureate: Other-dominant, with other professional programs",Very high undergraduate,"Four-year, very small, primarily residential",82,19,63,2,1,1,82,12,70,0,25,6,19,0,0,0,0,0,0,0,0,0,NY23
191630,Hobart William Smith Colleges, ,337 Pulteney Street,Geneva,NY,14456,-76.985516,42.858131,Private not-for-profit,Graduate degree or certificate offering,No,Town: Distant,Baccalaureate Colleges: Arts & Sciences Focus,Postbaccalaureate: Single program-Education,Very high undergraduate,"Four-year, small, highly residential",10,2,8,0,0,0,10,0,0,10,10,2,8,0,0,0,0,0,0,0,0,0,NY24
191649,Hofstra University, ,100 Hofstra University,Hempstead,NY,11549,-73.60078,40.715959,Private not-for-profit,Graduate degree or certificate offering,No,Suburb: Large,Doctoral/Professional Universities,Research Doctoral: Professional-dominant,Majority undergraduate,"Four-year, medium, highly residential",4814,1792,3022,371,189,182,4814,356,737,3721,1217,436,781,173,90,83,55,24,31,1,0,1,NY04
191676,Houghton College,Houghton College,1 Willard Ave,Houghton,NY,14744,-78.155426,42.426137,Private not-for-profit,Graduate degree or certificate offering,No,Rural: Remote,Baccalaureate Colleges: Arts & Sciences Focus,Postbaccalaureate: Single program-Other,Very high undergraduate,"Four-year, very small, highly residential",45,20,25,5,1,4,45,19,12,14,11,7,4,2,0,2,0,0,0,0,0,0,NY23
191931,Iona College, ,715 North Ave,New Rochelle,NY,10801-1890,-73.788046,40.925725,Private not-for-profit,Graduate degree or certificate offering,No,Suburb: Large,Master's Colleges & Universities: Larger Programs,Postbaccalaureate: Comprehensive programs,High undergraduate,"Four-year, medium, primarily residential",730,279,451,21,16,5,730,64,291,375,308,119,189,5,4,1,0,0,0,0,0,0,NY16
191968,Ithaca College, ,953 Danby Road,Ithaca,NY,14850-7002,-76.494136,42.422154,Private not-for-profit,Graduate degree or certificate offering,No,Suburb: Small,Master's Colleges & Universities: Larger Programs,"Postbaccalaureate: Other-dominant, with Arts & Sciences",Very high undergraduate,"Four-year, medium, highly residential",627,172,455,14,3,11,627,485,9,133,173,50,123,6,1,5,0,0,0,0,0,0,NY19
192040,Jewish Theological Seminary of America, ,3080 Broadway,New York,NY,10027-4649,-73.960582,40.811892,Private not-for-profit,Graduate degree or certificate offering,No,City: Large,Special Focus Four-Year: Faith-Related Institutions,Research Doctoral: Professional-dominant,Majority graduate,"Four-year, very small, highly residential",240,117,123,3,1,2,240,31,64,145,50,17,33,1,0,1,2,2,0,0,0,0,NY13
192110,The Juilliard School,Juilliard,60 Lincoln Center Plaza,New York,NY,10023-6588,-73.982913,40.773725,Private not-for-profit,Graduate degree or certificate offering,No,City: Large,"Special Focus Four-Year: Arts, Music & Design Schools",Research Doctoral: Single program-Other,Majority undergraduate,"Four-year, very small, highly residential",376,196,180,123,54,69,376,67,309,0,115,54,61,42,14,28,7,6,1,1,1,0,NY12
192192,Keuka College, ,141 Central Avenue,Keuka Park,NY,14478,-77.090562,42.615253,Private not-for-profit,Graduate degree or certificate offering,No,Town: Distant,Master's Colleges & Universities: Medium Programs,"Postbaccalaureate: Other-dominant, with other professional programs",High undergraduate,"Four-year, small, highly residential",303,51,252,1,0,1,303,272,21,10,150,29,121,1,0,1,0,0,0,0,0,0,NY24
192271,LIM College,LIM|LIM College,12 E 53rd St,New York,NY,10022-5268,-73.975054,40.759865,Private for-profit,Graduate degree or certificate offering,No,City: Large,Special Focus Four-Year: Business & Management Schools,Postbaccalaureate: Single program-Business,High undergraduate,"Four-year, small, primarily nonresidential",532,40,492,111,15,96,532,470,49,13,244,20,224,77,10,67,0,0,0,0,0,0,NY12
192323,Le Moyne College, ,1419 Salt Springs Rd,Syracuse,NY,13214-1301,-76.090435,43.049192,Private not-for-profit,Graduate degree or certificate offering,No,Suburb: Large,Master's Colleges & Universities: Larger Programs,"Postbaccalaureate: Other-dominant, with other professional programs",High undergraduate,"Four-year, small, highly residential",797,214,583,6,4,2,797,187,576,34,258,79,179,2,2,0,0,0,0,0,0,0,NY22
192448,Long Island University, ,720 Northern Blvd,Brookville,NY,11548-1327,-73.593678,40.820714,Private not-for-profit,Graduate degree or certificate offering,No,Suburb: Large,Doctoral Universities: High Research Activity,Research Doctoral: Professional-dominant,Majority undergraduate,"Four-year, medium, primarily residential",5533,1255,4278,355,130,225,5533,531,281,4721,1591,344,1247,129,42,87,89,38,51,8,5,3,NY03
192703,Manhattan College, ,4513 Manhattan College Parkway,Riverdale,NY,10471-4098,-73.901893,40.889756,Private not-for-profit,Graduate degree or certificate offering,No,City: Large,Master's Colleges & Universities: Larger Programs,"Postbaccalaureate: Business-dominant, with Arts & Sciences",High undergraduate,"Four-year, medium, highly residential",707,328,379,38,23,15,707,33,196,478,273,131,142,22,14,8,0,0,0,0,0,0,NY15
192712,Manhattan School of Music, ,130 Claremont Avenue,New York,NY,10027,-73.961334,40.812312,Private not-for-profit,Graduate degree or certificate offering,No,City: Large,"Special Focus Four-Year: Arts, Music & Design Schools",Postbaccalaureate: Single program-Other,Majority undergraduate,"Four-year, very small, highly residential",469,209,260,304,106,198,469,0,469,0,132,52,80,85,30,55,0,0,0,0,0,0,NY13
192749,Manhattanville College, ,2900 Purchase St,Purchase,NY,10577,-73.715645,41.032187,Private not-for-profit,Graduate degree or certificate offering,No,Suburb: Large,Master's Colleges & Universities: Larger Programs,Research Doctoral: Single program-Education,Majority undergraduate,"Four-year, small, highly residential",1436,436,1000,12,8,4,1436,8,1214,214,251,74,177,3,1,2,15,4,11,1,1,0,NY16
192785,Maria College of Albany, ,700 New Scotland Ave,Albany,NY,12208,-73.806287,42.657789,Private not-for-profit,Graduate degree or certificate offering,No,City: Small,Special Focus Four-Year: Other Health Professions Schools,Not classified (Exclusively Undergraduate),Very high undergraduate,"Four-year, very small, primarily nonresidential",20,2,18,0,0,0,20,0,2,18,0,0,0,0,0,0,0,0,0,0,0,0,NY20
192819,Marist College, ,3399 North Rd,Poughkeepsie,NY,12601,-73.935484,41.720937,Private not-for-profit,Graduate degree or certificate offering,No,Suburb: Large,Master's Colleges & Universities: Larger Programs,Postbaccalaureate: Comprehensive programs,High undergraduate,"Four-year, medium, highly residential",1151,447,704,33,24,9,1151,702,225,224,359,131,228,11,8,3,0,0,0,0,0,0,NY18
192925,Medaille College, ,18 Agassiz Circle,Buffalo,NY,14214-2695,-78.855941,42.92856,Private not-for-profit,Graduate degree or certificate offering,No,City: Large,Master's Colleges & Universities: Larger Programs,"Postbaccalaureate: Education-dominant, with Arts & Sciences",Majority undergraduate,"Four-year, small, primarily residential",1146,237,909,0,0,0,1146,146,1000,0,269,60,209,0,0,0,0,0,0,0,0,0,NY26
193016,Mercy College,Mercy,555 Broadway,Dobbs Ferry,NY,10522,-73.874447,41.021626,Private not-for-profit,Graduate degree or certificate offering,No,Suburb: Large,Master's Colleges & Universities: Larger Programs,"Postbaccalaureate: Other-dominant, with Arts & Sciences",High undergraduate,"Four-year, medium, primarily nonresidential",3331,702,2629,31,13,18,3331,1744,1189,398,897,214,683,19,10,9,0,0,0,0,0,0,NY16
193052,Mesivta Torah Vodaath Rabbinical Seminary, ,425 E 9th St,Brooklyn,NY,11218,-73.969395,40.6382,Private not-for-profit,Graduate degree or certificate offering,No,City: Large,Special Focus Four-Year: Faith-Related Institutions,Not classified (Exclusively Undergraduate),Majority undergraduate,"Four-year, very small, highly residential",207,207,0,0,0,0,207,0,0,207,0,0,0,0,0,0,0,0,0,0,0,0,NY09
193061,Mesivta of Eastern Parkway-Yeshiva Zichron Meilech, ,510 Dahill Rd,Brooklyn,NY,11218-5559,-73.979327,40.635236,Private not-for-profit,Graduate degree or certificate offering,No,City: Large,Special Focus Two-Year: Other Fields,Not classified (Exclusively Undergraduate),Exclusively undergraduate two-year,"Two-year, very small",2,2,0,0,0,0,2,0,0,2,0,0,0,0,0,0,0,0,0,0,0,0,NY09
193070,Mesivtha Tifereth Jerusalem of America, ,145 E Broadway,New York,NY,10002-6301,-73.991271,40.713812,Private not-for-profit,Graduate degree or certificate offering,No,City: Large,Special Focus Four-Year: Faith-Related Institutions,"Postbaccalaureate: Other-dominant, with Arts & Sciences",Majority undergraduate,"Four-year, very small, highly residential",18,18,0,0,0,0,18,0,0,18,2,2,0,0,0,0,1,1,0,0,0,0,NY10
193247,Mirrer Yeshiva Cent Institute, ,1791-5 Ocean Parkway,Brooklyn,NY,11223-2010,-73.966049,40.605043,Private not-for-profit,Graduate degree or certificate offering,No,City: Large,Special Focus Four-Year: Faith-Related Institutions,Research Doctoral: Single program-Other,High undergraduate,"Four-year, very small, highly residential",25,25,0,1,1,0,25,0,0,25,3,3,0,0,0,0,3,3,0,0,0,0,NY09
193292,Molloy College, ,1000 Hempstead Ave,Rockville Centre,NY,11571-5002,-73.626183,40.685941,Private not-for-profit,Graduate degree or certificate offering,No,Suburb: Large,Master's Colleges & Universities: Larger Programs,Research Doctoral: Professional-dominant,High undergraduate,"Four-year, medium, primarily nonresidential",2572,486,2086,13,5,8,2572,1181,429,962,443,101,342,4,2,2,14,1,13,0,0,0,NY04
193308,Monroe College, ,2501 Jerome Avenue,Bronx,NY,10468,-73.900215,40.864459,Private for-profit,Graduate degree or certificate offering,No,City: Large,Master's Colleges & Universities: Larger Programs,"Postbaccalaureate: Business-dominant, with Arts & Sciences",High undergraduate,"Four-year, medium, primarily nonresidential",1001,289,712,450,148,302,1001,735,243,23,364,117,247,163,65,98,0,0,0,0,0,0,NY13
193353,Mount Saint Mary College,The Mount/Mount Saint Mary College,330 Powell Avenue,Newburgh,NY,12550,-74.012655,41.513872,Private not-for-profit,Graduate degree or certificate offering,No,City: Small,Master's Colleges & Universities: Medium Programs,"Postbaccalaureate: Other-dominant, with other professional programs",Very high undergraduate,"Four-year, small, primarily residential",463,92,371,2,0,2,463,66,254,143,124,31,93,0,0,0,0,0,0,0,0,0,NY18
193399,College of Mount Saint Vincent, ,6301 Riverdale Ave,Bronx,NY,10471-1093,-73.908887,40.913657,Private not-for-profit,Graduate degree or certificate offering,No,City: Large,Baccalaureate Colleges: Diverse Fields,"Postbaccalaureate: Education-dominant, with Arts & Sciences",High undergraduate,"Four-year, small, primarily residential",654,110,544,7,2,5,654,208,372,74,93,15,78,0,0,0,0,0,0,0,0,0,NY15
193405,Icahn School of Medicine at Mount Sinai, ,"One Gustave L Levy Place, Box 1217",New York,NY,10029-6574,-73.952414,40.790359,Private not-for-profit,Graduate degree or certificate offering,No,City: Large,Special Focus Four-Year: Research Institutions,Research Doctoral: STEM-dominant,Exclusively graduate,Exclusively graduate/professional,1329,566,763,145,64,81,1329,0,24,1305,130,44,86,17,7,10,40,19,21,6,2,4,NY13
193584,Nazareth College, ,4245 East Ave,Rochester,NY,14618-3790,-77.518579,43.101576,Private not-for-profit,Graduate degree or certificate offering,No,Suburb: Large,Master's Colleges & Universities: Larger Programs,"Postbaccalaureate: Other-dominant, with Arts & Sciences",High undergraduate,"Four-year, small, highly residential",779,139,640,27,9,18,779,310,439,30,276,34,242,19,7,12,0,0,0,0,0,0,NY25
193654,The New School,New School University; Parsons The New School for Design; New School for Social Research; Eugene Lang College; Mannes College; The New School for Drama; The New School for Jazz and Contemporary Music; The New School for Public Engagement, ,New York,NY,10011,-73.997114,40.735508,Private not-for-profit,Graduate degree or certificate offering,No,City: Large,Doctoral Universities: High Research Activity,"Research Doctoral: Comprehensive programs, no medical/veterinary school",Majority undergraduate,"Four-year, medium, primarily residential",2888,938,1950,1132,323,809,2888,2494,267,127,974,262,712,411,99,312,55,22,33,14,9,5,NY10
193751,Northeast College of Health Sciences, ,2360 State Route 89,Seneca Falls,NY,13148-0800,-76.756232,42.91173,Private not-for-profit,Graduate degree or certificate offering,No,Town: Distant,Special Focus Four-Year: Other Health Professions Schools,Postbaccalaureate: Single program-Other,Exclusively graduate,Exclusively graduate/professional,706,350,356,124,60,64,706,163,306,237,97,36,61,6,3,3,0,0,0,0,0,0,NY24
193821,New York Law School, ,185 West Broadway,New York,NY,10013-2921,-74.006969,40.717998,Private not-for-profit,Graduate degree or certificate offering,No,City: Large,Special Focus Four-Year: Law Schools,Postbaccalaureate: Single program-Other,Exclusively graduate,Exclusively graduate/professional,1090,456,634,37,17,20,1090,0,0,1090,6,5,1,1,1,0,0,0,0,0,0,0,NY10
193830,New York Medical College, ,Administration Building,Valhalla,NY,10595,-73.810042,41.085031,Private not-for-profit,Graduate degree or certificate offering,No,Suburb: Large,Special Focus Four-Year: Medical Schools & Centers,Research Doctoral: STEM-dominant,Exclusively graduate,Exclusively graduate/professional,1714,636,1078,136,44,92,1714,198,247,1269,151,42,109,37,14,23,11,5,6,3,1,2,NY17
193894,New York Theological Seminary,NYTS,475 Riverside Dr  Ste 650,New York,NY,10115-0083,-73.963793,40.810869,Private not-for-profit,Graduate degree or certificate offering,No,City: Large,Special Focus Four-Year: Faith-Related Institutions,Postbaccalaureate: Single program-Other,Exclusively graduate,Exclusively graduate/professional,274,113,161,8,3,5,274,274,0,0,22,8,14,0,0,0,0,0,0,0,0,0,NY13
193900,New York University, ,70 Washington Sq South,New York,NY,10012-1091,-73.997264,40.729452,Private not-for-profit,Graduate degree or certificate offering,No,City: Large,Doctoral Universities: Very High Research Activity,"Research Doctoral: Comprehensive programs, with medical/veterinary school",Majority undergraduate,"Four-year, large, primarily residential",29683,12610,17073,9770,4780,4990,29683,8564,17608,3511,9064,3923,5141,3971,1908,2063,406,217,189,179,113,66,NY10
193973,Niagara University, ,Lewiston Road,Niagara University,NY,14109,-79.036689,43.137279,Private not-for-profit,Graduate degree or certificate offering,No,Suburb: Large,Master's Colleges & Universities: Larger Programs,Research Doctoral: Single program-Other,High undergraduate,"Four-year, medium, highly residential",1131,378,753,265,104,161,1131,654,399,78,372,131,241,96,37,59,5,1,4,1,0,1,NY26
194073,New York College of Podiatric Medicine,The First Institute of Podiatry  Long Island College of Podiatry  New York College of Podiatry  M.J. Lewi College of Podiatry  New York College of Podiatric Medicine,53 East 124 Street,New York,NY,10035-1940,-73.940496,40.805037,Private not-for-profit,Graduate degree or certificate offering,No,City: Large,Special Focus Four-Year: Other Health Professions Schools,Postbaccalaureate: Single program-Other,Exclusively graduate,Exclusively graduate/professional,365,195,170,13,8,5,365,0,0,365,0,0,0,0,0,0,0,0,0,0,0,0,NY13
194091,New York Institute of Technology,New York Tech,Northern Blvd,Old Westbury,NY,11568-8000,-73.6078,40.812447,Private not-for-profit,Graduate degree or certificate offering,No,Suburb: Large,Master's Colleges & Universities: Larger Programs,"Postbaccalaureate: Other-dominant, with Arts & Sciences",Majority undergraduate,"Four-year, medium, primarily nonresidential",3728,1748,1980,583,322,261,3728,283,377,3068,707,335,372,324,184,140,0,0,0,0,0,0,NY03
194116,New York School of Interior Design,"NYSID, NY School of Interior Design",170 East 70th Street,New York,NY,10021,-73.962404,40.768615,Private not-for-profit,Graduate degree or certificate offering,No,City: Large,"Special Focus Four-Year: Arts, Music & Design Schools","Postbaccalaureate: Other-dominant, with Arts & Sciences",Majority undergraduate,"Four-year, very small, primarily nonresidential",172,28,144,44,13,31,172,44,125,3,63,11,52,26,9,17,0,0,0,0,0,0,NY12
194161,Nyack College, ,2 Washington Street,New York,NY,10004,-74.015605,40.705798,Private not-for-profit,Graduate degree or certificate offering,No,City: Large,Master's Colleges & Universities: Larger Programs,"Postbaccalaureate: Other-dominant, with Arts & Sciences",Majority undergraduate,"Four-year, small, primarily residential",1078,422,656,63,37,26,1078,630,267,181,211,74,137,11,2,9,0,0,0,0,0,0,NY10
194310,Pace University,Pace University,1 Pace Plaza,New York,NY,10038-1598,-74.004719,40.711014,Private not-for-profit,Graduate degree or certificate offering,No,City: Large,Doctoral/Professional Universities,Research Doctoral: STEM-dominant,Majority undergraduate,"Four-year, large, primarily residential",6188,2239,3949,877,427,450,6188,3509,1295,1384,1601,593,1008,393,191,202,37,12,25,2,2,0,NY10
194392,Paul Smiths College of Arts and Science,Paul Smith's College,7777 State Route 30,Paul Smiths,NY,12970-0265,-74.252675,44.433965,Private not-for-profit,Graduate degree or certificate offering,No,Rural: Distant,Baccalaureate Colleges: Diverse Fields,Not classified (Exclusively Undergraduate),Very high undergraduate,"Four-year, very small, highly residential",33,19,14,1,0,1,33,13,20,0,0,0,0,0,0,0,0,0,0,0,0,0,NY21
194578,Pratt Institute-Main,Pratt Institute,200 Willoughby Ave,Brooklyn,NY,11205,-73.96431,40.691297,Private not-for-profit,Graduate degree or certificate offering,No,City: Large,"Special Focus Four-Year: Arts, Music & Design Schools","Postbaccalaureate: Other-dominant, with Arts & Sciences",Majority undergraduate,"Four-year, medium, highly residential",1402,368,1034,637,170,467,1402,0,0,1402,627,153,474,339,85,254,0,0,0,0,0,0,NY07
194657,Rabbinical Academy Mesivta Rabbi Chaim Berlin, ,1593 Coney Island Ave,Brooklyn,NY,11230,-73.963702,40.618467,Private not-for-profit,Graduate degree or certificate offering,No,City: Large,Special Focus Four-Year: Faith-Related Institutions,Postbaccalaureate: Single program-Other,Majority graduate,"Four-year, very small, highly residential",228,228,0,0,0,0,228,0,0,228,18,18,0,0,0,0,0,0,0,0,0,0,NY09
194666,Rabbinical College Bobover Yeshiva Bnei Zion, ,1577 48th St,Brooklyn,NY,11219,-73.985026,40.631954,Private not-for-profit,Graduate degree or certificate offering,No,City: Large,Special Focus Four-Year: Faith-Related Institutions,Postbaccalaureate: Single program-Other,Very high undergraduate,"Four-year, very small, primarily residential",40,40,0,0,0,0,40,0,0,40,8,8,0,0,0,0,0,0,0,0,0,0,NY09
194763,Rabbinical Seminary of America, ,76-01 147th St,Flushing,NY,11367,-73.817161,40.72308,Private not-for-profit,Graduate degree or certificate offering,No,City: Large,Special Focus Four-Year: Faith-Related Institutions,Postbaccalaureate: Single program-Other,Majority undergraduate,"Four-year, very small, highly residential",227,227,0,0,0,0,227,0,0,227,23,23,0,0,0,0,0,0,0,0,0,0,NY06
194824,Rensselaer Polytechnic Institute,"RPI, Rensselaer",110 8th St,Troy,NY,12180-3590,-73.676646,42.729978,Private not-for-profit,Graduate degree or certificate offering,No,City: Small,Doctoral Universities: Very High Research Activity,Research Doctoral: STEM-dominant,High undergraduate,"Four-year, medium, highly residential",1321,895,426,598,406,192,1321,0,0,1321,486,317,169,191,112,79,111,73,38,56,37,19,NY20
194958,Roberts Wesleyan College, ,2301 Westside Dr,Rochester,NY,14624,-77.798498,43.125755,Private not-for-profit,Graduate degree or certificate offering,No,Suburb: Large,Master's Colleges & Universities: Larger Programs,"Postbaccalaureate: Education-dominant, with other professional programs",Majority undergraduate,"Four-year, small, highly residential",675,124,551,6,2,4,675,330,272,73,212,41,171,2,1,1,0,0,0,0,0,0,NY25
195003,Rochester Institute of Technology,RIT,1 Lomb Memorial Dr,Rochester,NY,14623-5603,-77.67386,43.084188,Private not-for-profit,Graduate degree or certificate offering,No,Suburb: Large,Doctoral Universities: High Research Activity,Research Doctoral: STEM-dominant,High undergraduate,"Four-year, large, highly residential",3391,2066,1325,1521,980,541,3391,749,1948,694,1146,660,486,510,313,197,51,34,17,27,19,8,NY25
195030,University of Rochester, ,Wilson Blvd. - Wallis Hall,Rochester,NY,14627-0011,-77.631202,43.126397,Private not-for-profit,Graduate degree or certificate offering,No,City: Midsize,Doctoral Universities: Very High Research Activity,"Research Doctoral: Comprehensive programs, with medical/veterinary school",Majority undergraduate,"Four-year, large, primarily nonresidential",6099,2772,3327,1843,988,855,6099,679,2668,2752,1431,618,813,669,289,380,274,149,125,92,64,28,NY25
195049,Rockefeller University, ,1230 York Avenue,New York,NY,10065-6399,-73.955198,40.762489,Private not-for-profit,Graduate degree or certificate offering,No,City: Large,Special Focus Four-Year: Research Institutions,Research Doctoral: Single program-Other,Exclusively graduate,Exclusively graduate/professional,255,142,113,87,51,36,255,0,0,255,3,2,1,2,2,0,33,19,14,11,7,4,NY12
195128,Russell Sage College, ,65 1st Street,Troy,NY,12180,-73.693711,42.72822,Private not-for-profit,Graduate degree or certificate offering,No,City: Small,Doctoral/Professional Universities,Research Doctoral: Professional-dominant,Majority undergraduate,"Four-year, small, highly residential",1343,215,1128,8,0,8,1343,420,676,247,286,42,244,1,0,1,37,11,26,0,0,0,NY20
195155,St Bernard's School of Theology and Ministry,SBSTM,120 French Road,Rochester,NY,14618,-77.526326,43.102185,Private not-for-profit,Graduate degree or certificate offering,No,Suburb: Large,Special Focus Four-Year: Faith-Related Institutions,Postbaccalaureate: Single program-Other,Exclusively graduate,Exclusively graduate/professional,134,97,37,11,11,0,134,0,134,0,22,17,5,1,1,0,0,0,0,0,0,0,NY25
195164,St Bonaventure University,St. Bona/Bonas,3261 W. State Road,Saint Bonaventure,NY,14778-9800,-78.481107,42.080191,Private not-for-profit,Graduate degree or certificate offering,No,Town: Remote,Master's Colleges & Universities: Medium Programs,"Postbaccalaureate: Business-dominant, with other professional programs",High undergraduate,"Four-year, small, highly residential",1020,407,613,18,13,5,1020,813,153,54,204,100,104,4,2,2,0,0,0,0,0,0,NY23
195173,St. Francis College,SFC,180 Remsen Street,Brooklyn Heights,NY,11201-4305,-73.992164,40.693228,Private not-for-profit,Graduate degree or certificate offering,No,City: Large,Baccalaureate Colleges: Diverse Fields,"Postbaccalaureate: Business-dominant, with Arts & Sciences",Very high undergraduate,"Four-year, small, primarily nonresidential",119,59,60,18,7,11,119,81,35,3,62,32,30,5,1,4,0,0,0,0,0,0,NY10
195216,St Lawrence University, ,23 Romoda Drive,Canton,NY,13617,-75.161343,44.589879,Private not-for-profit,Graduate degree or certificate offering,No,Town: Remote,Baccalaureate Colleges: Arts & Sciences Focus,"Postbaccalaureate: Education-dominant, with other professional programs",Very high undergraduate,"Four-year, small, highly residential",47,28,19,4,2,2,47,14,31,2,22,13,9,4,2,2,0,0,0,0,0,0,NY21
195234,The College of Saint Rose, ,432 Western Ave,Albany,NY,12203-1490,-73.786661,42.664297,Private not-for-profit,Graduate degree or certificate offering,No,City: Small,Master's Colleges & Universities: Larger Programs,"Postbaccalaureate: Education-dominant, with Arts & Sciences",Majority undergraduate,"Four-year, medium, highly residential",2173,522,1651,54,30,24,2173,181,608,1384,395,89,306,26,15,11,0,0,0,0,0,0,NY20
195243,St. Thomas Aquinas College,STAC,125 Rte 340,Sparkill,NY,10976-1050,-73.936799,41.041576,Private not-for-profit,Graduate degree or certificate offering,No,Suburb: Large,Master's Colleges & Universities: Small Programs,"Postbaccalaureate: Education-dominant, with other professional programs",Very high undergraduate,"Four-year, small, highly residential",228,75,153,2,1,1,228,7,106,115,72,23,49,0,0,0,0,0,0,0,0,0,NY17
195304,Sarah Lawrence College, ,One Meadway,Bronxville,NY,10708,-73.843727,40.9355,Private not-for-profit,Graduate degree or certificate offering,No,Suburb: Large,Baccalaureate Colleges: Arts & Sciences Focus,"Postbaccalaureate: Other-dominant, with Arts & Sciences",High undergraduate,"Four-year, small, highly residential",218,23,195,30,0,30,218,0,0,218,95,10,85,13,0,13,0,0,0,0,0,0,NY16
195438,Sh'or Yoshuv Rabbinical College, ,1 Cedarlawn Avenue,Lawrence,NY,11559-1714,-73.740085,40.605227,Private not-for-profit,Graduate degree or certificate offering,No,Suburb: Large,Special Focus Four-Year: Faith-Related Institutions,Not classified (Exclusively Undergraduate),Very high undergraduate,"Four-year, very small, highly residential",18,18,0,1,1,0,18,0,0,18,0,0,0,0,0,0,0,0,0,0,0,0,NY04
195474,Siena College, ,515 Loudon Rd,Loudonville,NY,12211-1462,-73.7526,42.717602,Private not-for-profit,Graduate degree or certificate offering,No,Suburb: Large,Master's Colleges & Universities: Small Programs,Postbaccalaureate: Single program-Business,Very high undergraduate,"Four-year, medium, highly residential",151,85,66,4,1,3,151,34,98,19,68,34,34,2,0,2,0,0,0,0,0,0,NY20
195544,St. Joseph's University-New York, ,245 Clinton Ave,Brooklyn,NY,11205-3688,-73.967664,40.690418,Private not-for-profit,Graduate degree or certificate offering,No,City: Large,Master's Colleges & Universities: Larger Programs,"Postbaccalaureate: Education-dominant, with Arts & Sciences",High undergraduate,"Four-year, medium, primarily nonresidential",1376,275,1101,7,2,5,1376,542,540,294,426,99,327,1,0,1,0,0,0,0,0,0,NY07
195580,Saint Vladimirs Orthodox Theological Seminary, ,575 Scarsdale Rd,Yonkers,NY,10707-1699,-73.824358,40.969393,Private not-for-profit,Graduate degree or certificate offering,No,Suburb: Large,Special Focus Four-Year: Faith-Related Institutions,Postbaccalaureate: Single program-Other,Exclusively graduate,Exclusively graduate/professional,94,86,8,9,9,0,94,0,0,94,16,14,2,4,4,0,0,0,0,0,0,0,NY16
195720,Saint John Fisher College,Fisher,3690 East Ave,Rochester,NY,14618-3597,-77.513056,43.116259,Private not-for-profit,Graduate degree or certificate offering,No,Suburb: Large,Doctoral/Professional Universities,Research Doctoral: Single program-Other,High undergraduate,"Four-year, medium, highly residential",1154,313,841,6,4,2,1154,202,677,275,234,69,165,1,1,0,46,16,30,0,0,0,NY25
195809,St. John's University-New York,St. John's University-New York,8000 Utopia Pky,Queens,NY,11439,-73.796104,40.722523,Private not-for-profit,Graduate degree or certificate offering,No,City: Large,Doctoral/Professional Universities,Research Doctoral: Professional-dominant,High undergraduate,"Four-year, large, primarily residential",4812,1722,3090,366,148,218,4812,1692,2655,465,1106,386,720,124,43,81,160,54,106,24,11,13,NY05
196024,SUNY College of Technology at Delhi,SUNY Delhi,454 Delhi Drive,Delhi,NY,13753-1100,-74.924612,42.269859,Public,Graduate degree or certificate offering,No,Town: Remote,Baccalaureate Colleges: Diverse Fields,Postbaccalaureate: Single program-Other,Very high undergraduate,"Four-year, small, highly residential",124,16,108,0,0,0,124,124,0,0,30,5,25,0,0,0,0,0,0,0,0,0,NY19
196042,Farmingdale State College,SUNY College of Technology at Farmingdale,2350 Broadhollow Road,Farmingdale,NY,11735-1021,-73.42832,40.754224,Public,Graduate degree or certificate offering,No,Suburb: Large,Baccalaureate Colleges: Diverse Fields,Postbaccalaureate: Single program-Business,Very high undergraduate,"Four-year, medium, primarily nonresidential",77,62,15,5,4,1,77,75,1,1,25,20,5,3,3,0,0,0,0,0,0,0,NY01
196060,SUNY at Albany,"University at Albany, SUNY",1400 Washington Avenue,Albany,NY,12222,-73.824662,42.685489,Public,Graduate degree or certificate offering,No,City: Small,Doctoral Universities: Very High Research Activity,"Research Doctoral: Comprehensive programs, no medical/veterinary school",High undergraduate,"Four-year, large, highly residential",5139,1829,3310,755,368,387,5139,2372,1797,970,1204,455,749,140,75,65,136,62,74,38,21,17,NY20
196079,Binghamton University,Binghamton University,4400 Vestal Parkway East,Vestal,NY,13850-6000,-75.966889,42.087868,Public,Graduate degree or certificate offering,No,Suburb: Midsize,Doctoral Universities: Very High Research Activity,"Research Doctoral: Comprehensive programs, no medical/veterinary school",High undergraduate,"Four-year, large, primarily residential",4333,2094,2239,1250,772,478,4333,346,2027,1960,1268,674,594,362,245,117,182,99,83,91,59,32,NY19
196088,University at Buffalo,University at Buffalo|UB|State University of New York at Buffalo|SUNY Buffalo|University of Buffalo,12 Capen Hall,Buffalo,NY,14260-1660,-78.789458,43.000942,Public,Graduate degree or certificate offering,No,Suburb: Large,Doctoral Universities: Very High Research Activity,"Research Doctoral: Comprehensive programs, with medical/veterinary school",Majority undergraduate,"Four-year, large, primarily residential",10924,5144,5780,2674,1641,1033,10924,3152,6565,1207,2331,1192,1139,808,529,279,336,188,148,157,98,59,NY26
196097,Stony Brook University,SUNY Stony Brook  State University of New York at Stony Brook,310 Administration Building,Stony Brook,NY,11794-0701,-73.12046,40.91476,Public,Graduate degree or certificate offering,No,Suburb: Large,Doctoral Universities: Very High Research Activity,"Research Doctoral: Comprehensive programs, with medical/veterinary school",Majority undergraduate,"Four-year, large, highly residential",10129,4188,5941,1937,1294,643,10129,3503,6626,0,2480,1034,1446,622,440,182,314,194,120,167,117,50,NY01
196103,SUNY College of Environmental Science and Forestry,ESF,One Forestry Dr.,Syracuse,NY,13210,-76.138724,43.034765,Public,Graduate degree or certificate offering,No,City: Midsize,Doctoral Universities: High Research Activity,Research Doctoral: STEM-dominant,High undergraduate,"Four-year, small, primarily residential",424,188,236,102,48,54,424,27,208,189,58,20,38,10,3,7,25,16,9,13,7,6,NY22
196112,SUNY Polytechnic Institute,SUNY Poly,100 Seymour Rd,Utica,NY,13502,-75.229841,43.137701,Public,Graduate degree or certificate offering,No,Suburb: Midsize,Master's Colleges & Universities: Larger Programs,Research Doctoral: Single program-Other,High undergraduate,"Four-year, small, highly residential",946,406,540,134,86,48,946,791,64,91,281,128,153,68,48,20,8,4,4,2,0,2,NY22
196121,SUNY Brockport,SUNY Brockport,350 New Campus Dr,Brockport,NY,14420-2919,-77.947188,43.211926,Public,Graduate degree or certificate offering,No,Town: Fringe,Master's Colleges & Universities: Larger Programs,Postbaccalaureate: Comprehensive programs,High undergraduate,"Four-year, medium, primarily residential",1760,559,1201,8,3,5,1760,1111,559,90,419,129,290,4,1,3,0,0,0,0,0,0,NY25
196130,SUNY Buffalo State,Buffalo State,1300 Elmwood Ave,Buffalo,NY,14222,-78.882125,42.933832,Public,Graduate degree or certificate offering,No,City: Large,Master's Colleges & Universities: Larger Programs,Postbaccalaureate: Comprehensive programs,Very high undergraduate,"Four-year, medium, primarily residential",1345,377,968,24,10,14,1345,578,689,78,561,136,425,14,5,9,0,0,0,0,0,0,NY26
196149,SUNY Cortland,SUNY Cortland,Miller Building,Cortland,NY,13045-0900,-76.188655,42.598022,Public,Graduate degree or certificate offering,No,Town: Distant,Master's Colleges & Universities: Medium Programs,"Postbaccalaureate: Education-dominant, with Arts & Sciences",Very high undergraduate,"Four-year, medium, highly residential",808,291,517,8,3,5,808,461,275,72,198,85,113,2,1,1,0,0,0,0,0,0,NY19
196158,SUNY at Fredonia, ,280 Central Ave,Fredonia,NY,14063-1136,-79.337375,42.452236,Public,Graduate degree or certificate offering,No,Town: Distant,Master's Colleges & Universities: Small Programs,"Postbaccalaureate: Education-dominant, with Arts & Sciences",Very high undergraduate,"Four-year, medium, highly residential",255,59,196,20,7,13,255,76,154,25,117,24,93,15,3,12,0,0,0,0,0,0,NY23
196167,SUNY College at Geneseo,SUNY Geneseo,1 College Circle,Geneseo,NY,14454-1465,-77.821894,42.796645,Public,Graduate degree or certificate offering,No,Town: Distant,Master's Colleges & Universities: Small Programs,"Postbaccalaureate: Education-dominant, with other professional programs",Very high undergraduate,"Four-year, medium, highly residential",121,22,99,0,0,0,121,100,17,4,56,8,48,0,0,0,0,0,0,0,0,0,NY24
196176,State University of New York at New Paltz,State University of New York at New Paltz,1 Hawk Drive,New Paltz,NY,12561-2443,-74.082188,41.740936,Public,Graduate degree or certificate offering,No,Suburb: Large,Master's Colleges & Universities: Larger Programs,Postbaccalaureate: Comprehensive programs,Very high undergraduate,"Four-year, medium, primarily residential",1142,329,813,141,64,77,1142,718,402,22,365,108,257,28,13,15,0,0,0,0,0,0,NY18
196185,SUNY Oneonta, ,108 Ravine Parkway,Oneonta,NY,13820-4015,-75.063632,42.468861,Public,Graduate degree or certificate offering,No,Town: Remote,Master's Colleges & Universities: Medium Programs,"Postbaccalaureate: Education-dominant, with Arts & Sciences",Very high undergraduate,"Four-year, medium, primarily residential",681,111,570,2,0,2,681,607,62,12,228,26,202,0,0,0,0,0,0,0,0,0,NY19
196194,SUNY College at Oswego,SUNY Oswego,7060 State Route 104,Oswego,NY,13126,-76.540798,43.454287,Public,Graduate degree or certificate offering,No,Town: Distant,Master's Colleges & Universities: Larger Programs,"Postbaccalaureate: Education-dominant, with Arts & Sciences",Very high undergraduate,"Four-year, medium, highly residential",1278,479,799,33,20,13,1278,904,313,61,322,122,200,12,8,4,0,0,0,0,0,0,NY24
196200,SUNY College at Potsdam,SUNY-Potsdam,44 Pierrepont Ave,Potsdam,NY,13676-2294,-74.973815,44.662148,Public,Graduate degree or certificate offering,No,Town: Remote,Master's Colleges & Universities: Medium Programs,"Postbaccalaureate: Education-dominant, with Arts & Sciences",Very high undergraduate,"Four-year, small, highly residential",384,110,274,11,2,9,384,248,131,5,123,39,84,6,2,4,0,0,0,0,0,0,NY21
196219,SUNY at Purchase College,Purchase College,735 Anderson Hill Rd,Purchase,NY,10577-1400,-73.701955,41.047223,Public,Graduate degree or certificate offering,No,Suburb: Large,Baccalaureate Colleges: Arts & Sciences Focus,"Postbaccalaureate: Other-dominant, with Arts & Sciences",Very high undergraduate,"Four-year, medium, highly residential",87,43,44,19,8,11,87,35,50,2,31,16,15,6,2,4,0,0,0,0,0,0,NY16
196228,SUNY College of Optometry,SUNY Optometry  State College of Optometry  SUNY State College of Optometry,33 West 42nd Street,New York,NY,10036-8003,-73.982236,40.754465,Public,Graduate degree or certificate offering,No,City: Large,Special Focus Four-Year: Other Health Professions Schools,Research Doctoral: Single program-Other,Exclusively graduate,Exclusively graduate/professional,403,119,284,33,15,18,403,1,399,3,2,1,1,2,1,1,1,1,0,1,1,0,NY12
196237,SUNY College at Old Westbury, ,223 Store Hill Rd,Old Westbury,NY,11568-0210,-73.571907,40.799021,Public,Graduate degree or certificate offering,No,Suburb: Large,Master's Colleges & Universities: Medium Programs,"Postbaccalaureate: Education-dominant, with Arts & Sciences",Very high undergraduate,"Four-year, medium, primarily nonresidential",422,154,268,4,1,3,422,77,303,42,125,46,79,0,0,0,0,0,0,0,0,0,NY03
196246,SUNY College at Plattsburgh,SUNY Plattsburgh,101 Broad Street,Plattsburgh,NY,12901-2681,-73.466536,44.69293,Public,Graduate degree or certificate offering,No,Town: Distant,Master's Colleges & Universities: Medium Programs,"Postbaccalaureate: Education-dominant, with Arts & Sciences",Very high undergraduate,"Four-year, medium, primarily residential",553,140,413,8,2,6,553,240,258,55,213,50,163,7,2,5,0,0,0,0,0,0,NY21
196255,SUNY Downstate Health Sciences University,SUNY Downstate Health Sciences University,450 Clarkson Ave,Brooklyn,NY,11203-2098,-73.945535,40.653855,Public,Graduate degree or certificate offering,No,City: Large,Special Focus Four-Year: Medical Schools & Centers,Research Doctoral: STEM-dominant,Majority graduate,"Four-year, small, highly residential",2092,717,1375,17,6,11,2092,349,1213,530,251,64,187,1,0,1,4,4,0,2,2,0,NY09
196264,SUNY Empire State College, ,Two Union Ave,Saratoga Springs,NY,12866-4391,-73.782484,43.077283,Public,Graduate degree or certificate offering,No,Suburb: Small,Master's Colleges & Universities: Larger Programs,"Postbaccalaureate: Education-dominant, with Arts & Sciences",High undergraduate,"Four-year, medium, primarily nonresidential",3452,814,2638,12,5,7,3452,3282,135,35,323,88,235,2,0,2,0,0,0,0,0,0,NY20
196291,SUNY Maritime College, ,6 Pennyfield Avenue,Throggs Neck,NY,10465-4198,-73.795309,40.807217,Public,Graduate degree or certificate offering,No,City: Large,Master's Colleges & Universities: Small Programs,"Postbaccalaureate: Business-dominant, with Arts & Sciences",Very high undergraduate,"Four-year, small, highly residential",191,162,29,11,8,3,191,122,65,4,56,51,5,7,6,1,0,0,0,0,0,0,NY14
196307,Upstate Medical University,SUNY Upstate Medical University|Upstate Medical|Upstate|Upstate Medical Center|SUNY Upstate,750 E Adams St,Syracuse,NY,13210,-76.140009,43.041819,Public,Graduate degree or certificate offering,No,City: Midsize,Special Focus Four-Year: Medical Schools & Centers,Research Doctoral: Single program-Other,Majority graduate,"Four-year, small, primarily residential",1390,524,866,65,23,42,1390,81,702,607,163,42,121,4,1,3,15,12,3,3,2,1,NY22
196413,Syracuse University, ,900 South Crouse Ave.,Syracuse,NY,13244,-76.136975,43.040176,Private not-for-profit,Graduate degree or certificate offering,No,City: Midsize,Doctoral Universities: Very High Research Activity,"Research Doctoral: Comprehensive programs, no medical/veterinary school",Majority undergraduate,"Four-year, large, highly residential",8847,4371,4476,2005,1143,862,8847,3541,3779,1527,2698,1405,1293,844,503,341,143,76,67,65,39,26,NY22
196468,Teachers College at Columbia University,Teachers College,525 W 120th St,New York,NY,10027,-73.960194,40.810216,Private not-for-profit,Graduate degree or certificate offering,No,City: Large,Doctoral Universities: High Research Activity,"Research Doctoral: Comprehensive programs, no medical/veterinary school",Exclusively graduate,Exclusively graduate/professional,5963,1340,4623,1316,239,1077,5963,4081,1848,34,1727,339,1388,509,72,437,185,57,128,37,11,26,NY13
196592,Touro College, ,50 West 47th Street,New York,NY,10036,-73.980813,40.757267,Private not-for-profit,Graduate degree or certificate offering,No,City: Large,Doctoral/Professional Universities,Postbaccalaureate: Comprehensive programs,Majority graduate,"Four-year, medium, primarily nonresidential",7358,2106,5252,232,105,127,7358,2510,3746,1102,1476,316,1160,39,25,14,0,0,0,0,0,0,NY12
196680,Excelsior College, ,7 Columbia Cir,Albany,NY,12203-5159,-73.862981,42.705487,Private not-for-profit,Graduate degree or certificate offering,No,City: Small,Master's Colleges & Universities: Larger Programs,Postbaccalaureate: Comprehensive programs,High undergraduate,"Four-year, medium, primarily nonresidential",2680,1494,1186,4,3,1,2680,2680,0,0,546,342,204,0,0,0,0,0,0,0,0,0,NY20
196884,Union Theological Seminary in the City of New York,Union Theological Seminary,3041 Broadway,New York,NY,10027-5792,-73.961549,40.811823,Private not-for-profit,Graduate degree or certificate offering,No,City: Large,Special Focus Four-Year: Faith-Related Institutions,Research Doctoral: Single program-Other,Exclusively graduate,Exclusively graduate/professional,245,101,144,31,14,17,245,245,0,0,88,41,47,15,9,6,3,2,1,0,0,0,NY13
197018,United Talmudical Seminary, ,191 Rodney St.,Brooklyn,NY,11211,-73.959113,40.705687,Private not-for-profit,Graduate degree or certificate offering,No,City: Large,Special Focus Four-Year: Faith-Related Institutions,Not classified (Exclusively Undergraduate),Majority undergraduate,"Four-year, medium, primarily nonresidential",955,955,0,0,0,0,955,0,0,955,0,0,0,0,0,0,0,0,0,0,0,0,NY07
197027,United States Merchant Marine Academy,USMMA|Kings Point,300 Steamboat Road,Kings Point,NY,11024-1634,-73.763004,40.81357,Public,Graduate degree or certificate offering,No,Suburb: Large,Baccalaureate Colleges: Diverse Fields,Postbaccalaureate: Single program-Other,Very high undergraduate,"Four-year, small, highly residential",16,13,3,0,0,0,16,16,0,0,2,2,0,0,0,0,0,0,0,0,0,0,NY03
197045,Utica University,Utica,1600 Burrstone Rd,Utica,NY,13502-4892,-75.272916,43.096213,Private not-for-profit,Graduate degree or certificate offering,No,City: Small,Master's Colleges & Universities: Larger Programs,"Postbaccalaureate: Other-dominant, with Arts & Sciences",High undergraduate,"Four-year, medium, primarily residential",2112,807,1305,8,5,3,2112,1514,261,337,463,206,257,2,2,0,0,0,0,0,0,0,NY22
197151,School of Visual Arts,"SVA, School of Visual Arts",209 E 23rd St,New York,NY,10010,-73.982359,40.738809,Private for-profit,Graduate degree or certificate offering,No,City: Large,Master's Colleges & Universities: Larger Programs,"Postbaccalaureate: Other-dominant, with Arts & Sciences",High undergraduate,"Four-year, medium, primarily residential",542,155,387,322,96,226,542,0,0,542,311,90,221,181,52,129,0,0,0,0,0,0,NY12
197197,Wagner College, ,One Campus Rd,Staten Island,NY,10301-4495,-74.092913,40.615588,Private not-for-profit,Graduate degree or certificate offering,No,City: Large,Master's Colleges & Universities: Medium Programs,"Postbaccalaureate: Other-dominant, with Arts & Sciences",High undergraduate,"Four-year, small, highly residential",453,121,332,20,9,11,453,0,0,453,168,45,123,5,2,3,0,0,0,0,0,0,NY11
197647,Yeshiva Derech Chaim, ,1573 39th Street,Brooklyn,NY,11218-0000,-73.979757,40.636889,Private not-for-profit,Graduate degree or certificate offering,No,City: Large,Special Focus Four-Year: Faith-Related Institutions,Research Doctoral: Single program-Other,Majority undergraduate,"Four-year, very small, highly residential",36,36,0,2,2,0,36,0,0,36,0,0,0,0,0,0,0,0,0,0,0,0,NY09
197674,Yeshiva of Nitra Rabbinical College, ,1425 Route 17 M,Chester,NY,10918,-74.255911,41.353674,Private not-for-profit,Graduate degree or certificate offering,No,Rural: Fringe,Special Focus Four-Year: Faith-Related Institutions,Not classified (Exclusively Undergraduate),High undergraduate,"Four-year, very small, highly residential",25,25,0,1,1,0,25,0,0,25,0,0,0,0,0,0,0,0,0,0,0,0,NY18
197692,Yeshiva Shaar Hatorah, ,117-06 84 Ave,Kew Gardens,NY,11418,-73.834252,40.703795,Private not-for-profit,Graduate degree or certificate offering,No,City: Large,Special Focus Four-Year: Faith-Related Institutions,Not classified (Exclusively Undergraduate),High undergraduate,"Four-year, very small, highly residential",28,28,0,0,0,0,28,0,0,28,0,0,0,0,0,0,0,0,0,0,0,0,NY05
197708,Yeshiva University, ,500 W 185th St,New York,NY,10033-3299,-73.929873,40.850605,Private not-for-profit,Graduate degree or certificate offering,No,City: Large,Doctoral/Professional Universities,Research Doctoral: Professional-dominant,Majority undergraduate,"Four-year, medium, highly residential",3226,1111,2115,299,109,190,3226,573,1845,808,548,148,400,94,38,56,71,13,58,6,3,3,NY13
197735,Yeshivath Viznitz, ,15 Elyon Road,Monsey,NY,10952,-74.070243,41.114682,Private not-for-profit,No graduate offering,No,Suburb: Large,Special Focus Four-Year: Faith-Related Institutions,Not classified (Exclusively Undergraduate),High undergraduate,"Four-year, very small, highly residential",216,216,0,4,4,0,216,0,0,216,0,0,0,0,0,0,0,0,0,0,0,0,NY17
197744,Yeshivath Zichron Moshe, ,Laurel Park Road,South Fallsburg,NY,12779,-74.621823,41.73048,Private not-for-profit,No graduate offering,No,Town: Distant,Special Focus Four-Year: Faith-Related Institutions,Not classified (Exclusively Undergraduate),High undergraduate,"Four-year, very small, highly residential",58,58,0,0,0,0,58,0,0,58,0,0,0,0,0,0,0,0,0,0,0,0,NY19
197869,Appalachian State University,Appalachian State University,287 Rivers St,Boone,NC,28608,-81.680583,36.215536,Public,Graduate degree or certificate offering,No,Town: Distant,Master's Colleges & Universities: Larger Programs,Research Doctoral: Single program-Education,Very high undergraduate,"Four-year, large, primarily residential",2335,673,1662,30,14,16,2335,1209,988,138,654,217,437,14,8,6,12,5,7,0,0,0,NC05
197911,Barton College, ,200 E. ACC Drive,Wilson,NC,27893-7000,-77.913867,35.734376,Private not-for-profit,Graduate degree or certificate offering,No,Town: Fringe,Baccalaureate Colleges: Diverse Fields,"Postbaccalaureate: Business-dominant, with other professional programs",Very high undergraduate,"Four-year, small, highly residential",92,25,67,6,2,4,92,15,49,28,46,13,33,6,2,4,0,0,0,0,0,0,NC01
198109,Cabarrus College of Health Sciences, ,401 Medical Park Drive,Concord,NC,28025-3959,-80.600824,35.440038,Private not-for-profit,Graduate degree or certificate offering,No,City: Midsize,Special Focus Four-Year: Other Health Professions Schools,Postbaccalaureate: Single program-Other,High undergraduate,"Four-year, very small, primarily nonresidential",107,8,99,0,0,0,107,35,72,0,21,2,19,0,0,0,0,0,0,0,0,0,NC12
198136,Campbell University, ,143 Main Street,Buies Creek,NC,27506,-78.738238,35.409149,Private not-for-profit,Graduate degree or certificate offering,No,Town: Fringe,Doctoral/Professional Universities,"Postbaccalaureate: Other-dominant, with Arts & Sciences",Majority undergraduate,"Four-year, medium, primarily residential",2437,964,1473,23,9,14,2437,105,671,1661,261,99,162,7,6,1,0,0,0,0,0,0,NC13
198215,Catawba College, ,2300 W Innes St,Salisbury,NC,28144,-80.482751,35.691443,Private not-for-profit,Graduate degree or certificate offering,No,Suburb: Midsize,Baccalaureate Colleges: Diverse Fields,Not classified (Exclusively Undergraduate),Very high undergraduate,"Four-year, small, highly residential",39,19,20,0,0,0,39,30,0,9,0,0,0,0,0,0,0,0,0,0,0,0,NC08
198303,Chowan University, ,One University Place,Murfreesboro,NC,27855,-77.099141,36.436258,Private not-for-profit,Graduate degree or certificate offering,No,Town: Distant,Baccalaureate Colleges: Diverse Fields,Not classified (Exclusively Undergraduate),Exclusively undergraduate four-year,"Four-year, small, highly residential",13,5,8,1,0,1,13,13,0,0,0,0,0,0,0,0,0,0,0,0,0,0,NC01
198419,Duke University, ,103 Allen Bldg,Durham,NC,27708,-78.937624,36.001135,Private not-for-profit,Graduate degree or certificate offering,No,City: Large,Doctoral Universities: Very High Research Activity,"Research Doctoral: Comprehensive programs, with medical/veterinary school",Majority graduate,"Four-year, large, highly residential",11100,5091,6009,2784,1561,1223,11100,2022,6874,2204,2856,1358,1498,969,519,450,380,234,146,147,106,41,NC04
198464,East Carolina University,ECU,East 5th Street,Greenville,NC,27858-4353,-77.368291,35.607186,Public,Graduate degree or certificate offering,No,City: Small,Doctoral Universities: High Research Activity,Research Doctoral: Professional-dominant,High undergraduate,"Four-year, large, primarily residential",6742,2197,4545,102,59,43,6742,4625,1170,947,1343,441,902,22,12,10,93,36,57,5,2,3,NC01
198507,Elizabeth City State University,ECSU,1704 Weeksville Rd,Elizabeth City,NC,27909,-76.214041,36.277978,Public,Graduate degree or certificate offering,Yes,Town: Distant,Baccalaureate Colleges: Diverse Fields,"Postbaccalaureate: Education-dominant, with Arts & Sciences",Very high undergraduate,"Four-year, small, highly residential",110,27,83,0,0,0,110,66,39,5,20,8,12,0,0,0,0,0,0,0,0,0,NC01
198516,Elon University, ,100 Campus Drive,Elon,NC,27244-2010,-79.50344,36.104148,Private not-for-profit,Graduate degree or certificate offering,No,Suburb: Midsize,Doctoral/Professional Universities,"Postbaccalaureate: Other-dominant, with Arts & Sciences",High undergraduate,"Four-year, medium, highly residential",984,350,634,11,4,7,984,0,0,984,153,54,99,6,3,3,0,0,0,0,0,0,NC04
198543,Fayetteville State University, ,1200 Murchison Rd,Fayetteville,NC,28301-4298,-78.891696,35.073641,Public,Graduate degree or certificate offering,Yes,City: Midsize,Master's Colleges & Universities: Medium Programs,Research Doctoral: Single program-Education,High undergraduate,"Four-year, medium, primarily residential",1498,511,987,27,13,14,1498,1162,268,68,252,79,173,7,4,3,7,3,4,0,0,0,NC09
198561,Gardner-Webb University,GWU,Main St,Boiling Springs,NC,28017-0997,-81.668141,35.24732,Private not-for-profit,Graduate degree or certificate offering,No,Town: Distant,Doctoral/Professional Universities,Research Doctoral: Professional-dominant,Majority undergraduate,"Four-year, small, highly residential",1778,546,1232,4,1,3,1778,890,124,764,397,130,267,2,0,2,98,16,82,0,0,0,NC10
198598,Greensboro College, ,815 W Market St,Greensboro,NC,27401-1875,-79.800232,36.071082,Private not-for-profit,Graduate degree or certificate offering,No,City: Large,Master's Colleges & Universities: Small Programs,Postbaccalaureate: Single program-Education,High undergraduate,"Four-year, very small, highly residential",196,43,153,0,0,0,196,0,196,0,71,16,55,0,0,0,0,0,0,0,0,0,NC06
198613,Guilford College, ,5800 W Friendly Avenue,Greensboro,NC,27410-4108,-79.887737,36.094233,Private not-for-profit,Graduate degree or certificate offering,No,City: Large,Baccalaureate Colleges: Arts & Sciences Focus,Postbaccalaureate: Single program-Other,Very high undergraduate,"Four-year, small, highly residential",10,1,9,0,0,0,10,0,10,0,2,2,0,0,0,0,0,0,0,0,0,0,NC06
198695,High Point University,HPU,One University Parkway,High Point,NC,27268,-79.994675,35.972035,Private not-for-profit,Graduate degree or certificate offering,No,City: Midsize,Baccalaureate Colleges: Diverse Fields,Research Doctoral: Single program-Education,High undergraduate,"Four-year, medium, highly residential",1117,369,748,8,1,7,1117,71,158,888,142,44,98,2,0,2,15,1,14,0,0,0,NC06
198756,Johnson C Smith University,JCSU,100 Beatties Ford Road,Charlotte,NC,28216-5398,-80.857251,35.243033,Private not-for-profit,Graduate degree or certificate offering,Yes,City: Large,Baccalaureate Colleges: Arts & Sciences Focus,Postbaccalaureate: Single program-Other,Very high undergraduate,"Four-year, small, highly residential",61,8,53,0,0,0,61,0,0,61,40,2,38,0,0,0,0,0,0,0,0,0,NC12
198808,Lees-McRae College, ,191 Main Street,Banner Elk,NC,28604,-81.873371,36.162477,Private not-for-profit,Graduate degree or certificate offering,No,Rural: Distant,Baccalaureate Colleges: Diverse Fields,Not classified (Exclusively Undergraduate),Very high undergraduate,"Four-year, very small, highly residential",2,2,0,1,1,0,2,0,0,2,1,1,0,1,1,0,0,0,0,0,0,0,NC05
198835,Lenoir-Rhyne University, ,625 7th Avenue NE,Hickory,NC,28601,-81.327598,35.739968,Private not-for-profit,Graduate degree or certificate offering,No,City: Small,Master's Colleges & Universities: Larger Programs,"Postbaccalaureate: Other-dominant, with Arts & Sciences",Majority undergraduate,"Four-year, small, highly residential",1020,223,797,22,10,12,1020,370,118,532,279,72,207,10,5,5,0,0,0,0,0,0,NC10
198899,Mars Hill University, ,100 Athletic St,Mars Hill,NC,28754,-82.551827,35.82752,Private not-for-profit,Graduate degree or certificate offering,No,Suburb: Large,Baccalaureate Colleges: Diverse Fields,"Postbaccalaureate: Other-dominant, with other professional programs",Very high undergraduate,"Four-year, very small, highly residential",34,15,19,2,0,2,34,13,20,1,22,9,13,2,0,2,0,0,0,0,0,0,NC11
198950,Meredith College,Meredith|Meridith,3800 Hillsborough St,Raleigh,NC,27607-5298,-78.689995,35.799351,Private not-for-profit,Graduate degree or certificate offering,No,City: Large,Baccalaureate Colleges: Arts & Sciences Focus,"Postbaccalaureate: Other-dominant, with Arts & Sciences",High undergraduate,"Four-year, small, highly residential",296,29,267,8,1,7,296,0,0,296,74,5,69,1,0,1,0,0,0,0,0,0,NC02
198969,Methodist University,Methodist,5400 Ramsey St,Fayetteville,NC,28311-1420,-78.874426,35.135058,Private not-for-profit,Graduate degree or certificate offering,No,City: Midsize,Master's Colleges & Universities: Small Programs,"Postbaccalaureate: Other-dominant, with other professional programs",High undergraduate,"Four-year, small, highly residential",362,106,256,2,0,2,362,4,93,265,43,15,28,0,0,0,0,0,0,0,0,0,NC07
199032,Montreat College, ,310 Gaither Circle,Montreat,NC,28757-1267,-82.2976,35.646577,Private not-for-profit,Graduate degree or certificate offering,No,Suburb: Large,Baccalaureate Colleges: Diverse Fields,"Postbaccalaureate: Business-dominant, with other professional programs",High undergraduate,"Four-year, very small, highly residential",183,52,131,1,1,0,183,93,90,0,47,10,37,1,1,0,0,0,0,0,0,0,NC11
199069,University of Mount Olive, ,634 Henderson St,Mount Olive,NC,28365-0919,-78.069388,35.208166,Private not-for-profit,Graduate degree or certificate offering,No,Town: Fringe,Master's Colleges & Universities: Small Programs,"Postbaccalaureate: Business-dominant, with other professional programs",Very high undergraduate,"Four-year, small, primarily residential",319,78,241,2,1,1,319,319,0,0,92,28,64,0,0,0,0,0,0,0,0,0,NC13
199102,North Carolina A & T State University,NCAT,1601 E Market  St,Greensboro,NC,27411,-79.773375,36.07282,Public,Graduate degree or certificate offering,Yes,City: Large,Doctoral Universities: High Research Activity,Research Doctoral: STEM-dominant,High undergraduate,"Four-year, large, highly residential",1920,746,1174,279,181,98,1920,861,773,286,372,145,227,45,32,13,62,33,29,24,15,9,NC06
199111,University of North Carolina at Asheville, ,One University Heights,Asheville,NC,28804-8510,-82.565392,35.617068,Public,Graduate degree or certificate offering,No,City: Small,Baccalaureate Colleges: Arts & Sciences Focus,Postbaccalaureate: Single program-Other,Very high undergraduate,"Four-year, small, highly residential",6,1,5,0,0,0,6,2,1,3,9,2,7,0,0,0,0,0,0,0,0,0,NC11
199120,University of North Carolina at Chapel Hill, ,103 South Bldg Cb 9100,Chapel Hill,NC,27599,-79.050969,35.911769,Public,Graduate degree or certificate offering,No,City: Small,Doctoral Universities: Very High Research Activity,"Research Doctoral: Comprehensive programs, with medical/veterinary school",Majority undergraduate,"Four-year, large, highly residential",12352,5238,7114,1119,569,550,12352,6332,4444,1576,2304,1025,1279,208,111,97,446,203,243,81,47,34,NC04
199139,University of North Carolina at Charlotte,UNC Charlotte,9201 University City Blvd,Charlotte,NC,28223-0001,-80.730919,35.306022,Public,Graduate degree or certificate offering,No,City: Large,Doctoral Universities: High Research Activity,Research Doctoral: STEM-dominant,High undergraduate,"Four-year, large, primarily residential",7506,2906,4600,1327,814,513,7506,3554,3397,555,1712,777,935,470,300,170,159,70,89,64,42,22,NC12
199148,University of North Carolina at Greensboro,UNCG,1400 Spring Garden St,Greensboro,NC,27402-6170,-79.809414,36.068236,Public,Graduate degree or certificate offering,No,City: Large,Doctoral Universities: High Research Activity,"Research Doctoral: Comprehensive programs, no medical/veterinary school",High undergraduate,"Four-year, large, primarily residential",4352,1280,3072,339,142,197,4352,2275,1694,383,891,259,632,88,39,49,122,39,83,22,8,14,NC06
199157,North Carolina Central University, ,1801 Fayetteville Street,Durham,NC,27707,-78.898602,35.974237,Public,Graduate degree or certificate offering,Yes,City: Large,Master's Colleges & Universities: Larger Programs,Research Doctoral: Single program-Other,High undergraduate,"Four-year, medium, highly residential",2254,570,1684,20,7,13,2254,770,679,805,486,114,372,9,4,5,1,0,1,0,0,0,NC04
199184,University of North Carolina School of the Arts,UNCSA,1533 South Main St.,Winston Salem,NC,27127-2738,-80.235672,36.076183,Public,Graduate degree or certificate offering,No,City: Midsize,"Special Focus Four-Year: Arts, Music & Design Schools",Postbaccalaureate: Single program-Other,High undergraduate,"Four-year, small, highly residential",152,67,85,14,5,9,152,0,100,52,57,23,34,6,2,4,0,0,0,0,0,0,NC05
199193,North Carolina State University at Raleigh,NC State University | NC State | N C State University | N C State | NCSU,2101 Hillsborough Street,Raleigh,NC,27695-7001,-78.674517,35.785111,Public,Graduate degree or certificate offering,No,City: Large,Doctoral Universities: Very High Research Activity,"Research Doctoral: Comprehensive programs, with medical/veterinary school",High undergraduate,"Four-year, large, primarily residential",11436,5644,5792,2734,1709,1025,11436,4497,5633,1306,2893,1559,1334,960,627,333,530,306,224,212,143,69,NC02
199209,North Carolina Wesleyan College, ,3400 N Wesleyan Blvd,Rocky Mount,NC,27804,-77.773982,36.019665,Private not-for-profit,Graduate degree or certificate offering,No,City: Small,Baccalaureate Colleges: Diverse Fields,"Postbaccalaureate: Other-dominant, with other professional programs",Very high undergraduate,"Four-year, small, highly residential",198,55,143,0,0,0,198,198,0,0,63,19,44,0,0,0,0,0,0,0,0,0,NC01
199218,University of North Carolina Wilmington,UNCW|University of North Carolina at Wilmington|UNC Wilmington|UNC W|University of NC at Wilmington|Univ of NC-Wilmington|UNC-W|University of North Carolina Wilmington|,601 South College Road,Wilmington,NC,28403-5963,-77.875527,34.225223,Public,Graduate degree or certificate offering,No,City: Midsize,Doctoral Universities: High Research Activity,Research Doctoral: Professional-dominant,High undergraduate,"Four-year, large, primarily residential",4045,1210,2835,78,41,37,4045,2978,944,123,1137,356,781,27,19,8,21,6,15,0,0,0,NC07
199281,University of North Carolina at Pembroke,UNCP,One University Drive,Pembroke,NC,28372-1510,-79.200347,34.688313,Public,Graduate degree or certificate offering,No,Town: Distant,Master's Colleges & Universities: Larger Programs,"Postbaccalaureate: Education-dominant, with other professional programs",High undergraduate,"Four-year, medium, primarily residential",2597,849,1748,15,9,6,2597,2129,449,19,527,158,369,4,1,3,0,0,0,0,0,0,NC07
199306,Pfeiffer University, ,48380 US Hwy 52N,Misenheimer,NC,28109-0960,-80.283168,35.484696,Private not-for-profit,Graduate degree or certificate offering,No,Rural: Distant,Master's Colleges & Universities: Medium Programs,"Postbaccalaureate: Other-dominant, with Arts & Sciences",High undergraduate,"Four-year, very small, highly residential",460,136,324,12,5,7,460,303,0,157,143,44,99,6,4,2,0,0,0,0,0,0,NC08
199412,Queens University of Charlotte,Queens,1900 Selwyn Ave,Charlotte,NC,28274-0001,-80.833509,35.189051,Private not-for-profit,Graduate degree or certificate offering,No,City: Large,Master's Colleges & Universities: Larger Programs,"Postbaccalaureate: Other-dominant, with Arts & Sciences",High undergraduate,"Four-year, small, highly residential",910,245,665,33,21,12,910,780,127,3,332,94,238,11,5,6,0,0,0,0,0,0,NC14
199607,Salem College, ,601 S Church St,Winston-Salem,NC,27101,-80.241297,36.086271,Private not-for-profit,Graduate degree or certificate offering,No,City: Midsize,Baccalaureate Colleges: Arts & Sciences Focus,"Postbaccalaureate: Education-dominant, with Arts & Sciences",High undergraduate,"Four-year, very small, highly residential",169,16,153,0,0,0,169,163,0,6,30,0,30,0,0,0,0,0,0,0,0,0,NC05
199643,Shaw University, ,118 East South Street,Raleigh,NC,27601,-78.637693,35.771181,Private not-for-profit,Graduate degree or certificate offering,Yes,City: Large,Baccalaureate Colleges: Diverse Fields,"Postbaccalaureate: Other-dominant, with other professional programs",Very high undergraduate,"Four-year, small, highly residential",165,86,79,3,1,2,165,8,130,27,26,14,12,0,0,0,0,0,0,0,0,0,NC13
199698,St. Andrews University,SAU,1700 Dogwood Mile,Laurinburg,NC,28352,-79.478567,34.74563,Private not-for-profit,Graduate degree or certificate offering,No,Town: Distant,Baccalaureate Colleges: Diverse Fields,Postbaccalaureate: Single program-Business,Very high undergraduate,"Four-year, very small, highly residential",40,14,26,3,2,1,40,40,0,0,12,6,6,1,1,0,0,0,0,0,0,0,NC09
199759,Southeastern Baptist Theological Seminary,SEBTS,120 S. Wingate Street,Wake Forest,NC,27587-1889,-78.513755,35.981858,Private not-for-profit,Graduate degree or certificate offering,No,Suburb: Large,Doctoral/Professional Universities,Research Doctoral: Professional-dominant,Majority graduate,"Four-year, small, primarily residential",2974,2261,713,16,15,1,2974,1007,713,1254,470,373,97,4,4,0,31,26,5,0,0,0,NC02
199847,Wake Forest University, ,1834 Wake Forest Road,Winston-Salem,NC,27106,-80.277446,36.133609,Private not-for-profit,Graduate degree or certificate offering,No,City: Midsize,Doctoral Universities: High Research Activity,Research Doctoral: STEM-dominant,Majority undergraduate,"Four-year, medium, highly residential",3958,1757,2201,330,145,185,3958,301,2058,1599,1023,488,535,140,63,77,51,29,22,9,6,3,NC05
199865,Warren Wilson College,"Warren Wilson, WWC",701 Warren Wilson Rd,Swannanoa,NC,28778-2099,-82.442619,35.610328,Private not-for-profit,Graduate degree or certificate offering,No,Suburb: Large,Baccalaureate Colleges: Arts & Sciences Focus,Postbaccalaureate: Single program-Other,High undergraduate,"Four-year, very small, highly residential",99,26,73,0,0,0,99,99,0,0,35,11,24,0,0,0,0,0,0,0,0,0,NC11
199962,Wingate University, ,301 E. Wilson Street,Wingate,NC,28174-0159,-80.44305,34.986064,Private not-for-profit,Graduate degree or certificate offering,No,Suburb: Large,Doctoral/Professional Universities,Research Doctoral: Professional-dominant,High undergraduate,"Four-year, medium, highly residential",1051,353,698,18,12,6,1051,193,858,0,143,53,90,1,1,0,65,32,33,0,0,0,NC08
199971,Carolina Christian College, ,4209 Indiana Avenue,Winston Salem,NC,27105,-80.256252,36.146168,Private not-for-profit,Graduate degree or certificate offering,No,City: Midsize,Special Focus Four-Year: Faith-Related Institutions,Not classified (Exclusively Undergraduate),High undergraduate,"Four-year, very small, primarily residential",18,7,11,0,0,0,18,0,18,0,4,3,1,0,0,0,0,0,0,0,0,0,NC05
199999,Winston-Salem State University,WSSU,601 Martin Luther King Jr Dr,Winston-Salem,NC,27110-0001,-80.225033,36.089554,Public,Graduate degree or certificate offering,Yes,City: Midsize,Doctoral/Professional Universities,"Postbaccalaureate: Other-dominant, with Arts & Sciences",Very high undergraduate,"Four-year, medium, highly residential",587,140,447,34,19,15,587,272,306,9,105,31,74,3,1,2,0,0,0,0,0,0,NC05
200004,Western Carolina University,Western,Highway 107,Cullowhee,NC,28723-9646,-83.186258,35.308979,Public,Graduate degree or certificate offering,No,Town: Distant,Doctoral/Professional Universities,Research Doctoral: Single program-Education,High undergraduate,"Four-year, large, primarily residential",2083,670,1413,95,27,68,2083,1072,888,123,544,160,384,24,4,20,16,1,15,0,0,0,NC11
200013,Rasmussen University-North Dakota, ,4012 19th Avenue SW,Fargo,ND,58103-7196,-96.848937,46.848362,Private for-profit,Graduate degree or certificate offering,No,City: Midsize,Baccalaureate/Associate's Colleges: Mixed Baccalaureate/Associate's,Postbaccalaureate: Single program-Other,Very high undergraduate,"Four-year, very small, primarily nonresidential",28,6,22,0,0,0,28,28,0,0,7,1,6,0,0,0,0,0,0,0,0,0,ND00
200059,Dickinson State University,DSU,291 Campus Drive,Dickinson,ND,58601-4896,-102.799679,46.882917,Public,Graduate degree or certificate offering,No,Town: Remote,Baccalaureate Colleges: Diverse Fields,Postbaccalaureate: Single program-Education,Very high undergraduate,"Four-year, small, primarily nonresidential",69,39,30,1,0,1,69,68,0,1,11,4,7,1,0,1,0,0,0,0,0,0,ND00
200156,University of Jamestown,UJ Jimmies,608 6th St NE,Jamestown,ND,58405,-98.698416,46.914302,Private not-for-profit,Graduate degree or certificate offering,No,Town: Remote,Master's Colleges & Universities: Small Programs,"Postbaccalaureate: Other-dominant, with other professional programs",High undergraduate,"Four-year, small, highly residential",302,101,201,7,4,3,302,194,12,96,49,12,37,0,0,0,0,0,0,0,0,0,ND00
200217,University of Mary,UMary/Marauders,7500 University Dr,Bismarck,ND,58504,-100.75274,46.723767,Private not-for-profit,Graduate degree or certificate offering,No,Rural: Fringe,Doctoral/Professional Universities,Research Doctoral: Single program-Education,Majority undergraduate,"Four-year, small, highly residential",1908,631,1277,4,3,1,1908,1177,591,140,385,154,231,1,1,0,3,1,2,0,0,0,ND00
200226,Mayville State University, ,330 Third Street NE,Mayville,ND,58257-1299,-97.322554,47.505415,Public,Graduate degree or certificate offering,No,Rural: Remote,Baccalaureate Colleges: Diverse Fields,Postbaccalaureate: Single program-Education,Very high undergraduate,"Four-year, very small, primarily residential",34,10,24,0,0,0,34,34,0,0,12,7,5,0,0,0,0,0,0,0,0,0,ND00
200253,Minot State University,MSU,500 University Ave W,Minot,ND,58707,-101.29861,48.246961,Public,Graduate degree or certificate offering,No,Town: Remote,Master's Colleges & Universities: Medium Programs,"Postbaccalaureate: Business-dominant, with other professional programs",Very high undergraduate,"Four-year, small, primarily residential",362,108,254,89,32,57,362,256,71,35,112,46,66,28,11,17,0,0,0,0,0,0,ND00
200280,University of North Dakota, ,"264 Centennial Drive, Stop 8193",Grand Forks,ND,58202-8193,-97.071738,47.921654,Public,Graduate degree or certificate offering,No,City: Small,Doctoral Universities: High Research Activity,"Research Doctoral: Comprehensive programs, with medical/veterinary school",High undergraduate,"Four-year, large, primarily residential",4592,1697,2895,464,268,196,4592,2623,735,1234,795,253,542,57,29,28,71,32,39,21,13,8,ND00
200332,North Dakota State University-Main Campus,"North Dakota State University, NDSU",1301  12th Avenue North,Fargo,ND,58108-6050,-96.800838,46.893127,Public,Graduate degree or certificate offering,No,City: Midsize,Doctoral Universities: Very High Research Activity,"Research Doctoral: Comprehensive programs, no medical/veterinary school",High undergraduate,"Four-year, large, highly residential",2745,1302,1443,632,398,234,2745,393,309,2043,440,220,220,76,51,25,126,60,66,48,33,15,ND00
200466,Sitting Bull College, ,9299 Hwy 24,Fort Yates,ND,58538-9721,-100.674735,46.085288,Public,Graduate degree or certificate offering,No,Rural: Remote,Tribal Colleges,Postbaccalaureate: Single program-Other,Very high undergraduate,"Four-year, very small, primarily residential",28,5,23,0,0,0,28,0,18,10,6,2,4,0,0,0,0,0,0,0,0,0,ND00
200484,Trinity Bible College and Graduate School, ,50 6th Ave S,Ellendale,ND,58436-7105,-98.517906,46.001037,Private not-for-profit,Graduate degree or certificate offering,No,Rural: Remote,Special Focus Four-Year: Faith-Related Institutions,Postbaccalaureate: Single program-Other,Majority undergraduate,"Four-year, very small, highly residential",111,87,24,3,3,0,111,57,0,54,16,11,5,0,0,0,0,0,0,0,0,0,ND00
200572,Valley City State University,VCSU,101 College St SW,Valley City,ND,58072,-98.00389,46.918517,Public,Graduate degree or certificate offering,No,Town: Remote,Baccalaureate Colleges: Diverse Fields,Postbaccalaureate: Single program-Education,Very high undergraduate,"Four-year, very small, primarily residential",194,57,137,1,0,1,194,192,2,0,36,9,27,0,0,0,0,0,0,0,0,0,ND00
200697,Air Force Institute of Technology-Graduate School of Engineering & Management,AFIT,2950 Hobson Way,Wright-Patterson AFB,OH,45433-7765,-84.082618,39.782221,Public,Graduate degree or certificate offering,No,Suburb: Large,Doctoral Universities: High Research Activity,Research Doctoral: STEM-dominant,Exclusively graduate,Exclusively graduate/professional,1558,1271,287,15,15,0,1558,724,415,419,324,281,43,9,9,0,26,25,1,0,0,0,OH10
200800,University of Akron Main Campus, ,302 Buchtel Common,Akron,OH,44325-4702,-81.511679,41.078551,Public,Graduate degree or certificate offering,No,City: Midsize,Doctoral Universities: High Research Activity,"Research Doctoral: Comprehensive programs, no medical/veterinary school",High undergraduate,"Four-year, large, primarily nonresidential",3044,1321,1723,448,314,134,3044,962,1673,409,678,272,406,103,64,39,130,74,56,65,48,17,OH13
201061,Art Academy of Cincinnati,AAC,1212 Jackson Street,Cincinnati,OH,45202-1706,-84.513913,39.108805,Private not-for-profit,Graduate degree or certificate offering,No,City: Large,"Special Focus Four-Year: Arts, Music & Design Schools",Postbaccalaureate: Single program-Education,Very high undergraduate,"Four-year, very small, primarily residential",8,2,6,0,0,0,8,8,0,0,5,2,3,0,0,0,0,0,0,0,0,0,OH01
201104,Ashland University, ,401 College Avenue,Ashland,OH,44805,-82.321061,40.861755,Private not-for-profit,Graduate degree or certificate offering,No,Town: Fringe,Master's Colleges & Universities: Larger Programs,Research Doctoral: Single program-Education,Majority undergraduate,"Four-year, medium, highly residential",1850,770,1080,130,69,61,1850,1362,218,270,547,243,304,51,26,25,9,4,5,0,0,0,OH04
201140,Athenaeum of Ohio,Mount St. Mary's Seminary & School of Theology,6616 Beechmont Ave,Cincinnati,OH,45230-2091,-84.371927,39.082926,Private not-for-profit,Graduate degree or certificate offering,No,City: Large,Special Focus Four-Year: Faith-Related Institutions,"Postbaccalaureate: Other-dominant, with Arts & Sciences",Majority graduate,Exclusively graduate/professional,135,114,21,10,10,0,135,2,9,124,24,21,3,1,1,0,0,0,0,0,0,0,OH01
201195,Baldwin Wallace University,Baldwin Wallace  Baldwin-Wallace College  Baldwin-Wallace,275 Eastland Rd,Berea,OH,44017-2088,-81.851145,41.373017,Private not-for-profit,Graduate degree or certificate offering,No,Suburb: Large,Master's Colleges & Universities: Larger Programs,"Postbaccalaureate: Business-dominant, with Arts & Sciences",High undergraduate,"Four-year, medium, highly residential",815,245,570,5,3,2,815,243,315,257,244,77,167,2,1,1,0,0,0,0,0,0,OH07
201371,Bluffton University, ,1 University Drive,Bluffton,OH,45817-2104,-83.899439,40.895606,Private not-for-profit,Graduate degree or certificate offering,No,Town: Distant,Baccalaureate Colleges: Diverse Fields,"Postbaccalaureate: Other-dominant, with other professional programs",Very high undergraduate,"Four-year, very small, highly residential",89,28,61,1,1,0,89,59,4,26,34,11,23,1,1,0,0,0,0,0,0,0,OH04
201441,Bowling Green State University-Main Campus,BGSU,220 McFall Ctr,Bowling Green,OH,43403,-83.640896,41.375513,Public,Graduate degree or certificate offering,No,Town: Fringe,Doctoral Universities: High Research Activity,"Research Doctoral: Comprehensive programs, no medical/veterinary school",High undergraduate,"Four-year, large, primarily residential",4275,1600,2675,402,226,176,4275,2154,1026,1095,963,359,604,99,63,36,72,31,41,21,9,12,OH05
201548,Capital University, ,1 College and Main,Columbus,OH,43209-2394,-82.937867,39.954875,Private not-for-profit,Graduate degree or certificate offering,No,Suburb: Large,Master's Colleges & Universities: Larger Programs,"Postbaccalaureate: Other-dominant, with other professional programs",High undergraduate,"Four-year, small, highly residential",1157,492,665,27,12,15,1157,694,463,0,86,32,54,4,2,2,0,0,0,0,0,0,OH03
201645,Case Western Reserve University,CWRU|Case|Case Western Reserve,10900 Euclid Ave,Cleveland,OH,44106,-81.609596,41.507419,Private not-for-profit,Graduate degree or certificate offering,No,City: Large,Doctoral Universities: Very High Research Activity,"Research Doctoral: Comprehensive programs, with medical/veterinary school",Majority graduate,"Four-year, large, highly residential",6410,2858,3552,1539,873,666,6410,499,1295,4616,1596,640,956,496,258,238,216,126,90,99,64,35,OH11
201654,Cedarville University, ,251 N. Main Street,Cedarville,OH,45314-0601,-83.814692,39.749237,Private not-for-profit,Graduate degree or certificate offering,No,Town: Fringe,Master's Colleges & Universities: Medium Programs,"Postbaccalaureate: Other-dominant, with other professional programs",Very high undergraduate,"Four-year, medium, highly residential",520,220,300,7,1,6,520,274,102,144,91,39,52,1,0,1,0,0,0,0,0,0,OH10
201885,University of Cincinnati-Main Campus, ,2624 Clifton Avenue,Cincinnati,OH,45221-0063,-84.51428,39.131159,Public,Graduate degree or certificate offering,No,City: Large,Doctoral Universities: Very High Research Activity,"Research Doctoral: Comprehensive programs, with medical/veterinary school",High undergraduate,"Four-year, large, primarily residential",13748,4947,8801,2185,1220,965,13748,7649,4496,1603,3108,1182,1926,645,368,277,225,104,121,93,54,39,OH01
201964,Ohio Christian University,OCU,1476 Lancaster Pike,Circleville,OH,43113-9487,-82.904885,39.613155,Private not-for-profit,Graduate degree or certificate offering,No,Town: Distant,Master's Colleges & Universities: Medium Programs,"Postbaccalaureate: Business-dominant, with other professional programs",High undergraduate,"Four-year, small, primarily nonresidential",269,127,142,2,2,0,269,267,0,2,130,67,63,2,2,0,0,0,0,0,0,0,OH02
202073,Cleveland Institute of Music,CIM,11021 East Blvd,Cleveland,OH,44106-1776,-81.608878,41.512444,Private not-for-profit,Graduate degree or certificate offering,No,City: Large,"Special Focus Four-Year: Arts, Music & Design Schools",Postbaccalaureate: Single program-Other,Majority undergraduate,"Four-year, very small, highly residential",108,51,57,36,13,23,108,0,108,0,40,18,22,15,6,9,0,0,0,0,0,0,OH11
202134,Cleveland State University, ,2121 Euclid Avenue,Cleveland,OH,44115-2214,-81.674355,41.502281,Public,Graduate degree or certificate offering,No,City: Large,Doctoral Universities: High Research Activity,Research Doctoral: STEM-dominant,High undergraduate,"Four-year, large, primarily nonresidential",5218,2153,3065,922,600,322,5218,598,1910,2710,1117,410,707,141,85,56,42,20,22,13,8,5,OH11
202170,Columbus College of Art and Design,CCAD,60 Cleveland Ave.,Columbus,OH,43215,-82.989479,39.966074,Private not-for-profit,Graduate degree or certificate offering,No,City: Large,"Special Focus Four-Year: Arts, Music & Design Schools",Postbaccalaureate: Single program-Other,Very high undergraduate,"Four-year, very small, primarily residential",28,7,21,6,1,5,28,26,2,0,14,3,11,4,0,4,0,0,0,0,0,0,OH03
202480,University of Dayton, ,300 College Park,Dayton,OH,45469,-84.176113,39.739547,Private not-for-profit,Graduate degree or certificate offering,No,City: Midsize,Doctoral Universities: High Research Activity,Research Doctoral: STEM-dominant,High undergraduate,"Four-year, large, highly residential",3949,1939,2010,880,604,276,3949,1580,2017,352,1034,583,451,384,262,122,25,16,9,8,6,2,OH10
202514,Defiance College, ,701 N Clinton St.,Defiance,OH,43512,-84.357075,41.296842,Private not-for-profit,Graduate degree or certificate offering,No,Town: Distant,Baccalaureate Colleges: Diverse Fields,"Postbaccalaureate: Business-dominant, with other professional programs",Very high undergraduate,"Four-year, very small, highly residential",73,36,37,0,0,0,73,73,0,0,11,7,4,0,0,0,0,0,0,0,0,0,OH09
202763,The University of Findlay, ,1000 North Main Street,Findlay,OH,45840-3653,-83.652313,41.053344,Private not-for-profit,Graduate degree or certificate offering,No,Town: Distant,Doctoral/Professional Universities,Research Doctoral: Single program-Education,Majority undergraduate,"Four-year, small, highly residential",1391,529,862,54,23,31,1391,557,454,380,288,119,169,26,12,14,13,4,9,0,0,0,OH05
202806,Franklin University, ,201 S Grant Ave,Columbus,OH,43215-5399,-82.990375,39.95831,Private not-for-profit,Graduate degree or certificate offering,No,City: Large,Master's Colleges & Universities: Larger Programs,Research Doctoral: Professional-dominant,Majority undergraduate,"Four-year, medium, primarily nonresidential",2761,1022,1739,68,33,35,2761,2761,0,0,638,253,385,23,11,12,19,7,12,0,0,0,OH03
202903,Gods Bible School and College, ,1810 Young Street,Cincinnati,OH,45202-6838,-84.505703,39.1153,Private not-for-profit,Graduate degree or certificate offering,No,City: Large,Baccalaureate Colleges: Diverse Fields,Postbaccalaureate: Single program-Other,Very high undergraduate,"Four-year, very small, primarily residential",32,26,6,1,0,1,32,32,0,0,4,4,0,0,0,0,0,0,0,0,0,0,OH01
203067,Hebrew Union College-Jewish Institute of Religion,HUC-JIR,One W 4th St,New York,NY,10012-1186,-73.994499,40.728938,Private not-for-profit,Graduate degree or certificate offering,No,City: Large,Special Focus Four-Year: Faith-Related Institutions,Research Doctoral: Single program-Other,Exclusively graduate,Exclusively graduate/professional,430,159,271,8,4,4,430,430,0,0,82,20,62,0,0,0,7,6,1,1,1,0,NY10
203085,Heidelberg University,Heidelburg College|Hiedelberg College|Hiedelburg College|Heidleberg College|Heidleburg College|The 'Berg|Heidelberg University|Hiedelberg University|Heidelburg University,310 E Market St,Tiffin,OH,44883-2462,-83.168387,41.114833,Private not-for-profit,Graduate degree or certificate offering,No,Town: Distant,Master's Colleges & Universities: Small Programs,"Postbaccalaureate: Business-dominant, with other professional programs",High undergraduate,"Four-year, small, highly residential",273,84,189,4,3,1,273,92,136,45,73,31,42,2,2,0,0,0,0,0,0,0,OH05
203128,Hiram College,Hiram, ,Hiram,OH,44234-0067,-81.143981,41.3107,Private not-for-profit,Graduate degree or certificate offering,No,Town: Fringe,Baccalaureate Colleges: Diverse Fields,Postbaccalaureate: Single program-Other,Very high undergraduate,"Four-year, very small, highly residential",21,11,10,0,0,0,21,16,5,0,2,0,2,0,0,0,0,0,0,0,0,0,OH14
203368,John Carroll University,JCU,1 John Carroll Boulevard,University Heights,OH,44118-4538,-81.531338,41.491321,Private not-for-profit,Graduate degree or certificate offering,No,Suburb: Large,Master's Colleges & Universities: Larger Programs,Postbaccalaureate: Comprehensive programs,High undergraduate,"Four-year, medium, highly residential",688,239,449,40,22,18,688,194,322,172,186,74,112,9,4,5,0,0,0,0,0,0,OH11
203465,Kent State University at Stark, ,6000 Frank Ave NW,North Canton,OH,44720-7599,-81.43731,40.868568,Public,Graduate degree or certificate offering,No,Suburb: Large,Baccalaureate/Associate's Colleges: Associate's Dominant,Not classified (Exclusively Undergraduate),Very high undergraduate,"Four-year, small, primarily nonresidential",22,10,12,1,0,1,22,10,0,12,0,0,0,0,0,0,0,0,0,0,0,0,OH13
203517,Kent State University at Kent, ,"Executive Office, 2nd Floor Library",Kent,OH,44242-0001,-81.342533,41.146653,Public,Graduate degree or certificate offering,No,Suburb: Large,Doctoral Universities: Very High Research Activity,"Research Doctoral: Comprehensive programs, no medical/veterinary school",High undergraduate,"Four-year, large, primarily residential",6797,2223,4574,773,369,404,6797,3018,2505,1274,1467,450,1017,168,80,88,134,50,84,53,25,28,OH14
203544,Kettering College, ,3737 Southern Blvd,Kettering,OH,45429-1299,-84.192006,39.695052,Private not-for-profit,Graduate degree or certificate offering,No,City: Small,Special Focus Four-Year: Other Health Professions Schools,Postbaccalaureate: Single program-Other,Majority undergraduate,"Four-year, very small, primarily nonresidential",316,59,257,3,1,2,316,0,247,69,57,12,45,1,1,0,0,0,0,0,0,0,OH10
203580,Lake Erie College,LEC,391 W Washington St,Painesville,OH,44077-3389,-81.251817,41.717841,Private not-for-profit,Graduate degree or certificate offering,No,Suburb: Large,Master's Colleges & Universities: Small Programs,"Postbaccalaureate: Business-dominant, with other professional programs",High undergraduate,"Four-year, very small, highly residential",290,113,177,4,3,1,290,154,109,27,97,45,52,2,2,0,0,0,0,0,0,0,OH14
203757,Lourdes University, ,6832 Convent Blvd,Sylvania,OH,43560-2898,-83.706108,41.710009,Private not-for-profit,Graduate degree or certificate offering,No,Suburb: Large,Master's Colleges & Universities: Small Programs,"Postbaccalaureate: Other-dominant, with other professional programs",High undergraduate,"Four-year, small, highly residential",250,83,167,0,0,0,250,115,53,82,49,11,38,0,0,0,0,0,0,0,0,0,OH09
203775,Malone University, ,2600 Cleveland Avenue NW,Canton,OH,44709-3308,-81.376863,40.825662,Private not-for-profit,Graduate degree or certificate offering,No,City: Small,Master's Colleges & Universities: Medium Programs,"Postbaccalaureate: Business-dominant, with other professional programs",High undergraduate,"Four-year, small, highly residential",532,127,405,1,1,0,532,217,204,111,133,46,87,0,0,0,0,0,0,0,0,0,OH13
203845,Marietta College, ,Irvine Bldg,Marietta,OH,45750,-81.450045,39.41668,Private not-for-profit,Graduate degree or certificate offering,No,Town: Fringe,Baccalaureate Colleges: Diverse Fields,"Postbaccalaureate: Other-dominant, with Arts & Sciences",Very high undergraduate,"Four-year, small, highly residential",165,32,133,0,0,0,165,0,0,165,37,7,30,0,0,0,0,0,0,0,0,0,OH06
203960,Mercy College of Ohio,Mercy College,2221 Madison Avenue,Toledo,OH,43604-1132,-83.552538,41.658319,Private not-for-profit,Graduate degree or certificate offering,No,City: Large,Special Focus Four-Year: Other Health Professions Schools,Postbaccalaureate: Single program-Other,Very high undergraduate,"Four-year, very small, primarily nonresidential",92,10,82,0,0,0,92,92,0,0,33,7,26,0,0,0,0,0,0,0,0,0,OH09
203997,Methodist Theological School in Ohio,MTSO,3081 Columbus Pike,Delaware,OH,43015-3211,-83.060146,40.253643,Private not-for-profit,Graduate degree or certificate offering,No,Suburb: Large,Special Focus Four-Year: Faith-Related Institutions,Postbaccalaureate: Single program-Other,Exclusively graduate,Exclusively graduate/professional,155,61,94,1,1,0,155,127,28,0,38,16,22,1,1,0,0,0,0,0,0,0,OH04
204024,Miami University-Oxford,Miami of Ohio,501 East High St,Oxford,OH,45056,-84.732954,39.507757,Public,Graduate degree or certificate offering,No,Town: Fringe,Doctoral Universities: High Research Activity,"Research Doctoral: Comprehensive programs, no medical/veterinary school",Very high undergraduate,"Four-year, large, primarily residential",2990,866,2124,254,128,126,2990,260,2373,357,881,295,586,89,46,43,69,19,50,13,4,9,OH08
204176,Mount Carmel College of Nursing, ,127 So.  Davis Ave,Columbus,OH,43222-1504,-83.021501,39.956625,Private not-for-profit,Graduate degree or certificate offering,No,City: Large,Special Focus Four-Year: Other Health Professions Schools,Postbaccalaureate: Single program-Other,High undergraduate,"Four-year, very small, primarily nonresidential",228,29,199,0,0,0,228,208,20,0,71,7,64,0,0,0,0,0,0,0,0,0,OH15
204185,University of Mount Union, ,1972 Clark Ave.,Alliance,OH,44601-3929,-81.111029,40.905256,Private not-for-profit,Graduate degree or certificate offering,No,Town: Fringe,Master's Colleges & Universities: Small Programs,"Postbaccalaureate: Other-dominant, with other professional programs",Very high undergraduate,"Four-year, small, highly residential",278,105,173,0,0,0,278,74,39,165,59,21,38,0,0,0,0,0,0,0,0,0,OH06
204194,Mount Vernon Nazarene University,MVNU,800 Martinsburg Rd,Mount Vernon,OH,43050-9500,-82.471074,40.372901,Private not-for-profit,Graduate degree or certificate offering,No,Town: Distant,Master's Colleges & Universities: Medium Programs,"Postbaccalaureate: Business-dominant, with Arts & Sciences",High undergraduate,"Four-year, small, highly residential",671,234,437,2,0,2,671,671,0,0,159,67,92,0,0,0,0,0,0,0,0,0,OH12
204200,Mount Saint Joseph University,"Mount St. Joseph University, Mount St. Joe, Mount, The Mount,Mount St. Joseph University on the Ohio.",5701 Delhi Rd,Cincinnati,OH,45233-1670,-84.639453,39.095893,Private not-for-profit,Graduate degree or certificate offering,No,Suburb: Large,Doctoral/Professional Universities,"Postbaccalaureate: Other-dominant, with Arts & Sciences",Majority undergraduate,"Four-year, small, primarily residential",744,156,588,0,0,0,744,139,125,480,212,47,165,0,0,0,0,0,0,0,0,0,OH01
204264,Muskingum University,Muskingum,10 College Drive,New Concord,OH,43762,-81.737127,39.996585,Private not-for-profit,Graduate degree or certificate offering,No,Town: Distant,Master's Colleges & Universities: Small Programs,"Postbaccalaureate: Education-dominant, with other professional programs",High undergraduate,"Four-year, small, highly residential",1188,252,936,1,1,0,1188,870,105,213,96,29,67,1,1,0,0,0,0,0,0,0,OH12
204468,Notre Dame College, ,4545 College Rd,Cleveland,OH,44121-4293,-81.516617,41.506894,Private not-for-profit,Graduate degree or certificate offering,No,Suburb: Large,Baccalaureate Colleges: Diverse Fields,"Postbaccalaureate: Education-dominant, with other professional programs",Very high undergraduate,"Four-year, small, primarily residential",169,50,119,1,0,1,169,150,10,9,44,7,37,0,0,0,0,0,0,0,0,0,OH11
204477,Northeast Ohio Medical University,NEOMED,4209 State Route 44,Rootstown,OH,44272-0095,-81.245302,41.102919,Public,Graduate degree or certificate offering,No,Suburb: Large,Special Focus Four-Year: Medical Schools & Centers,Research Doctoral: Single program-Other,Exclusively graduate,Exclusively graduate/professional,991,446,545,0,0,0,991,7,211,773,35,14,21,0,0,0,2,0,2,0,0,0,OH14
204486,University of Northwestern Ohio, ,1441 N Cable Rd,Lima,OH,45805,-84.157004,40.762917,Private not-for-profit,Graduate degree or certificate offering,No,Suburb: Small,Baccalaureate/Associate's Colleges: Mixed Baccalaureate/Associate's,Postbaccalaureate: Single program-Business,Very high undergraduate,"Four-year, small, highly residential",77,26,51,0,0,0,77,77,0,0,32,10,22,0,0,0,0,0,0,0,0,0,OH04
204501,Oberlin College, ,70 N Professor St,Oberlin,OH,44074,-82.216795,41.291992,Private not-for-profit,Graduate degree or certificate offering,No,Town: Fringe,Baccalaureate Colleges: Arts & Sciences Focus,Postbaccalaureate: Single program-Other,Very high undergraduate,"Four-year, small, highly residential",19,12,7,15,8,7,19,0,0,19,1,1,0,1,1,0,0,0,0,0,0,0,OH05
204617,Ohio Dominican University,ODU,1216 Sunbury Road,Columbus,OH,43219,-82.940689,39.992764,Private not-for-profit,Graduate degree or certificate offering,No,City: Large,Master's Colleges & Universities: Medium Programs,"Postbaccalaureate: Business-dominant, with Arts & Sciences",High undergraduate,"Four-year, small, highly residential",569,183,386,20,7,13,569,202,0,367,187,67,120,14,6,8,0,0,0,0,0,0,OH03
204635,Ohio Northern University,Northern|ONU,525 S. Main St,Ada,OH,45810-1599,-83.827441,40.7662,Private not-for-profit,Graduate degree or certificate offering,No,Town: Fringe,Baccalaureate Colleges: Diverse Fields,"Postbaccalaureate: Other-dominant, with other professional programs",Majority undergraduate,"Four-year, small, highly residential",692,288,404,43,16,27,692,0,330,362,17,11,6,0,0,0,0,0,0,0,0,0,OH04
204671,Ohio State University-Lima Campus, ,4240 Campus Dr,Lima,OH,45804,-84.02384,40.738521,Public,No graduate offering,No,Rural: Fringe,Baccalaureate Colleges: Diverse Fields,Not classified (Exclusively Undergraduate),Very high undergraduate,"Four-year, very small, primarily nonresidential",17,0,17,0,0,0,17,15,2,0,0,0,0,0,0,0,0,0,0,0,0,0,OH04
204680,Ohio State University-Mansfield Campus, ,1760 University Drive,Mansfield,OH,44906,-82.580194,40.796536,Public,No graduate offering,No,Rural: Fringe,Baccalaureate/Associate's Colleges: Mixed Baccalaureate/Associate's,Not classified (Exclusively Undergraduate),Very high undergraduate,"Four-year, very small, primarily nonresidential",5,2,3,0,0,0,5,4,1,0,0,0,0,0,0,0,0,0,0,0,0,0,OH04
204699,Ohio State University-Marion Campus, ,1461 Mount Vernon Ave,Marion,OH,43302-5695,-83.090597,40.577779,Public,No graduate offering,No,Town: Distant,Baccalaureate/Associate's Colleges: Mixed Baccalaureate/Associate's,Not classified (Exclusively Undergraduate),Very high undergraduate,"Four-year, very small, primarily nonresidential",10,0,10,0,0,0,10,10,0,0,0,0,0,0,0,0,0,0,0,0,0,0,OH04
204705,Ohio State University-Newark Campus, ,1179 University Dr,Newark,OH,43055,-82.447441,40.069314,Public,No graduate offering,No,Suburb: Small,Baccalaureate/Associate's Colleges: Mixed Baccalaureate/Associate's,Not classified (Exclusively Undergraduate),Very high undergraduate,"Four-year, small, primarily nonresidential",9,3,6,1,1,0,9,6,2,1,0,0,0,0,0,0,0,0,0,0,0,0,OH12
204796,Ohio State University-Main Campus, ,190 N. Oval Mall,Columbus,OH,43210,-83.014853,39.999324,Public,Graduate degree or certificate offering,No,City: Large,Doctoral Universities: Very High Research Activity,"Research Doctoral: Comprehensive programs, with medical/veterinary school",High undergraduate,"Four-year, large, primarily residential",16077,6813,9264,2692,1594,1098,16077,4336,10415,1326,2828,1149,1679,478,285,193,900,427,473,283,171,112,OH03
204857,Ohio University-Main Campus, ,020 Chubb Hall,Athens,OH,45701-2979,-82.100985,39.326798,Public,Graduate degree or certificate offering,No,Town: Distant,Doctoral Universities: Very High Research Activity,"Research Doctoral: Comprehensive programs, with medical/veterinary school",High undergraduate,"Four-year, large, primarily residential",7961,3393,4568,737,399,338,7961,4661,1267,2033,2031,945,1086,202,98,104,128,67,61,62,31,31,OH12
204936,Otterbein University, ,1 South Grove Street,Westerville,OH,43081,-82.936444,40.125327,Private not-for-profit,Graduate degree or certificate offering,No,Suburb: Large,Master's Colleges & Universities: Medium Programs,"Postbaccalaureate: Other-dominant, with other professional programs",Very high undergraduate,"Four-year, small, highly residential",612,175,437,1,0,1,612,100,315,197,130,43,87,0,0,0,0,0,0,0,0,0,OH03
204990,Payne Theological Seminary, ,1230 Wilberforce-Clifton Rd.,Wilberforce,OH,45384,-83.884871,39.715286,Private not-for-profit,Graduate degree or certificate offering,No,Rural: Fringe,Special Focus Four-Year: Faith-Related Institutions,Postbaccalaureate: Single program-Other,Exclusively graduate,Exclusively graduate/professional,230,127,103,4,3,1,230,227,0,3,22,11,11,1,1,0,0,0,0,0,0,0,OH10
205027,Pontifical College Josephinum, ,7625 N High Street,Columbus,OH,43235-1499,-83.018829,40.120735,Private not-for-profit,Graduate degree or certificate offering,No,City: Large,Baccalaureate Colleges: Arts & Sciences Focus,Postbaccalaureate: Single program-Other,Majority undergraduate,"Four-year, very small, highly residential",53,50,3,6,6,0,53,29,0,24,8,8,0,2,2,0,0,0,0,0,0,0,OH03
205124,Rabbinical College Telshe,Telshe Yeshiva,28400 Euclid Ave,Wickliffe,OH,44092,-81.485261,41.593533,Private not-for-profit,Graduate degree or certificate offering,No,Suburb: Large,Special Focus Four-Year: Faith-Related Institutions,Postbaccalaureate: Single program-Other,Majority undergraduate,"Four-year, very small, highly residential",21,21,0,0,0,0,21,0,0,21,2,2,0,0,0,0,0,0,0,0,0,0,OH14
205203,University of Rio Grande,University of Rio Grande and Rio Grande Community College,218 N College Ave,Rio Grande,OH,45674,-82.378852,38.881764,Private not-for-profit,Graduate degree or certificate offering,No,Rural: Distant,Baccalaureate/Associate's Colleges: Mixed Baccalaureate/Associate's,Postbaccalaureate: Single program-Education,Very high undergraduate,"Four-year, very small, primarily residential",28,15,13,1,1,0,28,14,1,13,6,4,2,1,1,0,0,0,0,0,0,0,OH02
205443,Shawnee State University, ,940  Second  Street,Portsmouth,OH,45662,-82.993769,38.730867,Public,Graduate degree or certificate offering,No,Town: Fringe,Master's Colleges & Universities: Small Programs,"Postbaccalaureate: Other-dominant, with Arts & Sciences",Very high undergraduate,"Four-year, small, primarily residential",271,76,195,0,0,0,271,146,41,84,53,12,41,0,0,0,0,0,0,0,0,0,OH02
205957,Franciscan University of Steubenville,Franciscan|Steubenville,1235 University Blvd,Steubenville,OH,43952-1763,-80.620524,40.376919,Private not-for-profit,Graduate degree or certificate offering,No,City: Small,Master's Colleges & Universities: Medium Programs,"Postbaccalaureate: Other-dominant, with Arts & Sciences",High undergraduate,"Four-year, small, highly residential",1214,517,697,78,46,32,1214,948,81,185,217,99,118,19,12,7,0,0,0,0,0,0,OH06
206048,Tiffin University, ,155 Miami Street,Tiffin,OH,44883,-83.184197,41.118316,Private not-for-profit,Graduate degree or certificate offering,No,Town: Distant,Master's Colleges & Universities: Larger Programs,Postbaccalaureate: Comprehensive programs,High undergraduate,"Four-year, small, highly residential",1078,413,665,49,23,26,1078,821,204,53,323,119,204,12,6,6,0,0,0,0,0,0,OH05
206084,University of Toledo, ,2801 W Bancroft,Toledo,OH,43606-3390,-83.614714,41.660572,Public,Graduate degree or certificate offering,No,City: Large,Doctoral Universities: High Research Activity,"Research Doctoral: Comprehensive programs, with medical/veterinary school",High undergraduate,"Four-year, large, primarily residential",4267,1752,2515,623,362,261,4267,580,2259,1428,972,418,554,240,141,99,114,47,67,49,25,24,OH09
206154,Tri-State Bible College,TSBC Tri State Bible College TriState Bible College,506 Margaret St,South Point,OH,45680,-82.579887,38.426238,Private not-for-profit,Graduate degree or certificate offering,No,Suburb: Midsize,Special Focus Four-Year: Faith-Related Institutions,Not classified (Exclusively Undergraduate),Very high undergraduate,"Four-year, very small, primarily nonresidential",6,5,1,0,0,0,6,0,0,6,0,0,0,0,0,0,0,0,0,0,0,0,OH02
206279,Union Institute & University,"Union, UI&U",2090 Florence Avenue,Cincinnati,OH,45206,-84.497652,39.119091,Private not-for-profit,Graduate degree or certificate offering,No,City: Large,Master's Colleges & Universities: Small Programs,Research Doctoral: Single program-Other,Majority undergraduate,"Four-year, very small, primarily nonresidential",333,98,235,0,0,0,333,156,22,155,48,17,31,0,0,0,9,3,6,0,0,0,OH01
206288,United Theological Seminary, ,4501 Denlinger Rd.,Dayton,OH,45426-2308,-84.276913,39.813423,Private not-for-profit,Graduate degree or certificate offering,No,Suburb: Large,Special Focus Four-Year: Faith-Related Institutions,Postbaccalaureate: Single program-Other,Exclusively graduate,Exclusively graduate/professional,488,299,189,19,16,3,488,67,201,220,60,41,19,4,3,1,0,0,0,0,0,0,OH10
206349,Ursuline College, ,2550 Lander Rd,Pepper Pike,OH,44124,-81.465118,41.497035,Private not-for-profit,Graduate degree or certificate offering,No,Suburb: Large,Master's Colleges & Universities: Medium Programs,"Postbaccalaureate: Other-dominant, with Arts & Sciences",Majority undergraduate,"Four-year, very small, primarily residential",648,86,562,8,1,7,648,43,278,327,105,15,90,0,0,0,0,0,0,0,0,0,OH11
206437,Walsh University, ,2020 East Maple St,North Canton,OH,44720-3396,-81.369931,40.873908,Private not-for-profit,Graduate degree or certificate offering,No,Suburb: Large,Doctoral/Professional Universities,"Postbaccalaureate: Other-dominant, with other professional programs",High undergraduate,"Four-year, small, highly residential",1149,231,918,14,5,9,1149,638,408,103,232,63,169,8,3,5,0,0,0,0,0,0,OH13
206491,Wilberforce University, ,1055 N Bickett Rd,Wilberforce,OH,45384-1001,-83.880595,39.707291,Private not-for-profit,Graduate degree or certificate offering,Yes,Rural: Fringe,nan,nan,nan,nan,18,9,9,0,0,0,18,0,0,18,4,0,4,0,0,0,0,0,0,0,0,0,OH10
206516,Winebrenner Theological Seminary, ,950 North Main Street - 2nd Floor,Findlay,OH,45840,-83.650711,41.052464,Private not-for-profit,Graduate degree or certificate offering,No,Town: Distant,Special Focus Four-Year: Faith-Related Institutions,"Postbaccalaureate: Other-dominant, with other professional programs",Exclusively graduate,Exclusively graduate/professional,115,59,56,0,0,0,115,15,81,19,13,7,6,0,0,0,0,0,0,0,0,0,OH05
206525,Wittenberg University, ,Ward St at N Wittenberg Ave,Springfield,OH,45504,-83.815445,39.934029,Private not-for-profit,Graduate degree or certificate offering,No,City: Small,Baccalaureate Colleges: Arts & Sciences Focus,"Postbaccalaureate: Business-dominant, with Arts & Sciences",Very high undergraduate,"Four-year, small, highly residential",57,35,22,0,0,0,57,16,32,9,22,13,9,0,0,0,0,0,0,0,0,0,OH10
206604,Wright State University-Main Campus, ,3640 Colonel Glenn Highway,Dayton,OH,45435-0001,-84.064881,39.780634,Public,Graduate degree or certificate offering,No,Suburb: Large,Doctoral Universities: High Research Activity,Research Doctoral: STEM-dominant,High undergraduate,"Four-year, medium, primarily residential",3251,1439,1812,432,216,216,3251,1156,1258,837,785,357,428,133,67,66,44,26,18,17,9,8,OH10
206613,Wright State University-Lake Campus, ,7600 Lake Campus Drive,Celina,OH,45822-2952,-84.509194,40.546074,Public,No graduate offering,No,Rural: Fringe,Baccalaureate Colleges: Diverse Fields,Not classified (Exclusively Undergraduate),Very high undergraduate,"Four-year, very small, primarily nonresidential",15,5,10,2,2,0,15,4,10,1,0,0,0,0,0,0,0,0,0,0,0,0,OH05
206622,Xavier University,XU | X,3800 Victory Parkway,Cincinnati,OH,45207-1092,-84.47465,39.149547,Private not-for-profit,Graduate degree or certificate offering,No,City: Large,Doctoral/Professional Universities,Postbaccalaureate: Comprehensive programs,High undergraduate,"Four-year, medium, primarily residential",2367,876,1491,42,18,24,2367,913,1107,347,709,284,425,10,3,7,0,0,0,0,0,0,OH01
206695,Youngstown State University, ,One University Plaza,Youngstown,OH,44555-0001,-80.64659,41.104928,Public,Graduate degree or certificate offering,No,City: Small,Master's Colleges & Universities: Larger Programs,Research Doctoral: Professional-dominant,High undergraduate,"Four-year, medium, primarily nonresidential",1977,701,1276,83,39,44,1977,1045,762,170,459,170,289,48,23,25,17,7,10,0,0,0,OH06
206835,Oklahoma Wesleyan University,OKWU or OWU,2201 Silver Lake Rd,Bartlesville,OK,74006-6299,-95.95671,36.717453,Private not-for-profit,Graduate degree or certificate offering,No,Town: Distant,Master's Colleges & Universities: Small Programs,"Postbaccalaureate: Business-dominant, with other professional programs",Very high undergraduate,"Four-year, very small, primarily residential",161,53,108,15,10,5,161,121,10,30,64,19,45,5,1,4,0,0,0,0,0,0,OK02
206862,Southern Nazarene University,SNU,6729 NW 39th Expy,Bethany,OK,73008,-97.629504,35.513295,Private not-for-profit,Graduate degree or certificate offering,No,Suburb: Large,Master's Colleges & Universities: Larger Programs,"Postbaccalaureate: Business-dominant, with other professional programs",Majority undergraduate,"Four-year, small, primarily residential",1018,382,636,18,14,4,1018,291,130,597,239,118,121,6,4,2,0,0,0,0,0,0,OK05
206914,Cameron University, ,2800 West Gore Blvd,Lawton,OK,73505-6377,-98.434163,34.606487,Public,Graduate degree or certificate offering,No,City: Small,Master's Colleges & Universities: Small Programs,"Postbaccalaureate: Education-dominant, with Arts & Sciences",Very high undergraduate,"Four-year, small, primarily nonresidential",432,126,306,17,9,8,432,201,207,24,86,25,61,6,3,3,0,0,0,0,0,0,OK04
206941,University of Central Oklahoma,"UCO, Central",100 N University Dr,Edmond,OK,73034,-97.471508,35.6552,Public,Graduate degree or certificate offering,No,Suburb: Large,Master's Colleges & Universities: Larger Programs,Postbaccalaureate: Comprehensive programs,Very high undergraduate,"Four-year, large, primarily nonresidential",2052,610,1442,216,93,123,2052,248,599,1205,511,146,365,87,32,55,0,0,0,0,0,0,OK05
207041,East Central University,ECU,1100 E. 14th Street,Ada,OK,74820-6999,-96.663849,34.771934,Public,Graduate degree or certificate offering,No,Town: Remote,Master's Colleges & Universities: Larger Programs,"Postbaccalaureate: Education-dominant, with other professional programs",High undergraduate,"Four-year, small, primarily residential",919,300,619,34,15,19,919,919,0,0,218,74,144,13,5,8,0,0,0,0,0,0,OK04
207157,Randall University, ,3701 S. I-35 Frontage Road,Moore,OK,73160,-97.491107,35.300757,Private not-for-profit,Graduate degree or certificate offering,No,Suburb: Large,Baccalaureate Colleges: Arts & Sciences Focus,Postbaccalaureate: Single program-Other,Very high undergraduate,"Four-year, very small, primarily residential",18,13,5,0,0,0,18,18,0,0,4,2,2,0,0,0,0,0,0,0,0,0,OK04
207209,Langston University, ,102 Page Hall,Langston,OK,73050,-97.260317,35.943982,Public,Graduate degree or certificate offering,Yes,Rural: Distant,Master's Colleges & Universities: Small Programs,"Postbaccalaureate: Other-dominant, with other professional programs",Very high undergraduate,"Four-year, small, highly residential",211,74,137,5,3,2,211,71,124,16,30,7,23,0,0,0,0,0,0,0,0,0,OK05
207263,Northeastern State University,NSU,600 N Grand,Tahlequah,OK,74464-2399,-94.967229,35.919939,Public,Graduate degree or certificate offering,No,Town: Remote,Master's Colleges & Universities: Larger Programs,"Postbaccalaureate: Education-dominant, with Arts & Sciences",High undergraduate,"Four-year, medium, primarily nonresidential",1734,431,1303,28,14,14,1734,944,597,193,379,88,291,7,2,5,0,0,0,0,0,0,OK02
207306,Northwestern Oklahoma State University,NWOSU|Northwestern Okla State|Northwestern Oklahoma State|,709 Oklahoma Blvd,Alva,OK,73717-2799,-98.667673,36.796658,Public,Graduate degree or certificate offering,No,Town: Remote,Master's Colleges & Universities: Small Programs,"Postbaccalaureate: Education-dominant, with Arts & Sciences",Very high undergraduate,"Four-year, small, highly residential",315,90,225,7,4,3,315,125,168,22,53,17,36,3,1,2,0,0,0,0,0,0,OK03
207315,Oklahoma State University Center for Health Sciences, ,1111 W 17th St,Tulsa,OK,74107-1898,-96.005702,36.137977,Public,Graduate degree or certificate offering,No,City: Large,Special Focus Four-Year: Medical Schools & Centers,Research Doctoral: STEM-dominant,Exclusively graduate,Exclusively graduate/professional,1442,674,768,24,9,15,1442,782,124,536,269,113,156,6,4,2,7,3,4,1,1,0,OK01
207324,Oklahoma Christian University,"OC, Oklahoma Christian, OCUSA, Oklahoma Christian University of Science and Arts, OCC, Oklahoma Christian College",2501 E Memorial Rd,Edmond,OK,73013,-97.469526,35.611412,Private not-for-profit,Graduate degree or certificate offering,No,City: Large,Master's Colleges & Universities: Medium Programs,"Postbaccalaureate: Business-dominant, with Arts & Sciences",High undergraduate,"Four-year, small, highly residential",459,277,182,0,0,0,459,270,153,36,180,104,76,0,0,0,0,0,0,0,0,0,OK05
207342,University of Oklahoma-Health Sciences Center, ,1105 Stonewall Avenue,Oklahoma City,OK,73117-1221,-97.496289,35.47928,Public,Graduate degree or certificate offering,No,City: Large,Special Focus Four-Year: Research Institutions,Research Doctoral: STEM-dominant,Majority graduate,"Four-year, small, primarily nonresidential",2677,980,1697,94,41,53,2677,248,1576,853,187,38,149,7,2,5,28,13,15,11,5,6,OK05
207388,Oklahoma State University-Main Campus, ,107 Whitehurst,Stillwater,OK,74078-1015,-97.069743,36.123085,Public,Graduate degree or certificate offering,No,Town: Distant,Doctoral Universities: Very High Research Activity,"Research Doctoral: Comprehensive programs, with medical/veterinary school",High undergraduate,"Four-year, large, primarily residential",5008,2431,2577,950,585,365,5008,1517,2485,1006,939,455,484,158,92,66,211,116,95,81,55,26,OK03
207403,Oklahoma Baptist University, ,500 W University,Shawnee,OK,74804,-96.932459,35.360492,Private not-for-profit,Graduate degree or certificate offering,No,Town: Distant,Master's Colleges & Universities: Small Programs,"Postbaccalaureate: Business-dominant, with Arts & Sciences",Very high undergraduate,"Four-year, small, highly residential",128,47,81,4,3,1,128,37,38,53,42,16,26,2,1,1,0,0,0,0,0,0,OK05
207458,Oklahoma City University, ,2501 N Blackwelder,Oklahoma City,OK,73106-1402,-97.541242,35.495271,Private not-for-profit,Graduate degree or certificate offering,No,City: Large,Doctoral/Professional Universities,Research Doctoral: Single program-Other,Majority undergraduate,"Four-year, small, highly residential",1301,512,789,69,30,39,1301,90,506,705,223,91,132,39,15,24,5,0,5,4,0,4,OK05
207500,University of Oklahoma-Norman Campus,University of Oklahoma|Oklahoma University|OU|Oklahoma,660 Parrington Oval,Norman,OK,73019-3072,-97.444211,35.209407,Public,Graduate degree or certificate offering,No,Suburb: Midsize,Doctoral Universities: Very High Research Activity,"Research Doctoral: Comprehensive programs, no medical/veterinary school",High undergraduate,"Four-year, large, primarily residential",8012,3755,4257,826,487,339,8012,2758,2304,2950,1851,852,999,161,82,79,208,117,91,65,39,26,OK04
207582,Oral Roberts University,ORU,7777 S Lewis Ave.,Tulsa,OK,74171,-95.952547,36.049129,Private not-for-profit,Graduate degree or certificate offering,No,City: Large,Doctoral/Professional Universities,Research Doctoral: Professional-dominant,High undergraduate,"Four-year, medium, highly residential",783,360,423,203,97,106,783,251,58,474,150,71,79,9,4,5,1,1,0,0,0,0,OK01
207661,Rogers State University,RSU|Rogers University|Rogers State College|Claremore Junior College|Claremore Jr. College|CJC|Oklahoma Military Academy|OMA|Eastern University Preparatory School,1701 W Will Rogers Blvd,Claremore,OK,74017-3252,-95.635718,36.321437,Public,Graduate degree or certificate offering,No,Town: Fringe,Baccalaureate Colleges: Diverse Fields,Postbaccalaureate: Single program-Business,Very high undergraduate,"Four-year, small, primarily residential",97,34,63,1,0,1,97,75,22,0,16,8,8,1,0,1,0,0,0,0,0,0,OK02
207847,Southeastern Oklahoma State University, ,425 W University Blvd,Durant,OK,74701-3347,-96.376864,34.006808,Public,Graduate degree or certificate offering,No,Town: Distant,Master's Colleges & Universities: Larger Programs,"Postbaccalaureate: Education-dominant, with Arts & Sciences",Majority undergraduate,"Four-year, medium, primarily nonresidential",3384,1362,2022,62,39,23,3384,3185,182,17,1007,422,585,17,10,7,0,0,0,0,0,0,OK02
207856,Southwestern Christian University,SCU,7210 NW 39th Expressway,Bethany,OK,73008,-97.63934,35.513314,Private not-for-profit,Graduate degree or certificate offering,No,Suburb: Large,Baccalaureate Colleges: Diverse Fields,Postbaccalaureate: Single program-Other,Very high undergraduate,"Four-year, very small, primarily residential",35,16,19,9,5,4,35,0,35,0,11,8,3,5,4,1,0,0,0,0,0,0,OK05
207865,Southwestern Oklahoma State University,SWOSU|Southwestern|Southwestern Oklahoma State University Weatherford Campus|Southwestern Oklahoma State University Sayre Campus,100 Campus Dr,Weatherford,OK,73096-3001,-98.707768,35.535281,Public,Graduate degree or certificate offering,No,Town: Remote,Master's Colleges & Universities: Larger Programs,Postbaccalaureate: Comprehensive programs,High undergraduate,"Four-year, medium, primarily residential",1118,345,773,19,7,12,1118,511,499,108,253,74,179,7,5,2,0,0,0,0,0,0,OK03
207971,University of Tulsa,Tulsa University,800 South Tucker Drive,Tulsa,OK,74104-3189,-95.945941,36.152324,Private not-for-profit,Graduate degree or certificate offering,No,City: Large,Doctoral Universities: High Research Activity,"Research Doctoral: Comprehensive programs, no medical/veterinary school",High undergraduate,"Four-year, medium, highly residential",1194,653,541,182,137,45,1194,278,741,175,220,132,88,41,31,10,40,19,21,13,11,2,OK01
208646,Eastern Oregon University,EOU,One University Blvd,La Grande,OR,97850,-118.092495,45.319795,Public,Graduate degree or certificate offering,No,Town: Remote,Master's Colleges & Universities: Small Programs,"Postbaccalaureate: Education-dominant, with other professional programs",Very high undergraduate,"Four-year, small, primarily nonresidential",474,137,337,5,3,2,474,323,79,72,131,39,92,2,1,1,0,0,0,0,0,0,OR02
208822,George Fox University,GFU,414 N Meridian St,Newberg,OR,97132,-122.967494,45.303629,Private not-for-profit,Graduate degree or certificate offering,No,Town: Fringe,Doctoral/Professional Universities,Research Doctoral: Professional-dominant,Majority undergraduate,"Four-year, medium, highly residential",1990,643,1347,26,11,15,1990,1022,531,437,336,107,229,6,2,4,62,34,28,2,1,1,OR06
209056,Lewis & Clark College,Lewis and Clark College,615 S Palatine Hill Rd,Portland,OR,97219-7899,-122.669137,45.450882,Private not-for-profit,Graduate degree or certificate offering,No,City: Large,Baccalaureate Colleges: Arts & Sciences Focus,"Postbaccalaureate: Other-dominant, with other professional programs",Majority undergraduate,"Four-year, small, highly residential",1560,437,1123,25,9,16,1560,582,970,8,202,40,162,3,0,3,0,0,0,0,0,0,OR05
209241,Mount Angel Seminary, ,1 Abbey Drive,Saint Benedict,OR,97373,-122.775405,45.057871,Private not-for-profit,Graduate degree or certificate offering,No,Town: Fringe,Special Focus Four-Year: Faith-Related Institutions,"Postbaccalaureate: Other-dominant, with Arts & Sciences",Majority graduate,"Four-year, very small, highly residential",104,101,3,9,9,0,104,0,0,104,11,10,1,1,1,0,0,0,0,0,0,0,OR05
209287,Multnomah University,Multnomah Bible College|Multnomah Biblical Seminary|MBC|MBS|Multnomah School of the Bible,8435 NE Glisan St,Portland,OR,97220,-122.575557,45.527139,Private not-for-profit,Graduate degree or certificate offering,No,City: Large,Master's Colleges & Universities: Small Programs,"Postbaccalaureate: Other-dominant, with Arts & Sciences",Majority undergraduate,"Four-year, very small, highly residential",330,202,128,11,7,4,330,93,91,146,63,28,35,5,2,3,0,0,0,0,0,0,OR03
209296,National University of Natural Medicine, ,49 S Porter St.,Portland,OR,97201-4848,-122.6766,45.501931,Private not-for-profit,Graduate degree or certificate offering,No,City: Large,Special Focus Four-Year: Other Health Professions Schools,Postbaccalaureate: Single program-Other,Majority graduate,"Four-year, very small, primarily nonresidential",523,84,439,8,0,8,523,78,426,19,79,7,72,1,0,1,0,0,0,0,0,0,OR01
209409,Bushnell University,Bushnell,828 E. 11th Ave.,Eugene,OR,97401-3745,-123.079754,44.047483,Private not-for-profit,Graduate degree or certificate offering,No,City: Midsize,Master's Colleges & Universities: Small Programs,"Postbaccalaureate: Education-dominant, with other professional programs",Majority undergraduate,"Four-year, very small, highly residential",232,73,159,1,0,1,232,82,115,35,81,30,51,0,0,0,0,0,0,0,0,0,OR04
209490,Oregon Health & Science University,OHSU| Oregon Health and Sciences University,3181 SW Sam Jackson Park Rd,Portland,OR,97239-3098,-122.686096,45.498772,Public,Graduate degree or certificate offering,No,City: Large,Special Focus Four-Year: Research Institutions,Research Doctoral: STEM-dominant,Majority graduate,"Four-year, small, primarily nonresidential",2391,890,1501,85,43,42,2391,89,889,1413,315,92,223,13,7,6,46,17,29,5,2,3,OR01
209506,Oregon Institute of Technology,OIT|Oregon Tech,3201 Campus Drive,Klamath Falls,OR,97601-8801,-121.785177,42.257152,Public,Graduate degree or certificate offering,No,Town: Remote,Baccalaureate Colleges: Diverse Fields,"Postbaccalaureate: Other-dominant, with Arts & Sciences",Very high undergraduate,"Four-year, small, primarily nonresidential",177,77,100,6,2,4,177,59,24,94,39,21,18,0,0,0,0,0,0,0,0,0,OR02
209542,Oregon State University, ,1500 SW Jefferson Avenue,Corvallis,OR,97331,-123.274723,44.56395,Public,Graduate degree or certificate offering,No,City: Small,Doctoral Universities: Very High Research Activity,"Research Doctoral: Comprehensive programs, with medical/veterinary school",High undergraduate,"Four-year, large, primarily nonresidential",6964,3256,3708,1411,938,473,6964,2388,1292,3284,1061,533,528,338,239,99,250,144,106,93,65,28,OR04
209551,University of Oregon,UO,110 Johnson Hall,Eugene,OR,97403,-123.075792,44.045146,Public,Graduate degree or certificate offering,No,City: Midsize,Doctoral Universities: Very High Research Activity,"Research Doctoral: Comprehensive programs, no medical/veterinary school",High undergraduate,"Four-year, large, primarily residential",4173,1929,2244,496,237,259,4173,216,780,3177,1002,449,553,94,44,50,169,77,92,29,16,13,OR04
209603,Pacific Northwest College of Art, ,511 NW Broadway,Portland,OR,97209-3404,-122.678182,45.526766,Private not-for-profit,Graduate degree or certificate offering,No,City: Large,nan,nan,nan,nan,134,39,95,3,0,3,134,0,0,134,51,15,36,2,0,2,0,0,0,0,0,0,OR01
209612,Pacific University,Pacific|PU|Pac U|PacificU|Pacific University Oregon,2043 College Way,Forest Grove,OR,97116,-123.108777,45.521394,Private not-for-profit,Graduate degree or certificate offering,No,Suburb: Large,Doctoral/Professional Universities,Research Doctoral: Professional-dominant,Majority graduate,"Four-year, medium, highly residential",2357,621,1736,106,31,75,2357,193,1698,466,436,103,333,6,3,3,19,6,13,2,1,1,OR01
209807,Portland State University, ,724 SW Harrison,Portland,OR,97201,-122.686289,45.511601,Public,Graduate degree or certificate offering,No,City: Large,Doctoral Universities: High Research Activity,Research Doctoral: STEM-dominant,High undergraduate,"Four-year, large, primarily nonresidential",6490,2354,4136,652,309,343,6490,573,995,4922,1610,625,985,206,98,108,95,42,53,27,18,9,OR01
209825,University of Portland, ,5000 N Willamette Blvd,Portland,OR,97203-5798,-122.726691,45.572724,Private not-for-profit,Graduate degree or certificate offering,No,City: Large,Master's Colleges & Universities: Medium Programs,"Postbaccalaureate: Education-dominant, with Arts & Sciences",Very high undergraduate,"Four-year, medium, highly residential",650,236,414,91,34,57,650,650,0,0,163,64,99,30,8,22,0,0,0,0,0,0,OR03
209922,Reed College,Reed,3203 SE Woodstock Blvd,Portland,OR,97202-8199,-122.630348,45.480959,Private not-for-profit,Graduate degree or certificate offering,No,City: Large,Baccalaureate Colleges: Arts & Sciences Focus,Postbaccalaureate: Single program-Other,Very high undergraduate,"Four-year, small, highly residential",24,11,13,0,0,0,24,18,4,2,2,0,2,0,0,0,0,0,0,0,0,0,OR03
210146,Southern Oregon University, ,1250 Siskiyou Blvd,Ashland,OR,97520,-122.695081,42.185077,Public,Graduate degree or certificate offering,No,Suburb: Midsize,Master's Colleges & Universities: Larger Programs,"Postbaccalaureate: Education-dominant, with Arts & Sciences",High undergraduate,"Four-year, medium, primarily residential",1500,478,1022,28,9,19,1500,524,840,136,252,81,171,18,5,13,0,0,0,0,0,0,OR02
210304,Warner Pacific University, ,2219 SE 68th Ave,Portland,OR,97215,-122.592498,45.506265,Private not-for-profit,Graduate degree or certificate offering,No,City: Large,Baccalaureate Colleges: Diverse Fields,Not classified (Exclusively Undergraduate),Very high undergraduate,"Four-year, very small, highly residential",3,1,2,0,0,0,3,0,0,3,2,0,2,0,0,0,0,0,0,0,0,0,OR03
210331,Corban University, ,5000 Deer Park Dr SE,Salem,OR,97317-9392,-122.961129,44.882399,Private not-for-profit,Graduate degree or certificate offering,No,City: Midsize,Master's Colleges & Universities: Small Programs,"Postbaccalaureate: Business-dominant, with other professional programs",High undergraduate,"Four-year, very small, highly residential",364,171,193,7,5,2,364,48,193,123,82,40,42,2,2,0,0,0,0,0,0,0,OR06
210368,Western Seminary,Western Seminary-San Jose  Western Seminary-Sacramento  Western Seminary-Portland,5511 SE Hawthorne Blvd,Portland,OR,97215-3367,-122.606374,45.512091,Private not-for-profit,Graduate degree or certificate offering,No,City: Large,Special Focus Four-Year: Faith-Related Institutions,Research Doctoral: Single program-Other,Exclusively graduate,Exclusively graduate/professional,1053,728,325,4,2,2,1053,955,94,4,138,84,54,0,0,0,14,10,4,1,0,1,OR03
210401,Willamette University, ,900 State St,Salem,OR,97301,-123.030537,44.935457,Private not-for-profit,Graduate degree or certificate offering,No,City: Midsize,Baccalaureate Colleges: Arts & Sciences Focus,"Postbaccalaureate: Other-dominant, with other professional programs",Majority undergraduate,"Four-year, small, highly residential",669,326,343,25,12,13,669,0,0,669,96,60,36,7,3,4,0,0,0,0,0,0,OR06
210429,Western Oregon University,Western Oregon State College,345 Monmouth Ave N,Monmouth,OR,97361-1394,-123.238309,44.852235,Public,Graduate degree or certificate offering,No,Town: Fringe,Master's Colleges & Universities: Larger Programs,Postbaccalaureate: Comprehensive programs,Very high undergraduate,"Four-year, medium, primarily residential",939,294,645,19,9,10,939,595,33,311,194,58,136,7,4,3,0,0,0,0,0,0,OR06
210438,University of Western States,Western States Chiropractic College,8000 NE Tillamook Street,Portland,OR,97213,-122.580586,45.536519,Private not-for-profit,Graduate degree or certificate offering,No,City: Large,Doctoral/Professional Universities,Research Doctoral: Professional-dominant,Majority graduate,"Four-year, very small, primarily nonresidential",1550,601,949,289,129,160,1550,880,670,0,206,50,156,27,7,20,22,13,9,1,1,0,OR03
210492,Bryn Athyn College of the New Church,Bryn Athyn College,2945 College Drive,Bryn Athyn,PA,19009-0717,-75.060808,40.134393,Private not-for-profit,Graduate degree or certificate offering,No,Suburb: Large,Baccalaureate Colleges: Arts & Sciences Focus,"Postbaccalaureate: Other-dominant, with Arts & Sciences",Very high undergraduate,"Four-year, very small, highly residential",17,6,11,1,1,0,17,2,9,6,9,1,8,0,0,0,0,0,0,0,0,0,PA04
210508,Academy of Vocal Arts, ,1920 Spruce St,Philadelphia,PA,19103-6685,-75.173735,39.94796,Private not-for-profit,Graduate degree or certificate offering,No,City: Large,nan,nan,nan,nan,24,11,13,8,3,5,24,0,0,24,0,0,0,0,0,0,0,0,0,0,0,0,PA03
210571,Albright College, ,1621 N. 13th St.,Reading,PA,19612-5234,-75.909742,40.361351,Private not-for-profit,Graduate degree or certificate offering,No,City: Small,Baccalaureate Colleges: Arts & Sciences Focus,Postbaccalaureate: Single program-Education,Very high undergraduate,"Four-year, small, highly residential",69,19,50,0,0,0,69,62,6,1,19,5,14,0,0,0,0,0,0,0,0,0,PA06
210739,DeSales University, ,2755 Station Avenue,Center Valley,PA,18034-9568,-75.375608,40.539091,Private not-for-profit,Graduate degree or certificate offering,No,Rural: Fringe,Doctoral/Professional Universities,"Postbaccalaureate: Other-dominant, with Arts & Sciences",High undergraduate,"Four-year, small, primarily residential",1228,405,823,0,0,0,1228,435,425,368,320,95,225,0,0,0,0,0,0,0,0,0,PA07
210775,Alvernia University, ,400 Saint Bernardine St,Reading,PA,19607-1799,-75.936754,40.310028,Private not-for-profit,Graduate degree or certificate offering,No,City: Small,Doctoral/Professional Universities,Research Doctoral: Single program-Other,High undergraduate,"Four-year, small, highly residential",585,177,408,8,3,5,585,165,328,92,159,45,114,1,0,1,2,0,2,0,0,0,PA06
210809,American College of Financial Services,The American College,630 Allendale Rd,King of Prussia,PA,19406,-75.394652,40.101644,Private not-for-profit,Graduate degree or certificate offering,No,Suburb: Large,Special Focus Four-Year: Business & Management Schools,Research Doctoral: Single program-Other,Very high undergraduate,Exclusively graduate/professional,1020,546,474,0,0,0,1020,912,108,0,74,54,20,0,0,0,5,4,1,0,0,0,PA05
211024,Clarks Summit University,BBC  BBC&S  Summit U  Summit University  BBC & S  BBS  Baptist Bible College of PA  Baptist Bible College  Baptist Bible Seminary  Baptist Bible College & Seminary  Baptist Bible College of Pennsylvania  Summit University of Pennsylvania  SU of Pennsylvania  Summit U  Summit U of Pennsylvania,538 Venard Rd,Clarks Summit,PA,18411-1250,-75.685472,41.495062,Private not-for-profit,Graduate degree or certificate offering,No,Suburb: Large,Master's Colleges & Universities: Small Programs,Research Doctoral: Single program-Other,Majority undergraduate,"Four-year, very small, primarily residential",310,197,113,8,7,1,310,254,0,56,86,59,27,0,0,0,5,5,0,2,2,0,PA08
211088,Arcadia University,Beaver College,450 S Easton Rd,Glenside,PA,19038-3295,-75.163876,40.092606,Private not-for-profit,Graduate degree or certificate offering,No,Suburb: Large,Master's Colleges & Universities: Larger Programs,Research Doctoral: Single program-Education,Majority undergraduate,"Four-year, small, highly residential",1753,385,1368,108,29,79,1753,1160,218,375,273,54,219,5,2,3,10,1,9,0,0,0,PA04
211130,Missio Theological Seminary,Missio Seminary,"421 N. 7th Street, Suite 700",Philadelphia,PA,19123,-75.150056,39.959026,Private not-for-profit,Graduate degree or certificate offering,No,City: Large,Special Focus Four-Year: Faith-Related Institutions,"Postbaccalaureate: Other-dominant, with other professional programs",Exclusively graduate,Exclusively graduate/professional,256,158,98,66,56,10,256,22,2,232,24,16,8,9,9,0,0,0,0,0,0,0,PA02
211158,Bloomsburg University of Pennsylvania, ,400 E Second St,Bloomsburg,PA,17815,-76.447844,41.00782,Public,Graduate degree or certificate offering,No,City: Small,Master's Colleges & Universities: Larger Programs,"Postbaccalaureate: Education-dominant, with Arts & Sciences",Very high undergraduate,"Four-year, medium, primarily residential",932,280,652,7,3,4,932,459,436,37,286,99,187,0,0,0,0,0,0,0,0,0,PA09
211273,Bryn Mawr College, ,101 N Merion Avenue,Bryn Mawr,PA,19010,-75.313223,40.02736,Private not-for-profit,Graduate degree or certificate offering,No,Suburb: Large,Baccalaureate Colleges: Arts & Sciences Focus,Research Doctoral: Humanities/social sciences-dominant,High undergraduate,"Four-year, small, highly residential",345,74,271,14,3,11,345,0,0,345,74,6,68,2,0,2,5,3,2,0,0,0,PA05
211291,Bucknell University, ,One Dent Drive,Lewisburg,PA,17837,-76.882616,40.954317,Private not-for-profit,Graduate degree or certificate offering,No,Town: Distant,Baccalaureate Colleges: Arts & Sciences Focus,Postbaccalaureate: Comprehensive programs,Very high undergraduate,"Four-year, medium, highly residential",34,10,24,3,0,3,34,0,0,34,16,9,7,2,1,1,0,0,0,0,0,0,PA15
211352,Cabrini University, ,610 King of Prussia Rd,Radnor,PA,19087-3698,-75.375263,40.056355,Private not-for-profit,Graduate degree or certificate offering,No,Suburb: Large,Master's Colleges & Universities: Medium Programs,Research Doctoral: Professional-dominant,High undergraduate,"Four-year, small, highly residential",685,196,489,7,2,5,685,401,224,60,157,44,113,2,0,2,22,9,13,0,0,0,PA05
211361,California University of Pennsylvania, ,250 University Ave,California,PA,15419-1394,-79.88679,40.064964,Public,Graduate degree or certificate offering,No,Suburb: Small,Master's Colleges & Universities: Larger Programs,Postbaccalaureate: Comprehensive programs,High undergraduate,"Four-year, medium, primarily residential",3178,1038,2140,27,11,16,3178,2707,430,41,896,291,605,5,2,3,0,0,0,0,0,0,PA14
211431,Carlow University, ,3333 Fifth Ave,Pittsburgh,PA,15213-3165,-79.963448,40.439293,Private not-for-profit,Graduate degree or certificate offering,No,City: Large,Master's Colleges & Universities: Larger Programs,"Postbaccalaureate: Other-dominant, with Arts & Sciences",Majority undergraduate,"Four-year, small, primarily residential",834,108,726,2,1,1,834,342,416,76,264,41,223,0,0,0,0,0,0,0,0,0,PA12
211440,Carnegie Mellon University,Carnegie Mellon; CMU,5000 Forbes Avenue,Pittsburgh,PA,15213-3890,-79.941993,40.44357,Private not-for-profit,Graduate degree or certificate offering,No,City: Large,Doctoral Universities: Very High Research Activity,"Research Doctoral: Comprehensive programs, no medical/veterinary school",Majority undergraduate,"Four-year, large, highly residential",8071,5080,2991,4866,3083,1783,8071,12,241,7818,3045,1860,1185,2006,1218,788,333,234,99,175,123,52,PA12
211468,Cedar Crest College, ,100 College Drive,Allentown,PA,18104-6196,-75.519221,40.586318,Private not-for-profit,Graduate degree or certificate offering,No,City: Midsize,Master's Colleges & Universities: Small Programs,"Postbaccalaureate: Education-dominant, with Arts & Sciences",High undergraduate,"Four-year, small, primarily residential",469,73,396,0,0,0,469,4,456,9,88,10,78,1,0,1,0,0,0,0,0,0,PA07
211477,Central Penn College,Central Penn,600 Valley Road,Summerdale,PA,17093-0309,-76.934461,40.3049,Private for-profit,Graduate degree or certificate offering,No,Suburb: Large,Baccalaureate Colleges: Diverse Fields,Postbaccalaureate: Single program-Business,Very high undergraduate,"Four-year, very small, primarily nonresidential",33,9,24,1,0,1,33,20,11,2,8,6,2,0,0,0,0,0,0,0,0,0,PA10
211556,Chatham University,Chatham,"Woodland Road, Office of Institutional Research",Pittsburgh,PA,15232,-79.926083,40.448432,Private not-for-profit,Graduate degree or certificate offering,No,City: Large,Doctoral/Professional Universities,Postbaccalaureate: Comprehensive programs,Majority undergraduate,"Four-year, small, highly residential",1124,222,902,28,8,20,1124,412,603,109,331,64,267,8,3,5,0,0,0,0,0,0,PA12
211583,Chestnut Hill College,CHC,9601 Germantown Ave,Philadelphia,PA,19118-2693,-75.228742,40.08678,Private not-for-profit,Graduate degree or certificate offering,No,City: Large,Master's Colleges & Universities: Medium Programs,"Postbaccalaureate: Other-dominant, with other professional programs",High undergraduate,"Four-year, small, primarily residential",523,110,413,7,0,7,523,30,132,361,122,23,99,3,0,3,0,0,0,0,0,0,PA03
211644,Clarion University of Pennsylvania,Clarion University,840 Wood Street,Clarion,PA,16214,-79.377501,41.207805,Public,Graduate degree or certificate offering,No,Town: Remote,Master's Colleges & Universities: Larger Programs,"Postbaccalaureate: Other-dominant, with Arts & Sciences",High undergraduate,"Four-year, medium, highly residential",1188,232,956,7,1,6,1188,930,179,79,412,79,333,0,0,0,0,0,0,0,0,0,PA15
211893,Curtis Institute of Music, ,1726 Locust St,Philadelphia,PA,19103,-75.170727,39.948857,Private not-for-profit,Graduate degree or certificate offering,No,City: Large,"Special Focus Four-Year: Arts, Music & Design Schools",Postbaccalaureate: Single program-Other,High undergraduate,"Four-year, very small, highly residential",32,18,14,7,2,5,32,32,0,0,0,0,0,0,0,0,0,0,0,0,0,0,PA03
211981,Delaware Valley University, ,700 E Butler Ave,Doylestown,PA,18901-2697,-75.158452,40.298659,Private not-for-profit,Graduate degree or certificate offering,No,Suburb: Large,Master's Colleges & Universities: Small Programs,Research Doctoral: Single program-Education,High undergraduate,"Four-year, small, highly residential",720,222,498,1,1,0,720,104,91,525,67,22,45,0,0,0,16,7,9,0,0,0,PA01
212009,Dickinson College, ,College and Louther Streets,Carlisle,PA,17013-2896,-77.197854,40.202796,Private not-for-profit,Graduate degree or certificate offering,No,City: Small,Baccalaureate Colleges: Arts & Sciences Focus,Not classified (Exclusively Undergraduate),Exclusively undergraduate four-year,"Four-year, small, highly residential",3,0,3,0,0,0,3,0,0,3,0,0,0,0,0,0,0,0,0,0,0,0,PA10
212054,Drexel University,Drexel,3141 Chestnut St,Philadelphia,PA,19104,-75.190051,39.955217,Private not-for-profit,Graduate degree or certificate offering,No,City: Large,Doctoral Universities: Very High Research Activity,"Research Doctoral: Comprehensive programs, with medical/veterinary school",Majority undergraduate,"Four-year, large, primarily residential",10878,3867,7011,1089,587,502,10878,6593,2902,1383,2211,792,1419,360,216,144,244,104,140,64,39,25,PA03
212106,Duquesne University, ,Administration Bldg 600 Forbes Ave,Pittsburgh,PA,15282,-79.993123,40.43589,Private not-for-profit,Graduate degree or certificate offering,No,City: Large,Doctoral Universities: High Research Activity,Research Doctoral: Professional-dominant,Majority undergraduate,"Four-year, medium, highly residential",3917,1267,2650,393,171,222,3917,1321,1557,1039,679,200,479,90,33,57,81,35,46,21,8,13,PA12
212115,East Stroudsburg University of Pennsylvania,East Stroudsburg University,200 Prospect Street,East Stroudsburg,PA,18301-2999,-75.173905,40.99599,Public,Graduate degree or certificate offering,No,City: Small,Master's Colleges & Universities: Larger Programs,Postbaccalaureate: Comprehensive programs,Very high undergraduate,"Four-year, medium, highly residential",1102,322,780,27,11,16,1102,311,315,476,300,100,200,13,5,8,0,0,0,0,0,0,PA08
212133,Eastern University, ,1300 Eagle Rd,Saint Davids,PA,19087-3696,-75.370316,40.050448,Private not-for-profit,Graduate degree or certificate offering,No,Suburb: Large,Master's Colleges & Universities: Larger Programs,Research Doctoral: Professional-dominant,Majority undergraduate,"Four-year, small, primarily residential",2481,858,1623,38,22,16,2481,2004,435,42,307,90,217,11,4,7,12,2,10,1,1,0,PA05
212160,Edinboro University of Pennsylvania,Edinboro,219 Meadville Street,Edinboro,PA,16444-0001,-80.121318,41.870717,Public,Graduate degree or certificate offering,No,Town: Fringe,Master's Colleges & Universities: Larger Programs,"Postbaccalaureate: Education-dominant, with Arts & Sciences",High undergraduate,"Four-year, medium, primarily residential",1745,304,1441,12,1,11,1745,832,730,183,435,76,359,2,1,1,0,0,0,0,0,0,PA16
212197,Elizabethtown College, ,One Alpha Drive,Elizabethtown,PA,17022-2298,-76.593224,40.149236,Private not-for-profit,Graduate degree or certificate offering,No,Suburb: Large,Master's Colleges & Universities: Small Programs,"Postbaccalaureate: Other-dominant, with other professional programs",Very high undergraduate,"Four-year, small, highly residential",318,90,228,0,0,0,318,179,75,64,83,13,70,0,0,0,0,0,0,0,0,0,PA11
212443,Evangelical Theological Seminary,"ETS, Evangelical, Evangelical Seminary",121 S College St,Myerstown,PA,17067-1222,-76.306252,40.372981,Private not-for-profit,Graduate degree or certificate offering,No,Suburb: Small,Master's Colleges & Universities: Small Programs,"Postbaccalaureate: Other-dominant, with Arts & Sciences",Exclusively graduate,Exclusively graduate/professional,192,130,62,2,2,0,192,20,118,54,41,20,21,1,1,0,5,4,1,0,0,0,PA09
212601,Gannon University, ,109 W Sixth St,Erie,PA,16541-0001,-80.087166,42.128403,Private not-for-profit,Graduate degree or certificate offering,No,City: Small,Doctoral/Professional Universities,Research Doctoral: Single program-Other,High undergraduate,"Four-year, medium, highly residential",1351,461,890,181,130,51,1351,315,609,427,318,115,203,58,41,17,9,4,5,0,0,0,PA16
212656,Geneva College, ,3200 College Ave,Beaver Falls,PA,15010-3599,-80.321826,40.772518,Private not-for-profit,Graduate degree or certificate offering,No,Suburb: Large,Master's Colleges & Universities: Small Programs,"Postbaccalaureate: Business-dominant, with other professional programs",Very high undergraduate,"Four-year, small, highly residential",190,75,115,4,0,4,190,46,94,50,55,21,34,3,0,3,0,0,0,0,0,0,PA17
212771,Gratz College, ,7605 Old York Rd,Melrose Park,PA,19027-3010,-75.133915,40.067206,Private not-for-profit,Graduate degree or certificate offering,No,Suburb: Large,Master's Colleges & Universities: Small Programs,Research Doctoral: Single program-Education,Majority graduate,"Four-year, very small, primarily nonresidential",458,124,334,0,0,0,458,458,0,0,45,5,40,0,0,0,8,1,7,0,0,0,PA04
212832,Gwynedd Mercy University, ,1325 Sumneytown Pike,Gwynedd Valley,PA,19437-0901,-75.236601,40.202804,Private not-for-profit,Graduate degree or certificate offering,No,Suburb: Large,Doctoral/Professional Universities,Research Doctoral: Single program-Education,Majority undergraduate,"Four-year, small, primarily residential",947,222,725,3,2,1,947,856,71,20,213,54,159,0,0,0,45,13,32,0,0,0,PA04
212984,Holy Family University,Holy Family,9801 Frankford Avenue,Philadelphia,PA,19114-2009,-74.986451,40.060581,Private not-for-profit,Graduate degree or certificate offering,No,City: Large,Master's Colleges & Universities: Larger Programs,Research Doctoral: Single program-Education,High undergraduate,"Four-year, small, primarily nonresidential",1262,210,1052,0,0,0,1262,1161,95,6,389,49,340,0,0,0,9,1,8,0,0,0,PA02
213011,Immaculata University, ,1145 King Road,Immaculata,PA,19345,-75.570711,40.027981,Private not-for-profit,Graduate degree or certificate offering,No,Suburb: Large,Doctoral/Professional Universities,Research Doctoral: Single program-Education,Majority undergraduate,"Four-year, small, primarily residential",1320,255,1065,9,1,8,1320,823,410,87,151,19,132,2,1,1,52,13,39,2,0,2,PA06
213020,Indiana University of Pennsylvania-Main Campus, ,1011 South Dr 201 Sutton Hall,Indiana,PA,15705-1098,-79.159332,40.617531,Public,Graduate degree or certificate offering,No,Town: Distant,Doctoral Universities: High Research Activity,"Research Doctoral: Comprehensive programs, no medical/veterinary school",High undergraduate,"Four-year, medium, highly residential",2452,876,1576,368,182,186,2452,475,655,1322,578,221,357,76,47,29,109,38,71,15,8,7,PA14
213251,Juniata College, ,1700 Moore St,Huntingdon,PA,16652-2196,-78.017292,40.500523,Private not-for-profit,Graduate degree or certificate offering,No,Town: Distant,Baccalaureate Colleges: Arts & Sciences Focus,Not classified (Exclusively Undergraduate),Very high undergraduate,"Four-year, small, highly residential",66,36,30,2,2,0,66,58,5,3,23,14,9,1,1,0,0,0,0,0,0,0,PA13
213303,Keystone College, ,One College Green,La Plume,PA,18440-0200,-75.777456,41.558969,Private not-for-profit,Graduate degree or certificate offering,No,Suburb: Large,Baccalaureate Colleges: Diverse Fields,"Postbaccalaureate: Education-dominant, with other professional programs",Very high undergraduate,"Four-year, small, primarily residential",114,40,74,0,0,0,114,84,7,23,27,8,19,0,0,0,0,0,0,0,0,0,PA09
213321,King's College,Kings College|King's|Kings,133 N River St,Wilkes-Barre,PA,18711-0801,-75.879822,41.250097,Private not-for-profit,Graduate degree or certificate offering,No,City: Small,Master's Colleges & Universities: Medium Programs,"Postbaccalaureate: Other-dominant, with other professional programs",Very high undergraduate,"Four-year, small, highly residential",436,116,320,9,2,7,436,124,134,178,134,38,96,6,2,4,0,0,0,0,0,0,PA08
213349,Kutztown University of Pennsylvania, ,15200 Kutztown Rd,Kutztown,PA,19530-0730,-75.783933,40.513561,Public,Graduate degree or certificate offering,No,Town: Fringe,Master's Colleges & Universities: Larger Programs,"Postbaccalaureate: Education-dominant, with Arts & Sciences",Very high undergraduate,"Four-year, medium, highly residential",1292,330,962,6,1,5,1292,730,509,53,290,64,226,1,0,1,0,0,0,0,0,0,PA04
213358,La Roche University,LRU,9000 Babcock Blvd,Pittsburgh,PA,15237-5898,-80.014851,40.568615,Private not-for-profit,Graduate degree or certificate offering,No,Suburb: Large,Master's Colleges & Universities: Small Programs,"Postbaccalaureate: Other-dominant, with Arts & Sciences",High undergraduate,"Four-year, small, highly residential",334,83,251,53,27,26,334,20,201,113,50,16,34,8,5,3,0,0,0,0,0,0,PA17
213367,La Salle University, ,1900 W Olney Ave,Philadelphia,PA,19141-1199,-75.153061,40.037979,Private not-for-profit,Graduate degree or certificate offering,No,City: Large,Doctoral/Professional Universities,Postbaccalaureate: Comprehensive programs,High undergraduate,"Four-year, medium, highly residential",2357,613,1744,57,22,35,2357,1607,519,231,480,131,349,9,4,5,0,0,0,0,0,0,PA03
213400,Lancaster Bible College, ,901 Eden Rd,Lancaster,PA,17601-5036,-76.287761,40.075347,Private not-for-profit,Graduate degree or certificate offering,No,Suburb: Large,Master's Colleges & Universities: Small Programs,Research Doctoral: Professional-dominant,High undergraduate,"Four-year, small, primarily residential",559,334,225,0,0,0,559,46,0,513,124,78,46,0,0,0,11,7,4,0,0,0,PA11
213446,Lancaster Theological Seminary, ,555 W James St,Lancaster,PA,17603-2897,-76.317631,40.045235,Private not-for-profit,Graduate degree or certificate offering,No,City: Small,Special Focus Four-Year: Faith-Related Institutions,Postbaccalaureate: Single program-Other,Exclusively graduate,Exclusively graduate/professional,103,48,55,0,0,0,103,103,0,0,21,11,10,0,0,0,0,0,0,0,0,0,PA11
213507,Lebanon Valley College,LVC,101 N College Ave,Annville,PA,17003-1400,-76.514431,40.330604,Private not-for-profit,Graduate degree or certificate offering,No,Suburb: Small,Master's Colleges & Universities: Small Programs,"Postbaccalaureate: Other-dominant, with other professional programs",Very high undergraduate,"Four-year, small, highly residential",364,135,229,0,0,0,364,157,131,76,60,22,38,0,0,0,0,0,0,0,0,0,PA09
213543,Lehigh University, ,27 Memorial Drive West,Bethlehem,PA,18015,-75.380236,40.606822,Private not-for-profit,Graduate degree or certificate offering,No,City: Small,Doctoral Universities: High Research Activity,"Research Doctoral: Comprehensive programs, no medical/veterinary school",High undergraduate,"Four-year, medium, primarily residential",2121,1123,998,587,390,197,2121,340,581,1200,538,281,257,137,86,51,90,48,42,49,32,17,PA07
213598,Lincoln University, ,1570 Baltimore Pike,Lincoln University,PA,19352-0999,-75.926458,39.807723,Public,Graduate degree or certificate offering,Yes,Suburb: Large,Master's Colleges & Universities: Medium Programs,"Postbaccalaureate: Other-dominant, with other professional programs",Very high undergraduate,"Four-year, small, highly residential",218,62,156,2,0,2,218,212,0,6,75,18,57,0,0,0,0,0,0,0,0,0,PA06
213613,Lock Haven University,LHU|LHUP|Lock Haven|Lock Haven University of Pennsylvania,401 North Fairview Street,Lock Haven,PA,17745-2390,-77.460108,41.141517,Public,Graduate degree or certificate offering,No,Town: Distant,Master's Colleges & Universities: Medium Programs,"Postbaccalaureate: Other-dominant, with Arts & Sciences",High undergraduate,"Four-year, small, primarily residential",598,181,417,0,0,0,598,408,189,1,127,39,88,0,0,0,0,0,0,0,0,0,PA15
213631,United Lutheran Seminary, ,61 Seminary Ridge,Gettysburg,PA,17325-1795,-77.244111,39.831701,Private not-for-profit,Graduate degree or certificate offering,No,City: Small,Special Focus Four-Year: Faith-Related Institutions,Postbaccalaureate: Single program-Other,Exclusively graduate,Exclusively graduate/professional,395,187,208,6,4,2,395,36,359,0,43,22,21,0,0,0,2,2,0,0,0,0,PA13
213774,Manor College, ,700 Fox Chase Rd,Jenkintown,PA,19046-3399,-75.104786,40.08714,Private not-for-profit,Graduate degree or certificate offering,No,Suburb: Large,Baccalaureate/Associate's Colleges: Associate's Dominant,Not classified (Exclusively Undergraduate),Very high undergraduate,"Four-year, very small, primarily nonresidential",1,0,1,0,0,0,1,1,0,0,0,0,0,0,0,0,0,0,0,0,0,0,PA04
213783,Mansfield University of Pennsylvania,Mansfield University,5 Swan Street,Mansfield,PA,16933,-77.07423,41.806949,Public,Graduate degree or certificate offering,No,Town: Distant,Baccalaureate Colleges: Diverse Fields,"Postbaccalaureate: Education-dominant, with other professional programs",Very high undergraduate,"Four-year, small, highly residential",13,1,12,0,0,0,13,5,6,2,6,0,6,0,0,0,0,0,0,0,0,0,PA15
213826,Marywood University,Marywood,2300 Adams Ave,Scranton,PA,18509-1598,-75.634142,41.434587,Private not-for-profit,Graduate degree or certificate offering,No,City: Small,Master's Colleges & Universities: Larger Programs,Research Doctoral: Single program-Other,Majority undergraduate,"Four-year, small, primarily residential",925,217,708,24,15,9,925,152,310,463,311,67,244,15,10,5,5,1,4,0,0,0,PA08
213987,Mercyhurst University, ,501 E 38th St,Erie,PA,16546,-80.053412,42.10578,Private not-for-profit,Graduate degree or certificate offering,No,City: Small,Master's Colleges & Universities: Medium Programs,"Postbaccalaureate: Education-dominant, with Arts & Sciences",High undergraduate,"Four-year, small, highly residential",586,244,342,44,30,14,586,391,194,1,154,67,87,11,8,3,0,0,0,0,0,0,PA16
213996,Messiah University, ,One University Avenue,Mechanicsburg,PA,17055,-76.988269,40.156579,Private not-for-profit,Graduate degree or certificate offering,No,Suburb: Large,Master's Colleges & Universities: Larger Programs,"Postbaccalaureate: Other-dominant, with Arts & Sciences",High undergraduate,"Four-year, small, highly residential",979,273,706,17,5,12,979,275,593,111,218,52,166,3,1,2,0,0,0,0,0,0,PA10
214041,Millersville University of Pennsylvania, ,"1 South George Street, Lyle Hall",Millersville,PA,17551-0302,-76.357381,40.000337,Public,Graduate degree or certificate offering,No,Suburb: Large,Master's Colleges & Universities: Larger Programs,Postbaccalaureate: Comprehensive programs,Very high undergraduate,"Four-year, medium, primarily residential",1455,389,1066,9,2,7,1455,1008,385,62,340,85,255,2,0,2,0,0,0,0,0,0,PA11
214069,Misericordia University, ,301 Lake St,Dallas,PA,18612-1098,-75.971541,41.345277,Private not-for-profit,Graduate degree or certificate offering,No,Suburb: Large,Doctoral/Professional Universities,"Postbaccalaureate: Other-dominant, with other professional programs",High undergraduate,"Four-year, small, primarily residential",591,135,456,0,0,0,591,148,260,183,181,39,142,0,0,0,0,0,0,0,0,0,PA08
214148,Moore College of Art and Design,Moore College,20th and the Parkway,Philadelphia,PA,19103-1179,-75.172105,39.957078,Private not-for-profit,Graduate degree or certificate offering,No,City: Large,"Special Focus Four-Year: Arts, Music & Design Schools","Postbaccalaureate: Education-dominant, with Arts & Sciences",Very high undergraduate,"Four-year, very small, highly residential",29,1,28,0,0,0,29,0,29,0,11,0,11,0,0,0,0,0,0,0,0,0,PA03
214157,Moravian University,Moravian Theological Seminary | Moravian | Moravian Seminary,1200 Main St,Bethlehem,PA,18018-6650,-75.383638,40.630947,Private not-for-profit,Graduate degree or certificate offering,No,City: Small,Master's Colleges & Universities: Small Programs,"Postbaccalaureate: Other-dominant, with other professional programs",High undergraduate,"Four-year, small, highly residential",821,215,606,6,1,5,821,416,397,8,120,33,87,3,1,2,0,0,0,0,0,0,PA07
214166,Mount Aloysius College, ,7373 Admiral Peary Hwy,Cresson,PA,16630-1999,-78.600898,40.459679,Private not-for-profit,Graduate degree or certificate offering,No,Town: Fringe,Baccalaureate Colleges: Diverse Fields,"Postbaccalaureate: Business-dominant, with other professional programs",Very high undergraduate,"Four-year, very small, primarily residential",39,21,18,3,3,0,39,4,32,3,28,17,11,2,2,0,0,0,0,0,0,0,PA13
214175,Muhlenberg College, ,2400 Chew Street,Allentown,PA,18104,-75.508502,40.596416,Private not-for-profit,Graduate degree or certificate offering,No,City: Midsize,Baccalaureate Colleges: Arts & Sciences Focus,Not classified (Exclusively Undergraduate),Very high undergraduate,"Four-year, small, highly residential",24,10,14,0,0,0,24,24,0,0,0,0,0,0,0,0,0,0,0,0,0,0,PA07
214272,Neumann University,Neumann,One Neumann Drive,Aston,PA,19014-1298,-75.440022,39.874876,Private not-for-profit,Graduate degree or certificate offering,No,Suburb: Large,Master's Colleges & Universities: Medium Programs,Research Doctoral: Professional-dominant,High undergraduate,"Four-year, small, primarily residential",905,233,672,3,1,2,905,219,465,221,116,26,90,0,0,0,9,2,7,0,0,0,PA05
214564,Salus University, ,8360 Old York Rd,Elkins Park,PA,19027-6262,-75.129511,40.085774,Private not-for-profit,Graduate degree or certificate offering,No,Suburb: Large,Special Focus Four-Year: Other Health Professions Schools,Research Doctoral: Single program-Other,Exclusively graduate,Exclusively graduate/professional,1407,289,1118,112,33,79,1407,16,217,1174,193,18,175,9,4,5,1,0,1,0,0,0,PA04
214883,Peirce College, ,1420 Pine Street,Philadelphia,PA,19102-4699,-75.166332,39.945483,Private not-for-profit,Graduate degree or certificate offering,No,City: Large,Baccalaureate Colleges: Diverse Fields,"Postbaccalaureate: Business-dominant, with other professional programs",Very high undergraduate,"Four-year, very small, primarily nonresidential",132,28,104,4,0,4,132,132,0,0,30,4,26,0,0,0,0,0,0,0,0,0,PA03
214971,Pennsylvania Academy of the Fine Arts,PAFA,128 N. Broad Street,Philadelphia,PA,19102-1510,-75.163456,39.955692,Private not-for-profit,Graduate degree or certificate offering,No,City: Large,"Special Focus Four-Year: Arts, Music & Design Schools",Postbaccalaureate: Single program-Other,Majority undergraduate,"Four-year, very small, primarily nonresidential",65,19,46,3,0,3,65,6,52,7,27,7,20,3,0,3,0,0,0,0,0,0,PA03
215062,University of Pennsylvania,"Penn, U of PA, U-Penn, U of P, Pennsylvania, UPenn, Pennsylvania University, University of Pennsylvania, Wharton, Wharton School of Business",34th & Spruce Street,Philadelphia,PA,19104-6303,-75.19391,39.950929,Private not-for-profit,Graduate degree or certificate offering,No,City: Large,Doctoral Universities: Very High Research Activity,"Research Doctoral: Comprehensive programs, with medical/veterinary school",Majority graduate,"Four-year, large, highly residential",17602,7780,9822,4184,2025,2159,17602,8105,4666,4831,4299,1820,2479,1432,646,786,555,282,273,172,114,58,PA03
215105,The University of the Arts,UArts,320 South Broad St,Philadelphia,PA,19102-4901,-75.165888,39.946017,Private not-for-profit,Graduate degree or certificate offering,No,City: Large,"Special Focus Four-Year: Arts, Music & Design Schools","Postbaccalaureate: Education-dominant, with Arts & Sciences",Very high undergraduate,"Four-year, small, primarily residential",253,80,173,18,9,9,253,253,0,0,84,31,53,5,4,1,0,0,0,0,0,0,PA03
215114,Cairn University-Langhorne,Cairn,200 Manor Ave,Langhorne,PA,19047-2990,-74.909509,40.165809,Private not-for-profit,Graduate degree or certificate offering,No,Suburb: Large,Master's Colleges & Universities: Medium Programs,"Postbaccalaureate: Education-dominant, with Arts & Sciences",High undergraduate,"Four-year, very small, highly residential",370,127,243,11,3,8,370,194,54,122,128,46,82,4,0,4,0,0,0,0,0,0,PA01
215123,Philadelphia College of Osteopathic Medicine, ,4170 City Ave,Philadelphia,PA,19131,-75.216092,40.004885,Private not-for-profit,Graduate degree or certificate offering,No,City: Large,Special Focus Four-Year: Medical Schools & Centers,"Postbaccalaureate: Other-dominant, with Arts & Sciences",Exclusively graduate,Exclusively graduate/professional,3336,1216,2120,12,3,9,3336,42,0,3294,273,51,222,0,0,0,0,0,0,0,0,0,PA03
215132,University of the Sciences,USciences,600 South 43rd Street,Philadelphia,PA,19104-4495,-75.207001,39.946412,Private not-for-profit,Graduate degree or certificate offering,No,City: Large,Doctoral/Professional Universities,Research Doctoral: STEM-dominant,Majority undergraduate,"Four-year, small, primarily residential",1089,331,758,49,16,33,1089,119,572,398,33,10,23,0,0,0,17,8,9,5,1,4,PA03
215293,University of Pittsburgh-Pittsburgh Campus, ,4200 Fifth Avenue,Pittsburgh,PA,15260,-79.953254,40.444388,Public,Graduate degree or certificate offering,No,City: Large,Doctoral Universities: Very High Research Activity,"Research Doctoral: Comprehensive programs, with medical/veterinary school",Majority undergraduate,"Four-year, large, primarily residential",10602,4356,6246,2120,1147,973,10602,616,1237,8749,1869,754,1115,487,259,228,353,182,171,146,92,54,PA12
215424,Pittsburgh Theological Seminary, ,616 N Highland Ave,Pittsburgh,PA,15206-2596,-79.921397,40.467347,Private not-for-profit,Graduate degree or certificate offering,No,City: Large,Special Focus Four-Year: Faith-Related Institutions,Research Doctoral: Single program-Other,Exclusively graduate,Exclusively graduate/professional,213,108,105,5,2,3,213,159,54,0,37,13,24,2,1,1,10,6,4,2,1,1,PA12
215442,Point Park University, ,201 Wood St,Pittsburgh,PA,15222-1984,-80.002061,40.438768,Private not-for-profit,Graduate degree or certificate offering,No,City: Large,Doctoral/Professional Universities,Research Doctoral: Professional-dominant,High undergraduate,"Four-year, small, primarily residential",1137,416,721,37,26,11,1137,822,195,120,249,98,151,16,10,6,44,16,28,0,0,0,PA12
215619,Reconstructionist Rabbinical College,RRC,1299 Church Rd,Wyncote,PA,19095-1898,-75.149506,40.087689,Private not-for-profit,Graduate degree or certificate offering,No,Suburb: Large,Special Focus Four-Year: Faith-Related Institutions,Postbaccalaureate: Arts & sciences-dominant,Exclusively graduate,Exclusively graduate/professional,43,16,27,0,0,0,43,43,0,0,6,1,5,0,0,0,0,0,0,0,0,0,PA04
215655,Robert Morris University, ,6001 University Boulevard,Moon Township,PA,15108-1189,-80.210468,40.520415,Private not-for-profit,Graduate degree or certificate offering,No,Suburb: Large,Doctoral/Professional Universities,Research Doctoral: Professional-dominant,Very high undergraduate,"Four-year, medium, highly residential",1085,467,618,57,39,18,1085,730,239,116,374,189,185,31,21,10,28,14,14,0,0,0,PA17
215691,Rosemont College, ,1400 Montgomery Ave,Rosemont,PA,19010-1699,-75.32925,40.033417,Private not-for-profit,Graduate degree or certificate offering,No,Suburb: Large,Master's Colleges & Universities: Medium Programs,"Postbaccalaureate: Other-dominant, with Arts & Sciences",Majority undergraduate,"Four-year, very small, primarily residential",361,91,270,4,0,4,361,56,303,2,105,22,83,1,0,1,0,0,0,0,0,0,PA05
215743,Saint Francis University, ,117 Evergreen Dr,Loretto,PA,15940,-78.63904,40.506734,Private not-for-profit,Graduate degree or certificate offering,No,Town: Fringe,Master's Colleges & Universities: Larger Programs,"Postbaccalaureate: Other-dominant, with other professional programs",High undergraduate,"Four-year, small, highly residential",724,230,494,0,0,0,724,429,277,18,329,85,244,0,0,0,0,0,0,0,0,0,PA13
215770,Saint Joseph's University, ,5600 City Avenue,Philadelphia,PA,19131-1395,-75.238343,39.994442,Private not-for-profit,Graduate degree or certificate offering,No,City: Large,Master's Colleges & Universities: Larger Programs,Research Doctoral: Single program-Education,High undergraduate,"Four-year, medium, highly residential",3340,1146,2194,170,57,113,3340,2757,497,86,997,363,634,93,33,60,10,3,7,0,0,0,PA03
215798,Saint Vincent College, ,300 Fraser Purchase Rd,Latrobe,PA,15650-2690,-79.403762,40.29265,Private not-for-profit,Graduate degree or certificate offering,No,Suburb: Large,Baccalaureate Colleges: Arts & Sciences Focus,"Postbaccalaureate: Other-dominant, with Arts & Sciences",Very high undergraduate,"Four-year, small, highly residential",230,79,151,2,1,1,230,0,154,76,83,26,57,2,1,1,0,0,0,0,0,0,PA14
215813,Saint Vincent Seminary, ,300 Fraser Purchase Rd,Latrobe,PA,15650-2690,-79.403762,40.29265,Private not-for-profit,Graduate degree or certificate offering,No,Suburb: Large,Special Focus Four-Year: Faith-Related Institutions,"Postbaccalaureate: Other-dominant, with Arts & Sciences",Exclusively graduate,Exclusively graduate/professional,66,54,12,10,10,0,66,20,2,44,9,9,0,1,1,0,0,0,0,0,0,0,PA14
215929,University of Scranton, ,800 Linden Street,Scranton,PA,18510-4699,-75.656915,41.406556,Private not-for-profit,Graduate degree or certificate offering,No,City: Small,Master's Colleges & Universities: Larger Programs,"Postbaccalaureate: Business-dominant, with Arts & Sciences",High undergraduate,"Four-year, medium, highly residential",1627,621,1006,77,50,27,1627,1086,494,47,501,176,325,18,10,8,10,7,3,0,0,0,PA08
215947,Seton Hill University, ,1 Seton Hill Drive,Greensburg,PA,15601,-79.557433,40.309407,Private not-for-profit,Graduate degree or certificate offering,No,Suburb: Large,Master's Colleges & Universities: Medium Programs,"Postbaccalaureate: Other-dominant, with Arts & Sciences",High undergraduate,"Four-year, small, highly residential",435,122,313,0,0,0,435,154,123,158,152,37,115,0,0,0,0,0,0,0,0,0,PA14
216010,Shippensburg University of Pennsylvania,Ship|SU|Shipensburg|Shippenburg|Shipenburg,1871 Old Main Drive,Shippensburg,PA,17257-2299,-77.522335,40.057933,Public,Graduate degree or certificate offering,No,Town: Fringe,Master's Colleges & Universities: Larger Programs,Postbaccalaureate: Comprehensive programs,Very high undergraduate,"Four-year, medium, primarily residential",1087,381,706,17,11,6,1087,848,176,63,237,76,161,14,9,5,0,0,0,0,0,0,PA13
216038,Slippery Rock University of Pennsylvania, ,1 Morrow Way,Slippery Rock,PA,16057-1383,-80.045965,41.062719,Public,Graduate degree or certificate offering,No,Town: Distant,Master's Colleges & Universities: Larger Programs,Research Doctoral: Single program-Education,High undergraduate,"Four-year, medium, primarily residential",2020,454,1566,6,4,2,2020,1499,454,67,438,104,334,1,0,1,9,2,7,0,0,0,PA16
216047,Saint Charles Borromeo Seminary-Overbrook, ,100 East Wynnewood Road,Wynnewood,PA,19096,-75.255675,39.99133,Private not-for-profit,Graduate degree or certificate offering,No,Suburb: Large,Special Focus Four-Year: Faith-Related Institutions,"Postbaccalaureate: Other-dominant, with Arts & Sciences",Majority graduate,"Four-year, very small, highly residential",175,145,30,16,16,0,175,0,0,175,49,46,3,8,8,0,0,0,0,0,0,0,PA05
216278,Susquehanna University,Susquahanna|Susquehana|Sesquehanna,514 University Ave,Selinsgrove,PA,17870-1025,-76.875329,40.797502,Private not-for-profit,Graduate degree or certificate offering,No,Town: Distant,Baccalaureate Colleges: Arts & Sciences Focus,Not classified (Exclusively Undergraduate),Very high undergraduate,"Four-year, small, highly residential",7,0,7,0,0,0,7,0,6,1,1,0,1,0,0,0,0,0,0,0,0,0,PA15
216339,Temple University,Temple,1801 North Broad Street,Philadelphia,PA,19122-6096,-75.156859,39.980546,Public,Graduate degree or certificate offering,No,City: Large,Doctoral Universities: Very High Research Activity,"Research Doctoral: Comprehensive programs, with medical/veterinary school",High undergraduate,"Four-year, large, primarily nonresidential",11085,4660,6425,1143,567,576,11085,3191,5655,2239,1958,807,1151,297,143,154,216,98,118,65,34,31,PA02
216348,Theological Seminary of the Reformed Episcopal Church,Reformed Episcopal Seminary,826 Second Avenue,Blue Bell,PA,19422-1257,-75.290124,40.168935,Private not-for-profit,Graduate degree or certificate offering,No,Suburb: Large,Special Focus Four-Year: Faith-Related Institutions,Postbaccalaureate: Single program-Other,Exclusively graduate,Exclusively graduate/professional,19,15,4,2,2,0,19,1,18,0,3,2,1,0,0,0,0,0,0,0,0,0,PA04
216357,Thiel College, ,75 College Ave,Greenville,PA,16125-2181,-80.384383,41.41354,Private not-for-profit,Graduate degree or certificate offering,No,Town: Fringe,Baccalaureate Colleges: Diverse Fields,Not classified (Exclusively Undergraduate),Very high undergraduate,"Four-year, very small, highly residential",24,11,13,0,0,0,24,0,0,24,8,6,2,0,0,0,0,0,0,0,0,0,PA16
216366,Thomas Jefferson University,"Jefferson (Philadelphia University + Thomas Jefferson University), Philadelphia University, PhilaU, Jefferson",1020 Walnut Street,Philadelphia,PA,19107,-75.158266,39.948274,Private not-for-profit,Graduate degree or certificate offering,No,City: Large,Doctoral Universities: High Research Activity,Research Doctoral: Single program-Other,Majority undergraduate,"Four-year, medium, highly residential",5437,1551,3886,209,99,110,5437,1372,2406,1659,954,218,736,112,55,57,16,6,10,2,1,1,PA02
216463,Trinity Episcopal School for Ministry,Trinity School for Ministry,311 Eleventh St,Ambridge,PA,15003-2397,-80.230178,40.593403,Private not-for-profit,Graduate degree or certificate offering,No,Suburb: Large,Special Focus Four-Year: Faith-Related Institutions,"Postbaccalaureate: Other-dominant, with Arts & Sciences",Exclusively graduate,Exclusively graduate/professional,229,159,70,18,12,6,229,103,27,99,30,21,9,4,4,0,0,0,0,0,0,0,PA17
216542,University of Valley Forge,VFCC; UVF,1401 Charlestown Road,Phoenixville,PA,19460-2373,-75.5469,40.117835,Private not-for-profit,Graduate degree or certificate offering,No,Suburb: Large,Baccalaureate Colleges: Diverse Fields,"Postbaccalaureate: Other-dominant, with other professional programs",Very high undergraduate,"Four-year, very small, highly residential",99,54,45,2,0,2,99,84,15,0,19,13,6,1,0,1,0,0,0,0,0,0,PA06
216597,Villanova University, ,800 Lancaster Avenue,Villanova,PA,19085-1699,-75.340502,40.036463,Private not-for-profit,Graduate degree or certificate offering,No,Suburb: Large,Doctoral Universities: High Research Activity,Research Doctoral: STEM-dominant,High undergraduate,"Four-year, medium, highly residential",5072,2387,2685,282,152,130,5072,1808,2763,501,1363,655,708,95,42,53,31,18,13,14,8,6,PA05
216667,Washington & Jefferson College,W&J|Washington & Jefferson College,60 S Lincoln St,Washington,PA,15301,-80.24049,40.170622,Private not-for-profit,Graduate degree or certificate offering,No,Suburb: Large,Baccalaureate Colleges: Arts & Sciences Focus,Not classified (Exclusively Undergraduate),Very high undergraduate,"Four-year, small, highly residential",2,1,1,0,0,0,2,0,0,2,0,0,0,0,0,0,0,0,0,0,0,0,PA14
216694,Waynesburg University, ,51 W College St,Waynesburg,PA,15370-1257,-80.186205,39.899871,Private not-for-profit,Graduate degree or certificate offering,No,Town: Distant,Master's Colleges & Universities: Medium Programs,Research Doctoral: Single program-Other,High undergraduate,"Four-year, small, highly residential",405,131,274,1,0,1,405,213,40,152,108,55,53,0,0,0,7,1,6,0,0,0,PA14
216764,West Chester University of Pennsylvania,WCU,University Avenue and High Street,West Chester,PA,19383,-75.59812,39.953398,Public,Graduate degree or certificate offering,No,Suburb: Large,Doctoral Universities: High Research Activity,Research Doctoral: Professional-dominant,High undergraduate,"Four-year, large, primarily residential",3736,1177,2559,52,16,36,3736,3100,601,35,989,320,669,23,8,15,36,12,24,0,0,0,PA06
216807,Westminster College, ,319 South Market  Street,New Wilmington,PA,16172,-80.331017,41.119272,Private not-for-profit,Graduate degree or certificate offering,No,Town: Fringe,Baccalaureate Colleges: Arts & Sciences Focus,Postbaccalaureate: Single program-Education,Very high undergraduate,"Four-year, small, highly residential",102,36,66,0,0,0,102,102,0,0,37,16,21,0,0,0,0,0,0,0,0,0,PA16
216816,Westminster Theological Seminary, ,2960 W Church Rd,Glenside,PA,19038,-75.176327,40.09815,Private not-for-profit,Graduate degree or certificate offering,No,Suburb: Large,Special Focus Four-Year: Faith-Related Institutions,Research Doctoral: Single program-Other,Exclusively graduate,Exclusively graduate/professional,998,659,339,138,116,22,998,511,79,408,146,97,49,37,31,6,6,6,0,1,1,0,PA04
216852,Widener University, ,One University Place,Chester,PA,19013-5792,-75.355363,39.861689,Private not-for-profit,Graduate degree or certificate offering,No,Suburb: Large,Doctoral/Professional Universities,Research Doctoral: Professional-dominant,Majority undergraduate,"Four-year, medium, highly residential",3803,1024,2779,136,69,67,3803,2829,948,26,577,109,468,16,3,13,64,26,38,22,15,7,PA05
216931,Wilkes University,Wilkes,84 West South Street,Wilkes-Barre,PA,18766,-75.890262,41.244199,Private not-for-profit,Graduate degree or certificate offering,No,City: Small,Doctoral/Professional Universities,Research Doctoral: Single program-Education,Majority undergraduate,"Four-year, medium, highly residential",4044,958,3086,4,3,1,4044,3728,311,5,634,171,463,3,2,1,41,13,28,0,0,0,PA08
217013,Wilson College, ,1015 Philadelphia Ave,Chambersburg,PA,17201-1285,-77.650712,39.949659,Private not-for-profit,Graduate degree or certificate offering,No,City: Small,Master's Colleges & Universities: Medium Programs,"Postbaccalaureate: Education-dominant, with Arts & Sciences",High undergraduate,"Four-year, very small, highly residential",1151,253,898,1,1,0,1151,1146,5,0,178,30,148,1,1,0,0,0,0,0,0,0,PA13
217040,Yeshivath Beth Moshe, ,930 Hickory St,Scranton,PA,18505-2196,-75.656191,41.394852,Private not-for-profit,Graduate degree or certificate offering,No,City: Small,Special Focus Four-Year: Faith-Related Institutions,Not classified (Exclusively Undergraduate),Very high undergraduate,"Four-year, very small, highly residential",3,3,0,0,0,0,3,0,0,3,0,0,0,0,0,0,0,0,0,0,0,0,PA08
217059,York College of Pennsylvania,YCP,441 Country Club Rd,York,PA,17403-3651,-76.727984,39.94614,Private not-for-profit,Graduate degree or certificate offering,No,Suburb: Midsize,Master's Colleges & Universities: Small Programs,"Postbaccalaureate: Business-dominant, with other professional programs",Very high undergraduate,"Four-year, medium, highly residential",444,139,305,5,4,1,444,53,199,192,107,49,58,2,1,1,0,0,0,0,0,0,PA10
217156,Brown University, ,One Prospect Street,Providence,RI,02912,-71.40385,41.82617,Private not-for-profit,Graduate degree or certificate offering,No,City: Midsize,Doctoral Universities: Very High Research Activity,"Research Doctoral: Comprehensive programs, with medical/veterinary school",Majority undergraduate,"Four-year, medium, highly residential",3265,1628,1637,996,576,420,3265,290,1488,1487,752,376,376,261,148,113,173,102,71,80,57,23,RI01
217165,Bryant University, ,1150 Douglas Pike,Smithfield,RI,02917-1291,-71.539547,41.920092,Private not-for-profit,Graduate degree or certificate offering,No,Suburb: Large,Master's Colleges & Universities: Larger Programs,"Postbaccalaureate: Business-dominant, with Arts & Sciences",Very high undergraduate,"Four-year, medium, highly residential",638,301,337,31,12,19,638,196,142,300,218,95,123,20,7,13,0,0,0,0,0,0,RI01
217235,Johnson & Wales University-Providence, ,8 Abbott Park Place,Providence,RI,02903-3703,-71.41277,41.819956,Private not-for-profit,Graduate degree or certificate offering,No,City: Midsize,Master's Colleges & Universities: Larger Programs,Research Doctoral: Single program-Education,Very high undergraduate,"Four-year, medium, highly residential",642,205,437,106,48,58,642,221,94,327,224,80,144,56,26,30,15,3,12,0,0,0,RI02
217305,New England Institute of Technology,New England Tech,One New England Tech Boulevard,East Greenwich,RI,02818-1205,-71.502892,41.661783,Private not-for-profit,Graduate degree or certificate offering,No,Suburb: Large,Master's Colleges & Universities: Small Programs,"Postbaccalaureate: Other-dominant, with Arts & Sciences",Very high undergraduate,"Four-year, small, primarily nonresidential",233,66,167,11,7,4,233,52,81,100,70,27,43,8,5,3,0,0,0,0,0,0,RI02
217402,Providence College, ,1 Cunningham Square,Providence,RI,02918-0001,-71.437446,41.842742,Private not-for-profit,Graduate degree or certificate offering,No,City: Midsize,Master's Colleges & Universities: Larger Programs,"Postbaccalaureate: Education-dominant, with Arts & Sciences",Very high undergraduate,"Four-year, medium, highly residential",680,269,411,11,5,6,680,111,463,106,234,100,134,6,2,4,0,0,0,0,0,0,RI02
217420,Rhode Island College,RIC|RI College|R.I. College|,600 Mount Pleasant Ave,Providence,RI,02908,-71.46556,41.842415,Public,Graduate degree or certificate offering,No,Suburb: Large,Master's Colleges & Universities: Larger Programs,Research Doctoral: Single program-Education,Very high undergraduate,"Four-year, medium, primarily nonresidential",1439,305,1134,1,0,1,1439,1091,322,26,298,54,244,0,0,0,2,1,1,0,0,0,RI01
217484,University of Rhode Island,URI,"Green Hall, 35 Campus Avenue",Kingston,RI,02881,-71.527356,41.484691,Public,Graduate degree or certificate offering,No,Suburb: Large,Doctoral Universities: High Research Activity,"Research Doctoral: Comprehensive programs, no medical/veterinary school",High undergraduate,"Four-year, large, primarily residential",3202,1242,1960,320,168,152,3202,475,1891,836,556,226,330,46,28,18,88,38,50,29,17,12,RI02
217493,Rhode Island School of Design,RISD,2 College St,Providence,RI,02903-2784,-71.407692,41.825935,Private not-for-profit,Graduate degree or certificate offering,No,City: Midsize,Master's Colleges & Universities: Larger Programs,"Postbaccalaureate: Other-dominant, with Arts & Sciences",High undergraduate,"Four-year, small, highly residential",510,171,339,264,75,189,510,10,396,104,211,69,142,123,34,89,0,0,0,0,0,0,RI01
217518,Roger Williams University,RWU,One Old Ferry Road,Bristol,RI,02809-2921,-71.260374,41.650214,Private not-for-profit,Graduate degree or certificate offering,No,Suburb: Large,Master's Colleges & Universities: Medium Programs,"Postbaccalaureate: Other-dominant, with Arts & Sciences",Very high undergraduate,"Four-year, medium, highly residential",402,164,238,9,3,6,402,68,259,75,162,65,97,4,2,2,0,0,0,0,0,0,RI01
217536,Salve Regina University, ,100 Ochre Point Avenue,Newport,RI,02840-4192,-71.30124,41.471545,Private not-for-profit,Graduate degree or certificate offering,No,Suburb: Large,Master's Colleges & Universities: Larger Programs,Research Doctoral: Single program-Other,High undergraduate,"Four-year, small, highly residential",818,307,511,7,3,4,818,576,218,24,229,88,141,1,1,0,5,3,2,0,0,0,RI01
217606,Northpoint Bible College, ,320 South Main Street,Haverhill,MA,01835,-71.079335,42.765357,Private not-for-profit,Graduate degree or certificate offering,No,Suburb: Large,Special Focus Four-Year: Faith-Related Institutions,Postbaccalaureate: Single program-Other,Very high undergraduate,"Four-year, very small, primarily residential",38,29,9,1,1,0,38,0,0,38,9,8,1,0,0,0,0,0,0,0,0,0,MA03
217624,Allen University,Allen University,1530 Harden Street,Columbia,SC,29204,-81.020045,34.010348,Private not-for-profit,Graduate degree or certificate offering,Yes,City: Midsize,Baccalaureate Colleges: Arts & Sciences Focus,Postbaccalaureate: Single program-Other,Very high undergraduate,"Four-year, very small, highly residential",131,59,72,2,0,2,131,0,131,0,13,6,7,0,0,0,0,0,0,0,0,0,SC06
217633,Anderson University,AU,316 Boulevard,Anderson,SC,29621-4035,-82.640358,34.5152,Private not-for-profit,Graduate degree or certificate offering,No,City: Small,Master's Colleges & Universities: Larger Programs,Research Doctoral: Single program-Other,High undergraduate,"Four-year, medium, highly residential",1006,437,569,24,9,15,1006,634,64,308,244,70,174,1,0,1,6,6,0,0,0,0,SC03
217688,Charleston Southern University,CSU|CHARLESTON SOUTHERN|,9200 University Blvd,Charleston,SC,29406-9121,-80.072587,32.983047,Private not-for-profit,Graduate degree or certificate offering,No,City: Midsize,Master's Colleges & Universities: Medium Programs,"Postbaccalaureate: Business-dominant, with Arts & Sciences",High undergraduate,"Four-year, small, highly residential",865,329,536,29,16,13,865,441,68,356,183,66,117,6,4,2,0,0,0,0,0,0,SC06
217721,Benedict College, ,1600 Harden Street,Columbia,SC,29204-1086,-81.020403,34.012941,Private not-for-profit,Graduate degree or certificate offering,Yes,City: Midsize,Baccalaureate Colleges: Diverse Fields,Postbaccalaureate: Single program-Business,Very high undergraduate,"Four-year, small, highly residential",12,8,4,0,0,0,12,0,12,0,0,0,0,0,0,0,0,0,0,0,0,0,SC06
217749,Bob Jones University, ,1700 Wade Hampton Boulavard,Greenville,SC,29614-0001,-82.365838,34.874016,Private not-for-profit,Graduate degree or certificate offering,No,City: Small,Master's Colleges & Universities: Small Programs,Research Doctoral: Professional-dominant,Very high undergraduate,"Four-year, small, highly residential",615,331,284,65,44,21,615,284,118,213,94,52,42,19,13,6,3,3,0,0,0,0,SC04
217776,Southern Wesleyan University,SWU,907 Wesleyan Drive,Central,SC,29630-1020,-82.761586,34.728068,Private not-for-profit,Graduate degree or certificate offering,No,Suburb: Large,Master's Colleges & Universities: Small Programs,"Postbaccalaureate: Business-dominant, with other professional programs",High undergraduate,"Four-year, very small, primarily residential",344,73,271,0,0,0,344,344,0,0,101,25,76,0,0,0,0,0,0,0,0,0,SC03
217819,College of Charleston, ,66 George St,Charleston,SC,29424-0001,-79.939794,32.784225,Public,Graduate degree or certificate offering,No,City: Midsize,Master's Colleges & Universities: Medium Programs,"Postbaccalaureate: Business-dominant, with Arts & Sciences",Very high undergraduate,"Four-year, medium, primarily residential",2146,491,1655,29,9,20,2146,1671,313,162,231,82,149,3,1,2,0,0,0,0,0,0,SC06
217864,Citadel Military College of South Carolina, ,171 Moultrie St,Charleston,SC,29409,-79.958775,32.797183,Public,Graduate degree or certificate offering,No,City: Midsize,Master's Colleges & Universities: Larger Programs,Postbaccalaureate: Comprehensive programs,High undergraduate,"Four-year, medium, highly residential",1302,649,653,5,2,3,1302,696,441,165,283,159,124,2,2,0,0,0,0,0,0,0,SC06
217873,Claflin University, ,400 Magnolia Street,Orangeburg,SC,29115-4498,-80.854319,33.498444,Private not-for-profit,Graduate degree or certificate offering,Yes,Town: Distant,Baccalaureate Colleges: Arts & Sciences Focus,"Postbaccalaureate: Other-dominant, with Arts & Sciences",Very high undergraduate,"Four-year, small, highly residential",88,22,66,7,2,5,88,63,0,25,35,5,30,0,0,0,0,0,0,0,0,0,SC06
217882,Clemson University, ,201 Sikes Hall,Clemson,SC,29634,-82.835114,34.679381,Public,Graduate degree or certificate offering,No,Suburb: Large,Doctoral Universities: Very High Research Activity,"Research Doctoral: Comprehensive programs, no medical/veterinary school",High undergraduate,"Four-year, large, primarily residential",6843,3280,3563,1462,1005,457,6843,3055,3158,630,1817,863,954,353,270,83,225,120,105,110,68,42,SC03
217907,Coker University,Coker,300 E College Ave,Hartsville,SC,29550,-80.070416,34.37696,Private not-for-profit,Graduate degree or certificate offering,No,Town: Distant,Master's Colleges & Universities: Small Programs,"Postbaccalaureate: Business-dominant, with Arts & Sciences",High undergraduate,"Four-year, small, highly residential",175,65,110,1,0,1,175,175,0,0,70,28,42,1,0,1,0,0,0,0,0,0,SC07
217925,Columbia International University,CIU,7435 Monticello Rd,Columbia,SC,29203-1513,-81.07443,34.07551,Private not-for-profit,Graduate degree or certificate offering,No,City: Midsize,Master's Colleges & Universities: Medium Programs,Research Doctoral: Professional-dominant,Majority undergraduate,"Four-year, small, highly residential",1792,838,954,246,106,140,1792,1581,160,51,218,92,126,74,21,53,27,18,9,3,2,1,SC06
217934,Columbia College, ,1301 Columbia College Dr,Columbia,SC,29203,-81.029967,34.045581,Private not-for-profit,Graduate degree or certificate offering,No,City: Midsize,Master's Colleges & Universities: Small Programs,"Postbaccalaureate: Education-dominant, with other professional programs",High undergraduate,"Four-year, very small, primarily residential",395,65,330,5,0,5,395,291,78,26,160,19,141,2,0,2,0,0,0,0,0,0,SC06
217961,Converse University, ,580 E Main St,Spartanburg,SC,29302-0006,-81.917881,34.955534,Private not-for-profit,Graduate degree or certificate offering,No,City: Small,Master's Colleges & Universities: Small Programs,"Postbaccalaureate: Education-dominant, with Arts & Sciences",Majority undergraduate,"Four-year, small, highly residential",1454,264,1190,20,5,15,1454,1057,286,111,97,15,82,2,0,2,25,10,15,0,0,0,SC04
217998,Erskine College,Erskine College and Seminary,2 Washington St,Due West,SC,29639,-82.39095,34.332087,Private not-for-profit,Graduate degree or certificate offering,No,Rural: Distant,Doctoral/Professional Universities,Research Doctoral: Single program-Other,Very high undergraduate,"Four-year, very small, highly residential",189,143,46,0,0,0,189,45,78,66,22,17,5,0,0,0,9,7,2,0,0,0,SC03
218061,Francis Marion University, ,4822 East Palmetto Street,Florence,SC,29506,-79.652854,34.189777,Public,Graduate degree or certificate offering,No,Suburb: Small,Master's Colleges & Universities: Medium Programs,"Postbaccalaureate: Other-dominant, with other professional programs",Very high undergraduate,"Four-year, medium, highly residential",763,151,612,5,4,1,763,391,301,71,180,34,146,1,1,0,0,0,0,0,0,0,SC07
218070,Furman University,Furman University,3300 Poinsett Highway,Greenville,SC,29613-6162,-82.440458,34.924676,Private not-for-profit,Graduate degree or certificate offering,No,Suburb: Large,Baccalaureate Colleges: Arts & Sciences Focus,"Postbaccalaureate: Education-dominant, with Arts & Sciences",Very high undergraduate,"Four-year, small, highly residential",307,58,249,1,1,0,307,45,41,221,62,16,46,1,1,0,0,0,0,0,0,0,SC04
218229,Lander University, ,320 Stanley Avenue,Greenwood,SC,29649-2099,-82.164736,34.199892,Public,Graduate degree or certificate offering,No,Town: Distant,Baccalaureate Colleges: Diverse Fields,"Postbaccalaureate: Education-dominant, with other professional programs",Very high undergraduate,"Four-year, medium, highly residential",256,62,194,0,0,0,256,239,7,10,46,11,35,0,0,0,0,0,0,0,0,0,SC03
218238,Limestone University, ,1115 College Drive,Gaffney,SC,29340-3799,-81.649161,35.057076,Private not-for-profit,Graduate degree or certificate offering,No,Town: Fringe,Baccalaureate Colleges: Diverse Fields,Postbaccalaureate: Single program-Business,Very high undergraduate,"Four-year, small, primarily residential",183,76,107,13,12,1,183,183,0,0,32,19,13,2,2,0,0,0,0,0,0,0,SC05
218335,Medical University of South Carolina,MUSC,179 Ashley Ave,Charleston,SC,29425,-79.947158,32.784363,Public,Graduate degree or certificate offering,No,City: Midsize,Special Focus Four-Year: Research Institutions,Research Doctoral: Professional-dominant,Majority graduate,"Four-year, small, primarily nonresidential",3216,1113,2103,70,31,39,3216,660,0,2556,294,71,223,7,3,4,181,58,123,5,5,0,SC06
218441,North Greenville University, ,7801 N. Tigerville Road,Tigerville,SC,29688-1892,-82.37026,35.069758,Private not-for-profit,Graduate degree or certificate offering,No,Rural: Fringe,Master's Colleges & Universities: Small Programs,Research Doctoral: Professional-dominant,High undergraduate,"Four-year, small, highly residential",381,190,191,5,5,0,381,140,109,132,96,49,47,3,3,0,9,6,3,0,0,0,SC04
218539,Presbyterian College,PC,503 South Broad Street,Clinton,SC,29325,-81.87448,34.465834,Private not-for-profit,Graduate degree or certificate offering,No,Town: Distant,Baccalaureate Colleges: Arts & Sciences Focus,Postbaccalaureate: Single program-Other,High undergraduate,"Four-year, small, highly residential",274,73,201,1,0,1,274,0,8,266,0,0,0,0,0,0,0,0,0,0,0,0,SC03
218645,University of South Carolina Aiken,"University of South Carolina Aiken, USC Aiken, USCA, USC Aiken, University of South Carolina at Aiken, UofSC Aiken",471 University Pkwy,Aiken,SC,29801,-81.767612,33.572704,Public,Graduate degree or certificate offering,No,Suburb: Large,Master's Colleges & Universities: Small Programs,"Postbaccalaureate: Business-dominant, with Arts & Sciences",High undergraduate,"Four-year, medium, primarily residential",1168,394,774,43,18,25,1168,1146,20,2,114,54,60,2,2,0,0,0,0,0,0,0,SC02
218654,University of South Carolina Beaufort,USC Beaufort,1 University Boulevard,Bluffton,SC,29909,-80.973595,32.303308,Public,Graduate degree or certificate offering,No,Town: Fringe,Baccalaureate Colleges: Diverse Fields,Not classified (Exclusively Undergraduate),Very high undergraduate,"Four-year, small, highly residential",8,5,3,1,0,1,8,1,2,5,0,0,0,0,0,0,0,0,0,0,0,0,SC01
218663,University of South Carolina-Columbia, ,Columbia-Campus,Columbia,SC,29208,-81.026935,33.996788,Public,Graduate degree or certificate offering,No,City: Midsize,Doctoral Universities: Very High Research Activity,"Research Doctoral: Comprehensive programs, with medical/veterinary school",High undergraduate,"Four-year, large, primarily residential",9630,3663,5967,1100,631,469,9630,4841,3405,1384,1659,565,1094,158,96,62,351,159,192,103,63,40,SC06
218724,Coastal Carolina University, ,103 Tom Trout Drive,Conway,SC,29526,-79.011767,33.794995,Public,Graduate degree or certificate offering,No,City: Small,Master's Colleges & Universities: Larger Programs,Research Doctoral: Single program-Other,Very high undergraduate,"Four-year, medium, primarily residential",1104,341,763,22,12,10,1104,654,283,167,255,95,160,10,4,6,1,1,0,0,0,0,SC07
218733,South Carolina State University, ,300 College St NE,Orangeburg,SC,29117-0001,-80.848722,33.497968,Public,Graduate degree or certificate offering,Yes,Town: Distant,Master's Colleges & Universities: Small Programs,Research Doctoral: Single program-Education,High undergraduate,"Four-year, small, highly residential",390,85,305,4,3,1,390,176,107,107,103,20,83,0,0,0,12,4,8,0,0,0,SC06
218742,University of South Carolina-Upstate, ,800 University Way,Spartanburg,SC,29303-4999,-81.970583,34.996403,Public,Graduate degree or certificate offering,No,Suburb: Midsize,Baccalaureate Colleges: Diverse Fields,"Postbaccalaureate: Education-dominant, with other professional programs",Very high undergraduate,"Four-year, medium, primarily nonresidential",677,107,570,7,3,4,677,647,20,10,107,20,87,0,0,0,0,0,0,0,0,0,SC04
218751,Sherman College of Chiropractic,Sherman College / SCSC / Sherman College of Chiropractic / Sherman,2020 Springfield Rd,Spartanburg,SC,29316,-81.985878,35.014602,Private not-for-profit,Graduate degree or certificate offering,No,Suburb: Midsize,Special Focus Four-Year: Other Health Professions Schools,Postbaccalaureate: Single program-Other,Exclusively graduate,Exclusively graduate/professional,503,256,247,2,1,1,503,0,376,127,0,0,0,0,0,0,0,0,0,0,0,0,SC04
218964,Winthrop University, ,701 Oakland Ave,Rock Hill,SC,29733,-81.031404,34.941515,Public,Graduate degree or certificate offering,No,City: Small,Master's Colleges & Universities: Larger Programs,"Postbaccalaureate: Education-dominant, with Arts & Sciences",High undergraduate,"Four-year, medium, highly residential",1722,339,1383,83,32,51,1722,1080,547,95,322,65,257,33,14,19,0,0,0,0,0,0,SC05
219000,Augustana University,Augie  Augustana College(SD)  Augustana University,2001 S Summit Ave,Sioux Falls,SD,57197-0001,-96.736975,43.525148,Private not-for-profit,Graduate degree or certificate offering,No,City: Midsize,Master's Colleges & Universities: Medium Programs,"Postbaccalaureate: Education-dominant, with other professional programs",Very high undergraduate,"Four-year, small, highly residential",384,80,304,6,2,4,384,294,34,56,121,23,98,1,0,1,0,0,0,0,0,0,SD00
219046,Black Hills State University,BHSU,1200 University St,Spearfish,SD,57799-9500,-103.870966,44.494889,Public,Graduate degree or certificate offering,No,Town: Distant,Master's Colleges & Universities: Small Programs,"Postbaccalaureate: Education-dominant, with Arts & Sciences",Very high undergraduate,"Four-year, small, primarily residential",482,119,363,7,1,6,482,392,79,11,72,21,51,1,0,1,0,0,0,0,0,0,SD00
219082,Dakota State University,Dakota State,820 N Washington Ave,Madison,SD,57042-1799,-97.113358,44.013014,Public,Graduate degree or certificate offering,No,Town: Distant,Master's Colleges & Universities: Medium Programs,Research Doctoral: Single program-Other,High undergraduate,"Four-year, small, primarily residential",952,485,467,84,59,25,952,757,45,150,123,85,38,25,17,8,14,11,3,0,0,0,SD00
219091,Dakota Wesleyan University, ,1200 W University Ave,Mitchell,SD,57301-4398,-98.031188,43.697432,Private not-for-profit,Graduate degree or certificate offering,No,Town: Remote,Baccalaureate Colleges: Diverse Fields,"Postbaccalaureate: Education-dominant, with other professional programs",High undergraduate,"Four-year, very small, highly residential",359,118,241,1,0,1,359,5,69,285,38,23,15,0,0,0,0,0,0,0,0,0,SD00
219198,Mount Marty University, ,1105 W. 8th Street,Yankton,SD,57078-3724,-97.409904,42.874475,Private not-for-profit,Graduate degree or certificate offering,No,Town: Remote,Master's Colleges & Universities: Small Programs,"Postbaccalaureate: Other-dominant, with other professional programs",High undergraduate,"Four-year, very small, highly residential",270,91,179,4,3,1,270,52,204,14,38,8,30,2,1,1,0,0,0,0,0,0,SD00
219204,National American University-Rapid City, ,5301 Mount Rushmore Road,Rapid City,SD,57701-2823,-103.250223,44.03152,Private for-profit,Graduate degree or certificate offering,No,City: Small,Doctoral/Professional Universities,Research Doctoral: Professional-dominant,Majority undergraduate,"Four-year, very small, primarily nonresidential",468,234,234,0,0,0,468,468,0,0,121,55,66,0,0,0,30,14,16,0,0,0,SD00
219240,Sioux Falls Seminary,North American Baptist Seminary,2100 S Summit Ave,Sioux Falls,SD,57105,-96.735896,43.525446,Private not-for-profit,Graduate degree or certificate offering,No,City: Midsize,Special Focus Four-Year: Faith-Related Institutions,"Postbaccalaureate: Other-dominant, with other professional programs",Majority graduate,Exclusively graduate/professional,726,469,257,3,2,1,726,726,0,0,48,32,16,1,1,0,0,0,0,0,0,0,SD00
219259,Northern State University,NSU,1200 S Jay St,Aberdeen,SD,57401-7198,-98.484728,45.450829,Public,Graduate degree or certificate offering,No,Town: Remote,Master's Colleges & Universities: Small Programs,"Postbaccalaureate: Education-dominant, with other professional programs",High undergraduate,"Four-year, small, highly residential",690,189,501,9,6,3,690,538,92,60,92,29,63,3,1,2,0,0,0,0,0,0,SD00
219277,Oglala Lakota College, ,490 Piya Wiconi Road,Kyle,SD,57752-0490,-102.240331,43.366813,Public,Graduate degree or certificate offering,No,Rural: Remote,Tribal Colleges,"Postbaccalaureate: Other-dominant, with Arts & Sciences",Very high undergraduate,"Four-year, very small, primarily nonresidential",48,17,31,0,0,0,48,47,0,1,4,2,2,0,0,0,0,0,0,0,0,0,SD00
219295,Presentation College, ,1500 N Main,Aberdeen,SD,57401-1280,-98.49129,45.483339,Private not-for-profit,Graduate degree or certificate offering,No,Town: Remote,Baccalaureate Colleges: Diverse Fields,Postbaccalaureate: Single program-Other,Very high undergraduate,"Four-year, very small, primarily residential",28,2,26,0,0,0,28,28,0,0,9,1,8,0,0,0,0,0,0,0,0,0,SD00
219347,South Dakota School of Mines and Technology,South Dakota Mines,501 E Saint Joseph St,Rapid City,SD,57701-3995,-103.205753,44.075439,Public,Graduate degree or certificate offering,No,City: Small,Master's Colleges & Universities: Medium Programs,Research Doctoral: STEM-dominant,High undergraduate,"Four-year, small, highly residential",414,305,109,108,83,25,414,109,105,200,107,79,28,24,20,4,18,13,5,10,7,3,SD00
219356,South Dakota State University, ,1004 Campanile Ave,Brookings,SD,57007-1898,-96.782139,44.317485,Public,Graduate degree or certificate offering,No,Town: Remote,Doctoral Universities: High Research Activity,Research Doctoral: STEM-dominant,Very high undergraduate,"Four-year, medium, highly residential",1758,677,1081,396,240,156,1758,469,570,719,314,135,179,77,49,28,58,34,24,40,27,13,SD00
219374,Sinte Gleska University, ,"E. Highway 18,  101 Antelope Lake Circle",Mission,SD,57555-0105,-100.622549,43.298878,Public,Graduate degree or certificate offering,No,Rural: Remote,Tribal Colleges,"Postbaccalaureate: Education-dominant, with other professional programs",High undergraduate,"Four-year, very small, primarily nonresidential",155,40,115,0,0,0,155,0,0,155,1,0,1,0,0,0,0,0,0,0,0,0,SD00
219383,University of Sioux Falls, ,1101 W 22nd St,Sioux Falls,SD,57105-1699,-96.738229,43.531574,Private not-for-profit,Graduate degree or certificate offering,No,City: Midsize,Master's Colleges & Universities: Medium Programs,"Postbaccalaureate: Business-dominant, with other professional programs",Very high undergraduate,"Four-year, small, highly residential",408,158,250,3,0,3,408,160,183,65,147,64,83,2,0,2,0,0,0,0,0,0,SD00
219471,University of South Dakota,USD,414 E Clark St,Vermillion,SD,57069-2390,-96.925283,42.786019,Public,Graduate degree or certificate offering,No,Town: Distant,Doctoral Universities: High Research Activity,"Research Doctoral: Comprehensive programs, with medical/veterinary school",High undergraduate,"Four-year, medium, primarily residential",3298,1161,2137,126,62,64,3298,1686,789,823,511,191,320,33,17,16,57,26,31,5,3,2,SD00
219602,Austin Peay State University, ,601 College St,Clarksville,TN,37044,-87.354081,36.533319,Public,Graduate degree or certificate offering,No,City: Midsize,Master's Colleges & Universities: Larger Programs,Postbaccalaureate: Comprehensive programs,Very high undergraduate,"Four-year, medium, primarily nonresidential",1530,494,1036,63,41,22,1530,943,503,84,493,159,334,32,21,11,1,0,1,0,0,0,TN07
219639,Baptist Health Sciences University,Baptist College of Health Sciences,1003 Monroe Ave,Memphis,TN,38104,-90.027501,35.138415,Private not-for-profit,Graduate degree or certificate offering,No,City: Large,Special Focus Four-Year: Other Health Professions Schools,Not classified (Exclusively Undergraduate),Very high undergraduate,"Four-year, very small, primarily nonresidential",26,5,21,0,0,0,26,2,23,1,0,0,0,0,0,0,0,0,0,0,0,0,TN09
219709,Belmont University, ,1900 Belmont Blvd,Nashville,TN,37212-3757,-86.794807,36.135589,Private not-for-profit,Graduate degree or certificate offering,No,City: Large,Doctoral/Professional Universities,"Postbaccalaureate: Other-dominant, with Arts & Sciences",High undergraduate,"Four-year, medium, highly residential",1800,554,1246,20,8,12,1800,1,760,1039,280,113,167,4,1,3,0,0,0,0,0,0,TN07
219718,Bethel University,Bethel,325 Cherry Ave,McKenzie,TN,38201,-88.516762,36.137848,Private not-for-profit,Graduate degree or certificate offering,No,Town: Distant,Master's Colleges & Universities: Larger Programs,"Postbaccalaureate: Business-dominant, with other professional programs",High undergraduate,"Four-year, small, primarily residential",715,247,468,2,0,2,715,715,0,0,216,78,138,0,0,0,0,0,0,0,0,0,TN08
219790,Bryan College-Dayton,William Jennings Bryan College,721 Bryan Drive,Dayton,TN,37321,-84.999552,35.497209,Private not-for-profit,Graduate degree or certificate offering,No,Town: Distant,Master's Colleges & Universities: Small Programs,"Postbaccalaureate: Business-dominant, with Arts & Sciences",High undergraduate,"Four-year, very small, highly residential",312,121,191,3,3,0,312,305,7,0,82,39,43,0,0,0,0,0,0,0,0,0,TN04
219806,Carson-Newman University, ,1646 S Russell Ave,Jefferson City,TN,37760,-83.491709,36.122934,Private not-for-profit,Graduate degree or certificate offering,No,Suburb: Small,Doctoral/Professional Universities,Research Doctoral: Single program-Education,High undergraduate,"Four-year, small, highly residential",1584,383,1201,37,26,11,1584,1205,193,186,252,80,172,18,12,6,41,17,24,0,0,0,TN01
219833,Christian Brothers University,CBU,650 East Parkway South,Memphis,TN,38104,-89.983241,35.127437,Private not-for-profit,Graduate degree or certificate offering,No,City: Large,Master's Colleges & Universities: Medium Programs,"Postbaccalaureate: Education-dominant, with Arts & Sciences",High undergraduate,"Four-year, small, primarily residential",550,225,325,53,35,18,550,148,292,110,157,70,87,32,23,9,0,0,0,0,0,0,TN09
219842,Pentecostal Theological Seminary, ,900 Walker St NE,Cleveland,TN,37311-3330,-84.868326,35.162528,Private not-for-profit,Graduate degree or certificate offering,No,City: Small,Special Focus Four-Year: Faith-Related Institutions,"Postbaccalaureate: Other-dominant, with other professional programs",Majority graduate,Exclusively graduate/professional,451,287,164,7,4,3,451,412,35,4,44,25,19,2,1,1,0,0,0,0,0,0,TN03
219949,Cumberland University,CU,1 Cumberland Square,Lebanon,TN,37087,-86.298782,36.204514,Private not-for-profit,Graduate degree or certificate offering,No,Town: Fringe,Master's Colleges & Universities: Medium Programs,"Postbaccalaureate: Business-dominant, with Arts & Sciences",Very high undergraduate,"Four-year, small, primarily residential",439,185,254,33,19,14,439,58,0,381,157,68,89,15,8,7,0,0,0,0,0,0,TN05
219976,Lipscomb University,David Lipscomb University  David Lipscomb  Lipscomb,One University Park Drive,Nashville,TN,37204-3951,-86.799791,36.106253,Private not-for-profit,Graduate degree or certificate offering,No,City: Large,Doctoral/Professional Universities,Research Doctoral: Professional-dominant,Majority undergraduate,"Four-year, medium, highly residential",2430,738,1692,24,15,9,2430,372,1082,976,545,172,373,12,6,6,51,15,36,0,0,0,TN05
220075,East Tennessee State University,ETSU,1276 Gilbreath Drive,Johnson City,TN,37614,-82.366954,36.301643,Public,Graduate degree or certificate offering,No,City: Small,Doctoral Universities: High Research Activity,Research Doctoral: Professional-dominant,High undergraduate,"Four-year, large, primarily residential",3392,1052,2340,138,64,74,3392,1161,749,1482,684,197,487,50,23,27,133,56,77,0,0,0,TN01
220181,Fisk University, ,1000 17th Ave North,Nashville,TN,37208-4501,-86.804805,36.167087,Private not-for-profit,Graduate degree or certificate offering,Yes,City: Large,Baccalaureate Colleges: Arts & Sciences Focus,"Postbaccalaureate: Other-dominant, with Arts & Sciences",Very high undergraduate,"Four-year, very small, highly residential",32,12,20,0,0,0,32,0,0,32,2,1,1,0,0,0,0,0,0,0,0,0,TN07
220206,Welch College, ,1045 Bison Trail,Gallatin,TN,37066-8460,-86.549153,36.36719,Private not-for-profit,Graduate degree or certificate offering,No,Rural: Fringe,Baccalaureate Colleges: Diverse Fields,Postbaccalaureate: Single program-Other,Very high undergraduate,"Four-year, very small, primarily residential",27,11,16,0,0,0,27,27,0,0,11,5,6,0,0,0,0,0,0,0,0,0,TN06
220215,Freed-Hardeman University, ,158 E Main St,Henderson,TN,38340-2399,-88.637964,35.440611,Private not-for-profit,Graduate degree or certificate offering,No,Town: Distant,Master's Colleges & Universities: Medium Programs,Research Doctoral: Professional-dominant,High undergraduate,"Four-year, small, highly residential",585,211,374,2,2,0,585,450,124,11,91,45,46,7,7,0,11,3,8,0,0,0,TN08
220473,Johnson University, ,7900 Johnson Dr,Knoxville,TN,37998,-83.750273,35.937193,Private not-for-profit,Graduate degree or certificate offering,No,Rural: Fringe,Master's Colleges & Universities: Medium Programs,Research Doctoral: Single program-Other,High undergraduate,"Four-year, very small, highly residential",383,217,166,21,10,11,383,271,43,69,74,43,31,1,0,1,8,7,1,1,1,0,TN02
220516,King University, ,1350 King College Rd,Bristol,TN,37620-2699,-82.159421,36.585309,Private not-for-profit,Graduate degree or certificate offering,No,City: Small,Master's Colleges & Universities: Larger Programs,"Postbaccalaureate: Business-dominant, with other professional programs",High undergraduate,"Four-year, small, primarily residential",431,114,317,10,6,4,431,197,192,42,189,59,130,4,3,1,0,0,0,0,0,0,TN01
220552,South College, ,3904 Lonas Road,Knoxville,TN,37909-0000,-83.97362,35.958283,Private for-profit,Graduate degree or certificate offering,No,City: Midsize,Doctoral/Professional Universities,"Postbaccalaureate: Other-dominant, with Arts & Sciences",High undergraduate,"Four-year, medium, primarily nonresidential",1380,433,947,28,11,17,1380,317,358,705,173,52,121,2,1,1,0,0,0,0,0,0,TN02
220613,Lee University, ,1120 N Ocoee St,Cleveland,TN,37311,-84.871399,35.166019,Private not-for-profit,Graduate degree or certificate offering,No,City: Small,Master's Colleges & Universities: Medium Programs,"Postbaccalaureate: Education-dominant, with Arts & Sciences",Very high undergraduate,"Four-year, medium, highly residential",690,306,384,32,14,18,690,119,152,419,184,74,110,7,4,3,0,0,0,0,0,0,TN03
220631,Lincoln Memorial University,LMU,6965 Cumberland Gap Pkwy,Harrogate,TN,37752-9900,-83.660198,36.578508,Private not-for-profit,Graduate degree or certificate offering,No,Town: Distant,Doctoral/Professional Universities,Research Doctoral: Professional-dominant,Majority graduate,"Four-year, medium, primarily residential",3468,1313,2155,29,13,16,3468,430,0,3038,468,143,325,5,3,2,61,21,40,0,0,0,TN02
220701,The University of Tennessee Southern, ,433 West Madison Street,Pulaski,TN,38478-2799,-87.035661,35.201019,Private not-for-profit,Graduate degree or certificate offering,No,Town: Distant,Baccalaureate Colleges: Diverse Fields,Postbaccalaureate: Single program-Business,Very high undergraduate,"Four-year, very small, highly residential",24,15,9,1,1,0,24,6,0,18,12,8,4,1,1,0,0,0,0,0,0,0,TN04
220792,Meharry Medical College, ,1005 DB Todd Blvd.,Nashville,TN,37208,-86.807371,36.165458,Private not-for-profit,Graduate degree or certificate offering,Yes,City: Large,Special Focus Four-Year: Medical Schools & Centers,Research Doctoral: Single program-Other,Exclusively graduate,Exclusively graduate/professional,949,371,578,0,0,0,949,0,0,949,139,41,98,0,0,0,4,3,1,0,0,0,TN07
220862,University of Memphis, ,Southern Avenue,Memphis,TN,38152,-89.938068,35.118878,Public,Graduate degree or certificate offering,No,City: Large,Doctoral Universities: Very High Research Activity,"Research Doctoral: Comprehensive programs, no medical/veterinary school",High undergraduate,"Four-year, large, primarily nonresidential",5774,2143,3631,513,282,231,5774,2350,2309,1115,1062,381,681,113,62,51,135,54,81,10,9,1,TN09
220871,Memphis Theological Seminary, ,168 East Parkway South,Memphis,TN,38104,-89.982653,35.13311,Private not-for-profit,Graduate degree or certificate offering,No,City: Large,Special Focus Four-Year: Faith-Related Institutions,"Postbaccalaureate: Other-dominant, with Arts & Sciences",Exclusively graduate,Exclusively graduate/professional,223,101,122,0,0,0,223,207,16,0,25,17,8,0,0,0,0,0,0,0,0,0,TN09
220978,Middle Tennessee State University, ,1301 East Main Street,Murfreesboro,TN,37132,-86.360618,35.848005,Public,Graduate degree or certificate offering,No,City: Midsize,Doctoral Universities: High Research Activity,"Research Doctoral: Comprehensive programs, no medical/veterinary school",Very high undergraduate,"Four-year, large, primarily nonresidential",3649,1374,2275,189,87,102,3649,1277,1078,1294,678,266,412,29,18,11,46,20,26,2,0,2,TN04
220996,Middle Tennessee School of Anesthesia Inc,MTSA,315 Hospital Drive,Madison,TN,37115,-86.683859,36.253425,Private not-for-profit,Graduate degree or certificate offering,No,City: Large,Special Focus Four-Year: Other Health Professions Schools,Postbaccalaureate: Single program-Other,Exclusively graduate,Exclusively graduate/professional,335,154,181,0,0,0,335,62,272,1,0,0,0,0,0,0,0,0,0,0,0,0,TN06
221351,Rhodes College,Rhodes,2000 North Parkway,Memphis,TN,38112-1690,-89.990803,35.154405,Private not-for-profit,Graduate degree or certificate offering,No,City: Large,Baccalaureate Colleges: Arts & Sciences Focus,"Postbaccalaureate: Business-dominant, with other professional programs",Very high undergraduate,"Four-year, small, highly residential",70,21,49,0,0,0,70,0,70,0,26,8,18,0,0,0,0,0,0,0,0,0,TN09
221519,The University of the South,Sewanee|University of the South,735 University Avenue,Sewanee,TN,37383-1000,-85.920179,35.204719,Private not-for-profit,Graduate degree or certificate offering,No,Rural: Distant,Baccalaureate Colleges: Arts & Sciences Focus,"Postbaccalaureate: Other-dominant, with Arts & Sciences",Very high undergraduate,"Four-year, small, highly residential",159,89,70,7,6,1,159,23,25,111,33,12,21,5,4,1,0,0,0,0,0,0,TN04
221661,Southern Adventist University, ,4881 Taylor Cir,Collegedale,TN,37315-0370,-85.052088,35.048254,Private not-for-profit,Graduate degree or certificate offering,No,Suburb: Large,Master's Colleges & Universities: Medium Programs,"Postbaccalaureate: Other-dominant, with other professional programs",Very high undergraduate,"Four-year, small, highly residential",421,116,305,15,6,9,421,123,239,59,145,35,110,3,2,1,0,0,0,0,0,0,TN03
221670,Southern College of Optometry,SCO,1245 Madison Ave,Memphis,TN,38104-2211,-90.019856,35.138252,Private not-for-profit,Graduate degree or certificate offering,No,City: Large,Special Focus Four-Year: Other Health Professions Schools,Postbaccalaureate: Single program-Other,Exclusively graduate,Exclusively graduate/professional,540,185,355,6,1,5,540,0,0,540,0,0,0,0,0,0,0,0,0,0,0,0,TN09
221731,Tennessee Wesleyan University, ,204 East College Street,Athens,TN,37303,-84.592728,35.446331,Private not-for-profit,Graduate degree or certificate offering,No,Town: Distant,Baccalaureate Colleges: Diverse Fields,Postbaccalaureate: Single program-Business,Very high undergraduate,"Four-year, small, primarily residential",140,30,110,0,0,0,140,65,75,0,29,9,20,0,0,0,0,0,0,0,0,0,TN03
221740,The University of Tennessee-Chattanooga,UTC,615 McCallie Ave,Chattanooga,TN,37403-2598,-85.300247,35.047519,Public,Graduate degree or certificate offering,No,City: Midsize,Doctoral/Professional Universities,Research Doctoral: Professional-dominant,Very high undergraduate,"Four-year, large, primarily residential",1714,730,984,67,49,18,1714,690,848,176,394,165,229,24,14,10,6,4,2,2,2,0,TN03
221759,The University of Tennessee-Knoxville, ,527 Andy Holt Tower,Knoxville,TN,37996,-83.925852,35.952082,Public,Graduate degree or certificate offering,No,City: Midsize,Doctoral Universities: Very High Research Activity,"Research Doctoral: Comprehensive programs, with medical/veterinary school",High undergraduate,"Four-year, large, primarily residential",7312,3284,4028,790,507,283,7312,2239,4100,973,1570,683,887,76,49,27,395,194,201,106,74,32,TN02
221768,The University of Tennessee-Martin,UT Martin,554 University Street,Martin,TN,38238,-88.864211,36.340338,Public,Graduate degree or certificate offering,No,Town: Remote,Master's Colleges & Universities: Medium Programs,"Postbaccalaureate: Education-dominant, with other professional programs",Very high undergraduate,"Four-year, medium, primarily residential",922,287,635,4,2,2,922,814,88,20,231,71,160,0,0,0,0,0,0,0,0,0,TN08
221838,Tennessee State University, ,3500 John A. Merritt Blvd,Nashville,TN,37209-1561,-86.828275,36.166321,Public,Graduate degree or certificate offering,Yes,City: Large,Doctoral Universities: High Research Activity,Research Doctoral: Professional-dominant,High undergraduate,"Four-year, medium, highly residential",1929,583,1346,138,73,65,1929,600,228,1101,303,88,215,26,15,11,57,13,44,12,8,4,TN07
221847,Tennessee Technological University,Tennessee Tech University|Tennessee Tech|TTU|Tenn Tech|TN Tech|Tech|,1 William L. Jones Drive,Cookeville,TN,38505-0001,-85.504039,36.174754,Public,Graduate degree or certificate offering,No,Town: Remote,Doctoral Universities: High Research Activity,Research Doctoral: STEM-dominant,Very high undergraduate,"Four-year, medium, primarily residential",1710,696,1014,129,98,31,1710,837,685,188,391,162,229,12,10,2,20,14,6,4,4,0,TN06
221892,Trevecca Nazarene University, ,333 Murfreesboro Rd,Nashville,TN,37210,-86.754238,36.141324,Private not-for-profit,Graduate degree or certificate offering,No,City: Large,Doctoral/Professional Universities,Research Doctoral: Professional-dominant,Majority graduate,"Four-year, medium, primarily residential",2393,705,1688,24,15,9,2393,1232,0,1161,506,157,349,10,7,3,164,36,128,1,0,1,TN07
221953,Tusculum University, ,60 Shiloh Road,Greeneville,TN,37743,-82.760818,36.172435,Private not-for-profit,Graduate degree or certificate offering,No,Town: Distant,Master's Colleges & Universities: Medium Programs,"Postbaccalaureate: Business-dominant, with other professional programs",High undergraduate,"Four-year, small, highly residential",360,124,236,6,3,3,360,55,150,155,213,74,139,1,1,0,0,0,0,0,0,0,TN01
221971,Union University, ,1050 Union University Dr,Jackson,TN,38305-3697,-88.858524,35.676896,Private not-for-profit,Graduate degree or certificate offering,No,City: Small,Doctoral/Professional Universities,Research Doctoral: Professional-dominant,Majority undergraduate,"Four-year, small, highly residential",1275,360,915,7,5,2,1275,482,480,313,323,86,237,3,2,1,45,19,26,0,0,0,TN08
221999,Vanderbilt University, ,2101 West End Avenue,Nashville,TN,37240,-86.803369,36.14659,Private not-for-profit,Graduate degree or certificate offering,No,City: Large,Doctoral Universities: Very High Research Activity,"Research Doctoral: Comprehensive programs, with medical/veterinary school",Majority undergraduate,"Four-year, large, highly residential",7155,2825,4330,796,429,367,7155,796,2380,3979,1459,563,896,197,101,96,415,185,230,61,42,19,TN07
222178,Abilene Christian University, , ,Abilene,TX,79699,-99.709797,32.468943,Private not-for-profit,Graduate degree or certificate offering,No,City: Midsize,Doctoral/Professional Universities,Research Doctoral: Professional-dominant,High undergraduate,"Four-year, medium, highly residential",2312,697,1615,64,41,23,2312,1831,215,266,397,114,283,12,8,4,95,29,66,0,0,0,TX19
222628,Amberton University, ,1700 Eastgate Dr,Garland,TX,75041-5595,-96.65302,32.859931,Private not-for-profit,Graduate degree or certificate offering,No,Suburb: Large,Master's Colleges & Universities: Larger Programs,"Postbaccalaureate: Business-dominant, with Arts & Sciences",Majority graduate,"Four-year, very small, primarily nonresidential",1406,412,994,109,66,43,1406,1406,0,0,259,88,171,28,17,11,0,0,0,0,0,0,TX05
222831,Angelo State University,Angelo State,2601 W. Avenue N,San Angelo,TX,76909,-100.465051,31.440914,Public,Graduate degree or certificate offering,No,City: Small,Master's Colleges & Universities: Larger Programs,Postbaccalaureate: Comprehensive programs,High undergraduate,"Four-year, medium, primarily residential",2204,762,1442,34,12,22,2204,1735,346,123,573,193,380,14,6,8,0,0,0,0,0,0,TX11
222877,Arlington Baptist University,ABU,3001 W Division,Arlington,TX,76012-3425,-97.156024,32.739489,Private not-for-profit,Graduate degree or certificate offering,No,City: Large,Baccalaureate Colleges: Diverse Fields,Postbaccalaureate: Single program-Other,Very high undergraduate,"Four-year, very small, highly residential",2,2,0,0,0,0,2,2,0,0,0,0,0,0,0,0,0,0,0,0,0,0,TX25
222983,Austin College, ,900 N Grand Ave,Sherman,TX,75090-4400,-96.596331,33.646345,Private not-for-profit,Graduate degree or certificate offering,No,City: Small,Baccalaureate Colleges: Arts & Sciences Focus,Postbaccalaureate: Single program-Education,Very high undergraduate,"Four-year, small, highly residential",17,8,9,0,0,0,17,0,0,17,17,8,9,0,0,0,0,0,0,0,0,0,TX04
223001,Austin Presbyterian Theological Seminary, ,100 E 27th St,Austin,TX,78705-5711,-97.736958,30.29201,Private not-for-profit,Graduate degree or certificate offering,No,City: Large,Special Focus Four-Year: Faith-Related Institutions,Postbaccalaureate: Single program-Other,Exclusively graduate,Exclusively graduate/professional,182,72,110,0,0,0,182,0,0,182,29,14,15,0,0,0,0,0,0,0,0,0,TX37
223117,Baptist Missionary Association Theological Seminary,BMA Seminary,1530 E Pine St,Jacksonville,TX,75766-5407,-95.255524,31.978961,Private not-for-profit,Graduate degree or certificate offering,No,Town: Distant,Special Focus Four-Year: Faith-Related Institutions,Postbaccalaureate: Single program-Other,Majority graduate,"Four-year, very small, primarily nonresidential",71,60,11,10,7,3,71,67,4,0,16,11,5,4,3,1,0,0,0,0,0,0,TX06
223223,Baylor College of Medicine, ,One Baylor Plaza,Houston,TX,77030-3498,-95.395743,29.7106,Private not-for-profit,Graduate degree or certificate offering,No,City: Large,Special Focus Four-Year: Research Institutions,Research Doctoral: STEM-dominant,Exclusively graduate,Exclusively graduate/professional,1657,707,950,213,94,119,1657,0,1182,475,75,13,62,1,1,0,94,47,47,28,16,12,TX09
223232,Baylor University, , ,Waco,TX,76798,-97.121041,31.546872,Private not-for-profit,Graduate degree or certificate offering,No,City: Midsize,Doctoral Universities: Very High Research Activity,"Research Doctoral: Comprehensive programs, no medical/veterinary school",High undergraduate,"Four-year, large, primarily residential",6324,2368,3956,333,206,127,6324,3380,2385,559,1107,429,678,77,44,33,131,82,49,25,19,6,TX17
224004,Concordia University Texas,CTX,11400 Concordia University Drive,Austin,TX,78726,-97.835703,30.420232,Private not-for-profit,Graduate degree or certificate offering,No,City: Large,Master's Colleges & Universities: Larger Programs,Research Doctoral: Single program-Education,High undergraduate,"Four-year, small, primarily nonresidential",635,220,415,0,0,0,635,481,146,8,256,91,165,0,0,0,11,1,10,0,0,0,TX37
224147,Texas A & M University-Corpus Christi, ,6300 Ocean Dr.,Corpus Christi,TX,78412-5503,-97.32395,27.713723,Public,Graduate degree or certificate offering,No,City: Large,Doctoral Universities: High Research Activity,Research Doctoral: Professional-dominant,High undergraduate,"Four-year, medium, primarily residential",3900,1559,2341,191,102,89,3900,1792,1996,112,819,341,478,68,45,23,21,5,16,3,2,1,TX27
224226,Dallas Baptist University,DBU,3000 Mountain Creek Parkway,Dallas,TX,75211-9299,-96.947006,32.710017,Private not-for-profit,Graduate degree or certificate offering,No,City: Large,Doctoral/Professional Universities,Research Doctoral: Professional-dominant,Majority undergraduate,"Four-year, medium, highly residential",1694,660,1034,417,182,235,1694,296,739,659,454,165,289,136,52,84,49,14,35,0,0,0,TX30
224305,Dallas Theological Seminary, ,3909 Swiss Ave,Dallas,TX,75204,-96.780497,32.795361,Private not-for-profit,Graduate degree or certificate offering,No,City: Large,Special Focus Four-Year: Faith-Related Institutions,Research Doctoral: Professional-dominant,Exclusively graduate,Exclusively graduate/professional,3016,1816,1200,444,310,134,3016,820,1539,657,408,250,158,30,23,7,27,21,6,6,4,2,TX30
224323,University of Dallas, ,1845 E Northgate Drive,Irving,TX,75062-4736,-96.919512,32.846221,Private not-for-profit,Graduate degree or certificate offering,No,City: Large,Master's Colleges & Universities: Larger Programs,Research Doctoral: Professional-dominant,Majority undergraduate,"Four-year, small, highly residential",1369,756,613,129,78,51,1369,790,405,174,331,190,141,51,27,24,9,5,4,1,1,0,TX06
224527,East Texas Baptist University, ,One Tiger Drive,Marshall,TX,75670-1498,-94.374488,32.557847,Private not-for-profit,Graduate degree or certificate offering,No,Town: Distant,Master's Colleges & Universities: Small Programs,"Postbaccalaureate: Business-dominant, with Arts & Sciences",Very high undergraduate,"Four-year, small, highly residential",191,91,100,0,0,0,191,110,71,10,57,26,31,0,0,0,0,0,0,0,0,0,TX01
224545,Texas A&M University-Texarkana,A&M-Texarkana,7101 University Avenue,Texarkana,TX,75503,-94.103617,33.490482,Public,Graduate degree or certificate offering,No,Rural: Fringe,Master's Colleges & Universities: Medium Programs,Research Doctoral: Single program-Education,High undergraduate,"Four-year, small, primarily nonresidential",471,145,326,13,6,7,471,289,144,38,114,36,78,3,1,2,3,3,0,0,0,0,TX01
224554,Texas A & M University-Commerce,A&M-Commerce,2200 Campbell Stree,Commerce,TX,75429-3011,-95.904579,33.242112,Public,Graduate degree or certificate offering,No,Town: Distant,Doctoral/Professional Universities,Research Doctoral: Professional-dominant,High undergraduate,"Four-year, medium, primarily residential",5246,1681,3565,265,141,124,5246,4563,0,683,1323,459,864,104,49,55,73,13,60,1,0,1,TX03
224712,Episcopal Theological Seminary of the Southwest, ,501 E. 32nd St.,Austin,TX,78705,-97.732652,30.293092,Private not-for-profit,Graduate degree or certificate offering,No,City: Large,Special Focus Four-Year: Faith-Related Institutions,Postbaccalaureate: Single program-Other,Exclusively graduate,Exclusively graduate/professional,138,40,98,1,1,0,138,0,136,2,34,9,25,0,0,0,0,0,0,0,0,0,TX37
224776,Miami International University of Art & Design-Art Institute Dallas, ,"8080 Park Lane, Suite 100",Dallas,TX,75231-5993,-96.767823,32.871008,Private for-profit,Graduate degree or certificate offering,No,City: Large,Baccalaureate Colleges: Diverse Fields,Postbaccalaureate: Single program-Other,Very high undergraduate,"Four-year, very small, primarily nonresidential",3,1,2,0,0,0,3,0,0,3,0,0,0,0,0,0,0,0,0,0,0,0,TX32
225201,Hallmark University, ,10401 IH 10 W,San Antonio,TX,78230-1736,-98.568618,29.538442,Private not-for-profit,Graduate degree or certificate offering,No,City: Large,Baccalaureate Colleges: Diverse Fields,"Postbaccalaureate: Other-dominant, with other professional programs",Very high undergraduate,"Four-year, very small, primarily nonresidential",65,41,24,0,0,0,65,65,0,0,33,19,14,0,0,0,0,0,0,0,0,0,TX20
225247,Hardin-Simmons University,"HSU, Hardin-Simmons",2200 Hickory,Abilene,TX,79698-0001,-99.73564,32.476434,Private not-for-profit,Graduate degree or certificate offering,No,City: Midsize,Doctoral/Professional Universities,Research Doctoral: Single program-Other,High undergraduate,"Four-year, small, highly residential",563,230,333,14,6,8,563,200,93,270,178,73,105,5,4,1,4,0,4,0,0,0,TX19
225399,Houston Baptist University,HBU,7502 Fondren Rd,Houston,TX,77074-3298,-95.515954,29.693819,Private not-for-profit,Graduate degree or certificate offering,No,City: Large,Master's Colleges & Universities: Larger Programs,Research Doctoral: Single program-Education,High undergraduate,"Four-year, small, primarily residential",1762,424,1338,92,30,62,1762,1030,519,213,384,94,290,20,6,14,18,4,14,1,0,1,TX09
225414,University of Houston-Clear Lake,"UHCL| University of Houston - Clear Lake| University of Houston, Clear Lake| UH-CL|University of Houston - ClearLake| University of Houston-ClearLake",2700 Bay Area Blvd,Houston,TX,77058-1002,-95.098129,29.582523,Public,Graduate degree or certificate offering,No,Suburb: Large,Doctoral/Professional Universities,Research Doctoral: Single program-Education,High undergraduate,"Four-year, medium, primarily nonresidential",3194,1167,2027,362,179,183,3194,2315,586,293,852,316,536,160,78,82,17,2,15,1,0,1,TX36
225432,University of Houston-Downtown, ,1 Main Street,Houston,TX,77002-1014,-95.359338,29.7661,Public,Graduate degree or certificate offering,No,City: Large,Master's Colleges & Universities: Larger Programs,"Postbaccalaureate: Business-dominant, with Arts & Sciences",Very high undergraduate,"Four-year, medium, primarily nonresidential",2135,887,1248,94,42,52,2135,1664,462,9,543,229,314,29,11,18,0,0,0,0,0,0,TX18
225502,University of Houston-Victoria,UH-Victoria,3007 N. Ben Wilson,Victoria,TX,77901,-96.976334,28.816248,Public,Graduate degree or certificate offering,No,City: Small,Master's Colleges & Universities: Larger Programs,"Postbaccalaureate: Business-dominant, with Arts & Sciences",Majority undergraduate,"Four-year, medium, primarily residential",1693,531,1162,99,47,52,1693,1506,168,19,594,161,433,49,22,27,0,0,0,0,0,0,TX27
225511,University of Houston,UH,212 E. Cullen Building,Houston,TX,77204-2018,-95.343537,29.720393,Public,Graduate degree or certificate offering,No,City: Large,Doctoral Universities: Very High Research Activity,"Research Doctoral: Comprehensive programs, no medical/veterinary school",High undergraduate,"Four-year, large, primarily nonresidential",9215,4155,5060,2123,1298,825,9215,3884,4610,721,1791,761,1030,383,226,157,429,216,213,213,143,70,TX18
225548,Howard Payne University, ,1000 Fisk St.,Brownwood,TX,76801-2794,-98.985204,31.716467,Private not-for-profit,Graduate degree or certificate offering,No,Town: Remote,Baccalaureate Colleges: Diverse Fields,"Postbaccalaureate: Business-dominant, with Arts & Sciences",Very high undergraduate,"Four-year, very small, highly residential",96,66,30,0,0,0,96,61,2,33,31,20,11,0,0,0,0,0,0,0,0,0,TX11
225575,Huston-Tillotson University, ,900 Chicon St,Austin,TX,78702-2795,-97.721691,30.264667,Private not-for-profit,Graduate degree or certificate offering,Yes,City: Large,Baccalaureate Colleges: Diverse Fields,Not classified (Exclusively Undergraduate),Very high undergraduate,"Four-year, small, primarily residential",20,7,13,0,0,0,20,20,0,0,5,1,4,0,0,0,0,0,0,0,0,0,TX35
225627,University of the Incarnate Word,"UIW|Incarnate Word|Incarnate|Incarnate Word, University of|Incarnate Word, Univ of|Univ. of the Incarnate Word",4301 Broadway,San Antonio,TX,78209,-98.46583,29.46708,Private not-for-profit,Graduate degree or certificate offering,No,City: Large,Doctoral/Professional Universities,Research Doctoral: Professional-dominant,Majority undergraduate,"Four-year, medium, primarily nonresidential",3394,1464,1930,114,55,59,3394,2411,834,149,666,335,331,16,8,8,22,10,12,4,2,2,TX21
226091,Lamar University, ,4400 MLK Blvd,Beaumont,TX,77705,-94.072244,30.042738,Public,Graduate degree or certificate offering,No,City: Midsize,Doctoral/Professional Universities,Research Doctoral: Professional-dominant,Majority undergraduate,"Four-year, medium, primarily residential",12490,3108,9382,322,224,98,12490,9517,281,2692,2667,705,1962,107,64,43,71,32,39,17,15,2,TX14
226152,Texas A & M International University, ,5201 University Blvd,Laredo,TX,78041-1900,-99.436043,27.571172,Public,Graduate degree or certificate offering,No,City: Large,Master's Colleges & Universities: Larger Programs,Research Doctoral: Single program-Other,High undergraduate,"Four-year, medium, primarily nonresidential",2003,725,1278,109,69,40,2003,1503,219,281,533,173,360,34,22,12,0,0,0,0,0,0,TX28
226231,LeTourneau University, ,2100 S Mobberly Ave,Longview,TX,75602,-94.726394,32.46632,Private not-for-profit,Graduate degree or certificate offering,No,City: Small,Master's Colleges & Universities: Medium Programs,"Postbaccalaureate: Other-dominant, with Arts & Sciences",Very high undergraduate,"Four-year, small, primarily residential",337,75,262,2,1,1,337,287,42,8,104,30,74,2,1,1,0,0,0,0,0,0,TX01
226383,Lubbock Christian University,LCU,5601 19th Street,Lubbock,TX,79407-2099,-101.934426,33.575973,Private not-for-profit,Graduate degree or certificate offering,No,City: Large,Master's Colleges & Universities: Medium Programs,"Postbaccalaureate: Other-dominant, with other professional programs",Very high undergraduate,"Four-year, small, primarily residential",372,73,299,5,2,3,372,66,89,217,101,12,89,1,1,0,0,0,0,0,0,0,TX19
226471,University of Mary Hardin-Baylor,UMHB|MHB|Mary Hardin-Baylor,900 College St,Belton,TX,76513-2599,-97.463471,31.066793,Private not-for-profit,Graduate degree or certificate offering,No,Suburb: Small,Doctoral/Professional Universities,"Postbaccalaureate: Other-dominant, with Arts & Sciences",High undergraduate,"Four-year, medium, highly residential",653,209,444,40,26,14,653,35,71,547,129,51,78,21,13,8,23,4,19,0,0,0,TX31
226587,McMurry University,McMurry College|McM|McM University|McM College|Mcmurry University|Mcmurry College|McMurry|Mcmurry,S 14th and Sayles Blvd,Abilene,TX,79697,-99.748682,32.429776,Private not-for-profit,Graduate degree or certificate offering,No,City: Midsize,Baccalaureate Colleges: Diverse Fields,Postbaccalaureate: Single program-Other,Very high undergraduate,"Four-year, very small, highly residential",7,1,6,0,0,0,7,2,0,5,7,3,4,0,0,0,0,0,0,0,0,0,TX19
226833,Midwestern State University,MSU-Texas,3410 Taft Blvd,Wichita Falls,TX,76308-2099,-98.519386,33.874809,Public,Graduate degree or certificate offering,No,City: Midsize,Master's Colleges & Universities: Larger Programs,Postbaccalaureate: Comprehensive programs,Very high undergraduate,"Four-year, medium, primarily residential",940,311,629,62,22,40,940,684,74,182,208,62,146,20,7,13,0,0,0,0,0,0,TX13
227216,University of North Texas,UNT|North Texas|Mean Grean,1501 W.Chestnut Ave.,Denton,TX,76203-1277,-97.148422,33.211178,Public,Graduate degree or certificate offering,No,City: Midsize,Doctoral Universities: Very High Research Activity,"Research Doctoral: Comprehensive programs, no medical/veterinary school",High undergraduate,"Four-year, large, primarily nonresidential",9900,3854,6046,2072,1029,1043,9900,3310,3072,3518,2150,782,1368,396,180,216,259,128,131,86,47,39,TX13
227289,Oblate School of Theology,Oblate,285 Oblate Dr,San Antonio,TX,78216-6693,-98.503113,29.505434,Private not-for-profit,Graduate degree or certificate offering,No,City: Large,Special Focus Four-Year: Faith-Related Institutions,Research Doctoral: Single program-Other,Exclusively graduate,Exclusively graduate/professional,238,176,62,57,46,11,238,37,0,201,26,26,0,8,8,0,2,0,2,2,0,2,TX20
227331,Our Lady of the Lake University,OLLU,411 SW 24th St.,San Antonio,TX,78207-4689,-98.54365,29.426194,Private not-for-profit,Graduate degree or certificate offering,No,City: Large,Doctoral/Professional Universities,Research Doctoral: Single program-Other,Majority graduate,"Four-year, small, primarily residential",1965,355,1610,4,0,4,1965,1324,460,181,506,77,429,0,0,0,47,18,29,1,0,1,TX20
227368,The University of Texas Rio Grande Valley,UT Rio Grande Valley | UTRGV | University of Texas Rio Grande Valley |,1201 W University Dr,Edinburg,TX,78539-2999,-98.173567,26.306759,Public,Graduate degree or certificate offering,No,City: Midsize,Doctoral Universities: High Research Activity,Research Doctoral: Professional-dominant,High undergraduate,"Four-year, large, primarily nonresidential",7524,2680,4844,411,261,150,7524,6054,949,521,1891,631,1260,3,2,1,30,14,16,5,3,2,TX15
227526,Prairie View A & M University,PVAMU,FM 1098 Road & University Drive,Prairie View,TX,77446,-95.989475,30.092425,Public,Graduate degree or certificate offering,Yes,Town: Distant,Doctoral Universities: High Research Activity,Research Doctoral: Professional-dominant,Very high undergraduate,"Four-year, medium, highly residential",1212,439,773,124,70,54,1212,698,440,74,283,107,176,31,17,14,17,4,13,3,3,0,TX10
227757,Rice University, ,6100 S Main St,Houston,TX,77005-1827,-95.402035,29.717897,Private not-for-profit,Graduate degree or certificate offering,No,City: Large,Doctoral Universities: Very High Research Activity,"Research Doctoral: Comprehensive programs, no medical/veterinary school",Majority undergraduate,"Four-year, medium, highly residential",3911,2468,1443,1373,892,481,3911,531,2809,571,929,584,345,310,196,114,207,127,80,88,59,29,TX07
227845,Saint Edward's University,"St. Edward's University, St. Edward's",3001 S Congress Ave,Austin,TX,78704-6489,-97.754998,30.229618,Private not-for-profit,Graduate degree or certificate offering,No,City: Large,Master's Colleges & Universities: Larger Programs,"Postbaccalaureate: Business-dominant, with Arts & Sciences",Very high undergraduate,"Four-year, medium, highly residential",821,225,596,10,6,4,821,751,61,9,203,62,141,1,1,0,0,0,0,0,0,0,TX37
227863,University of St Thomas, ,3800 Montrose Blvd,Houston,TX,77006-4696,-95.393102,29.736438,Private not-for-profit,Graduate degree or certificate offering,No,City: Large,Doctoral/Professional Universities,Research Doctoral: Professional-dominant,High undergraduate,"Four-year, small, primarily nonresidential",1570,549,1021,140,69,71,1570,789,650,131,510,155,355,59,26,33,28,10,18,1,1,0,TX07
227881,Sam Houston State University,SHSU,1806 Ave J,Huntsville,TX,77340,-95.546205,30.714738,Public,Graduate degree or certificate offering,No,Town: Distant,Doctoral Universities: High Research Activity,Research Doctoral: Professional-dominant,Very high undergraduate,"Four-year, large, primarily nonresidential",3911,1243,2668,103,40,63,3911,2352,469,1090,836,251,585,19,6,13,69,21,48,3,0,3,TX17
228042,Schreiner University, ,2100 Memorial Blvd,Kerrville,TX,78028-5697,-99.130586,30.031458,Private not-for-profit,Graduate degree or certificate offering,No,Town: Remote,Master's Colleges & Universities: Small Programs,"Postbaccalaureate: Business-dominant, with other professional programs",Very high undergraduate,"Four-year, small, highly residential",130,46,84,0,0,0,130,130,0,0,67,25,42,0,0,0,0,0,0,0,0,0,TX21
228149,St. Mary's University, ,One Camino Santa Maria,San Antonio,TX,78228,-98.562778,29.453244,Private not-for-profit,Graduate degree or certificate offering,No,City: Large,Master's Colleges & Universities: Larger Programs,Research Doctoral: Professional-dominant,Majority undergraduate,"Four-year, medium, highly residential",1435,641,794,63,40,23,1435,36,939,460,205,86,119,28,16,12,8,3,5,0,0,0,TX20
228194,South Texas College of Law Houston, ,1303 San Jacinto Street,Houston,TX,77002-7006,-95.36455,29.753171,Private not-for-profit,Graduate degree or certificate offering,No,City: Large,Special Focus Four-Year: Law Schools,Postbaccalaureate: Single program-Other,Exclusively graduate,Exclusively graduate/professional,1055,483,572,0,0,0,1055,0,1055,0,0,0,0,0,0,0,0,0,0,0,0,0,TX18
228246,Southern Methodist University,SMU,6425 Boaz St,Dallas,TX,75275-0221,-96.783365,32.843612,Private not-for-profit,Graduate degree or certificate offering,No,Suburb: Large,Doctoral Universities: High Research Activity,"Research Doctoral: Comprehensive programs, no medical/veterinary school",Majority undergraduate,"Four-year, large, highly residential",6321,3288,3033,825,530,295,6321,950,1600,3771,1704,921,783,275,172,103,130,62,68,42,31,11,TX24
228325,Southwestern Assemblies of God University,SAGU,1200 Sycamore,Waxahachie,TX,75165,-96.853492,32.40443,Private not-for-profit,Graduate degree or certificate offering,No,Suburb: Large,Master's Colleges & Universities: Small Programs,"Postbaccalaureate: Other-dominant, with Arts & Sciences",High undergraduate,"Four-year, small, highly residential",420,194,226,1,1,0,420,385,34,1,94,42,52,0,0,0,5,5,0,0,0,0,TX06
228431,Stephen F Austin State University,"SFASU, SFA, Stephen F, Stephen F. Austin","2008 Alumni Drive, Rusk 206",Nacogdoches,TX,75961,-94.64908,31.621056,Public,Graduate degree or certificate offering,No,Town: Remote,Master's Colleges & Universities: Larger Programs,Research Doctoral: Professional-dominant,Very high undergraduate,"Four-year, large, primarily residential",2087,574,1513,46,22,24,2087,1432,520,135,512,129,383,14,6,8,10,3,7,2,1,1,TX17
228459,Texas State University,Texas State|Texas State University-San Marcos|Southwest Texas State University|Southwest Texas State|SWT|SWTSU|Texas State San Marcos|TxSt|TxState|TS|,601 University Dr,San Marcos,TX,78666,-97.943029,29.888885,Public,Graduate degree or certificate offering,No,City: Small,Doctoral Universities: High Research Activity,Research Doctoral: Professional-dominant,High undergraduate,"Four-year, large, primarily nonresidential",5436,1893,3543,415,193,222,5436,1973,3079,384,1297,420,877,125,45,80,50,22,28,14,9,5,TX35
228468,Southwestern Adventist University, ,100 W Hillcrest,Keene,TX,76059,-97.32702,32.397617,Private not-for-profit,Graduate degree or certificate offering,No,Town: Fringe,Baccalaureate Colleges: Diverse Fields,"Postbaccalaureate: Other-dominant, with other professional programs",Very high undergraduate,"Four-year, very small, primarily residential",49,18,31,2,0,2,49,12,0,37,6,3,3,0,0,0,0,0,0,0,0,0,TX25
228501,Sul Ross State University,Sul Ross,HWY 90 East,Alpine,TX,79832,-103.651469,30.363139,Public,Graduate degree or certificate offering,No,Town: Remote,Master's Colleges & Universities: Larger Programs,Postbaccalaureate: Comprehensive programs,High undergraduate,"Four-year, small, primarily residential",737,232,505,6,4,2,737,476,189,72,171,59,112,6,4,2,0,0,0,0,0,0,TX23
228529,Tarleton State University,Tarleton|Texans|TSU|Tarleton State|,1333 W. Washington,Stephenville,TX,76401-0000,-98.214866,32.214988,Public,Graduate degree or certificate offering,No,Town: Remote,Doctoral Universities: High Research Activity,Research Doctoral: Single program-Education,Very high undergraduate,"Four-year, large, primarily residential",2710,914,1796,21,9,12,2710,2388,322,0,726,236,490,12,7,5,26,9,17,0,0,0,TX25
228635,University of Texas Southwestern Medical Center,UT Southwestern  UT Southwestern Medical School  UT Southwestern Graduate School of Biomedical Sciences  UT Southwestern Allied Health Sciences School  UTSW Medical School  UTSW Graduate School  UTSW Allied Health School  UTSWMC  UTSWMC Medical School  UTSWMC Graduate School  UTSWMC Allied Health School  University of Texas Southwestern Medical School  University of Texas Southwestern Graduate School of Biomedical Sciences  University of Texas Southwestern Allied Health Sciences School  University of Texas Southwestern School of Health Professions,5323 Harry Hines Blvd,Dallas,TX,75390-9096,-96.841156,32.812307,Public,Graduate degree or certificate offering,No,City: Large,Special Focus Four-Year: Research Institutions,Research Doctoral: STEM-dominant,Exclusively graduate,Exclusively graduate/professional,2538,1182,1356,636,363,273,2538,287,829,1422,111,23,88,3,2,1,62,32,30,16,5,11,TX30
228644,The University of Texas Health Science Center at San Antonio,UT Health San Antonio,7703 Floyd Curl Dr,San Antonio,TX,78229-3900,-98.575655,29.508107,Public,Graduate degree or certificate offering,No,City: Large,Special Focus Four-Year: Research Institutions,Research Doctoral: STEM-dominant,Majority graduate,"Four-year, medium, primarily nonresidential",2908,1104,1804,108,52,56,2908,49,0,2859,276,78,198,13,6,7,101,29,72,11,5,6,TX20
228653,The University of Texas Medical Branch at Galveston,UTMB,301 University Blvd,Galveston,TX,77555-0129,-94.775956,29.310758,Public,Graduate degree or certificate offering,No,Town: Fringe,Special Focus Four-Year: Research Institutions,Research Doctoral: STEM-dominant,Majority graduate,"Four-year, small, primarily residential",2989,956,2033,63,24,39,2989,874,0,2115,405,61,344,6,2,4,53,19,34,4,1,3,TX14
228705,Texas A & M University-Kingsville,Texas A&M-Kingsville,955 University Blvd,Kingsville,TX,78363,-97.882387,27.525168,Public,Graduate degree or certificate offering,No,Town: Distant,Doctoral Universities: High Research Activity,Research Doctoral: STEM-dominant,High undergraduate,"Four-year, medium, primarily residential",1666,787,879,479,328,151,1666,674,457,535,504,261,243,213,154,59,27,11,16,10,6,4,TX34
228723,Texas A & M University-College Station,Texas A&M | TAMU,"JKW Administration Building, Suite 200",College Station,TX,77843-1248,-96.336475,30.618726,Public,Graduate degree or certificate offering,No,City: Midsize,Doctoral Universities: Very High Research Activity,"Research Doctoral: Comprehensive programs, with medical/veterinary school",High undergraduate,"Four-year, large, primarily nonresidential",16871,8930,7941,4402,2900,1502,16871,2941,1020,12910,3603,1954,1649,924,602,322,795,484,311,419,279,140,TX10
228769,The University of Texas at Arlington,UT Arlington,701 S. Nedderman Dr.,Arlington,TX,76013,-97.11296,32.729718,Public,Graduate degree or certificate offering,No,City: Large,Doctoral Universities: Very High Research Activity,"Research Doctoral: Comprehensive programs, no medical/veterinary school",High undergraduate,"Four-year, large, primarily residential",17052,5178,11874,3205,2130,1075,17052,10737,732,5583,4902,1668,3234,1293,879,414,230,139,91,137,91,46,TX25
228778,The University of Texas at Austin,UT Austin,110 Inner Campus Drive,Austin,TX,78705,-97.738273,30.282825,Public,Graduate degree or certificate offering,No,City: Large,Doctoral Universities: Very High Research Activity,"Research Doctoral: Comprehensive programs, with medical/veterinary school",High undergraduate,"Four-year, large, primarily nonresidential",11304,5691,5613,2863,1777,1086,11304,2350,5265,3689,3093,1601,1492,624,357,267,733,406,327,281,195,86,TX37
228787,The University of Texas at Dallas,UT Dallas,800 West Campbell  Road,Richardson,TX,75080-3021,-96.749702,32.984673,Public,Graduate degree or certificate offering,No,City: Midsize,Doctoral Universities: Very High Research Activity,"Research Doctoral: Comprehensive programs, no medical/veterinary school",High undergraduate,"Four-year, large, primarily residential",8884,4891,3993,3825,2311,1514,8884,182,6690,2012,3103,1726,1377,1641,1006,635,244,141,103,144,96,48,TX32
228796,The University of Texas at El Paso,UTEP,500 W. University Ave,El Paso,TX,79968-0691,-106.504098,31.77015,Public,Graduate degree or certificate offering,No,City: Large,Doctoral Universities: Very High Research Activity,"Research Doctoral: Comprehensive programs, no medical/veterinary school",High undergraduate,"Four-year, large, primarily nonresidential",4888,2124,2764,595,353,242,4888,3375,1068,445,1139,518,621,116,78,38,84,40,44,28,16,12,TX16
228802,The University of Texas at Tyler,UT Tyler,3900 University Blvd,Tyler,TX,75799-6699,-95.254337,32.315772,Public,Graduate degree or certificate offering,No,City: Midsize,Doctoral Universities: High Research Activity,Research Doctoral: Professional-dominant,High undergraduate,"Four-year, medium, primarily residential",3506,1062,2444,80,51,29,3506,2661,657,188,916,297,619,28,18,10,22,6,16,0,0,0,TX01
228866,Texas Chiropractic College Foundation Inc,TCC/TxChiroCollege/,5912 Spencer Hwy,Pasadena,TX,77505-1699,-95.150135,29.663702,Private not-for-profit,Graduate degree or certificate offering,No,Suburb: Large,Special Focus Four-Year: Other Health Professions Schools,Postbaccalaureate: Single program-Other,Exclusively graduate,Exclusively graduate/professional,333,168,165,0,0,0,333,0,0,333,0,0,0,0,0,0,0,0,0,0,0,0,TX36
228875,Texas Christian University,TCU,2800 S University Dr,Fort Worth,TX,76129,-97.364758,32.70961,Private not-for-profit,Graduate degree or certificate offering,No,City: Large,Doctoral Universities: High Research Activity,"Research Doctoral: Comprehensive programs, no medical/veterinary school",High undergraduate,"Four-year, large, highly residential",1931,810,1121,104,51,53,1931,491,1147,293,493,217,276,33,20,13,50,25,25,5,2,3,TX12
228909,University of North Texas Health Science Center,UNT Health Science Center|UNTHSC|University of North Texas Health Sciences Center at Fort Worth|UNT Health Sciences Center|Texas College of Osteopathic Medicine|TCOM,3500 Camp Bowie Blvd,Fort Worth,TX,76107-2699,-97.369138,32.749907,Public,Graduate degree or certificate offering,No,City: Large,Special Focus Four-Year: Medical Schools & Centers,Research Doctoral: STEM-dominant,Exclusively graduate,Exclusively graduate/professional,2473,920,1553,62,20,42,2473,298,361,1814,436,146,290,9,1,8,14,6,8,4,2,2,TX12
228981,Texas Lutheran University,TLU,1000 W. Court St,Seguin,TX,78155-5999,-97.982669,29.573261,Private not-for-profit,Graduate degree or certificate offering,No,Town: Fringe,Baccalaureate Colleges: Diverse Fields,"Postbaccalaureate: Business-dominant, with other professional programs",Very high undergraduate,"Four-year, small, highly residential",48,18,30,1,0,1,48,15,0,33,31,8,23,1,0,1,0,0,0,0,0,0,TX15
229018,The University of Texas Permian Basin,UT Permian Basin,4901 E University,Odessa,TX,79762-0001,-102.329634,31.889509,Public,Graduate degree or certificate offering,No,City: Midsize,Master's Colleges & Universities: Larger Programs,Postbaccalaureate: Comprehensive programs,High undergraduate,"Four-year, small, primarily residential",2005,790,1215,66,44,22,2005,1604,282,119,451,180,271,14,9,5,0,0,0,0,0,0,TX11
229027,The University of Texas at San Antonio,UTSA,One UTSA Circle,San Antonio,TX,78249-1644,-98.620657,29.583709,Public,Graduate degree or certificate offering,No,City: Large,Doctoral Universities: Very High Research Activity,"Research Doctoral: Comprehensive programs, no medical/veterinary school",High undergraduate,"Four-year, large, primarily nonresidential",5549,2437,3112,574,321,253,5549,3325,2082,142,1311,543,768,101,49,52,134,71,63,49,33,16,TX20
229063,Texas Southern University,TSU,3100 Cleburne St,Houston,TX,77004,-95.361113,29.721046,Public,Graduate degree or certificate offering,Yes,City: Large,Doctoral Universities: High Research Activity,Research Doctoral: Professional-dominant,High undergraduate,"Four-year, medium, primarily residential",1938,709,1229,86,29,57,1938,550,944,444,239,83,156,8,1,7,17,6,11,2,0,2,TX18
229115,Texas Tech University, ,Broadway and University Avenue,Lubbock,TX,79409-5005,-101.874783,33.583448,Public,Graduate degree or certificate offering,No,City: Large,Doctoral Universities: Very High Research Activity,"Research Doctoral: Comprehensive programs, no medical/veterinary school",High undergraduate,"Four-year, large, primarily nonresidential",8262,3685,4577,1469,873,596,8262,3066,1378,3818,1797,813,984,206,122,84,382,186,196,161,93,68,TX19
229160,Texas Wesleyan University, ,1201 Wesleyan St,Fort Worth,TX,76105-1536,-97.279613,32.732962,Private not-for-profit,Graduate degree or certificate offering,No,City: Large,Doctoral/Professional Universities,Research Doctoral: Professional-dominant,Majority undergraduate,"Four-year, small, primarily residential",890,316,574,21,10,11,890,296,409,185,245,89,156,7,2,5,51,10,41,0,0,0,TX33
229179,Texas Woman's University,TWU,304 Administration Dr,Denton,TX,76204,-97.127842,33.226211,Public,Graduate degree or certificate offering,No,City: Midsize,Doctoral/Professional Universities,"Research Doctoral: Comprehensive programs, no medical/veterinary school",Majority undergraduate,"Four-year, large, primarily nonresidential",7900,767,7133,170,32,138,7900,4278,1482,2140,1547,148,1399,42,7,35,105,14,91,9,3,6,TX13
229267,Trinity University,Trinity,One Trinity Place,San Antonio,TX,78212-7200,-98.48186,29.462682,Private not-for-profit,Graduate degree or certificate offering,No,City: Large,Baccalaureate Colleges: Arts & Sciences Focus,"Postbaccalaureate: Education-dominant, with other professional programs",Very high undergraduate,"Four-year, small, highly residential",221,78,143,4,1,3,221,56,138,27,97,37,60,1,0,1,0,0,0,0,0,0,TX35
229300,The University of Texas Health Science Center at Houston,UTHealth,7000 Fannin,Houston,TX,77030,-95.403183,29.702873,Public,Graduate degree or certificate offering,No,City: Large,Special Focus Four-Year: Research Institutions,Research Doctoral: Professional-dominant,Majority graduate,"Four-year, medium, primarily nonresidential",5797,1796,4001,609,234,375,5797,59,1053,4685,729,179,550,50,13,37,178,54,124,42,17,25,TX09
229337,Texas Tech University Health Sciences Center, ,3601 4th Street,Lubbock,TX,79430,-101.891915,33.589284,Public,Graduate degree or certificate offering,No,City: Large,Special Focus Four-Year: Research Institutions,Research Doctoral: Professional-dominant,Majority graduate,"Four-year, medium, primarily nonresidential",4951,1378,3573,101,41,60,4951,2061,1785,1105,724,163,561,10,4,6,55,21,34,9,6,3,TX19
229780,Wayland Baptist University, ,1900 W. 7th Street,Plainview,TX,79072,-101.730042,34.187677,Private not-for-profit,Graduate degree or certificate offering,No,Town: Remote,Master's Colleges & Universities: Larger Programs,Research Doctoral: Single program-Other,High undergraduate,"Four-year, small, primarily residential",1334,597,737,14,8,6,1334,803,458,73,390,188,202,4,1,3,1,1,0,0,0,0,TX19
229814,West Texas A & M University,WTAMU,2501 4th Ave,Canyon,TX,79016-0001,-101.914736,34.982789,Public,Graduate degree or certificate offering,No,Town: Fringe,Master's Colleges & Universities: Larger Programs,Research Doctoral: Single program-Other,High undergraduate,"Four-year, medium, primarily residential",3370,1380,1990,151,80,71,3370,2740,630,0,834,364,470,72,37,35,0,0,0,0,0,0,TX13
230038,Brigham Young University,BYU,Main Campus,Provo,UT,84602,-111.649281,40.250851,Private not-for-profit,Graduate degree or certificate offering,No,City: Midsize,Doctoral Universities: High Research Activity,Research Doctoral: STEM-dominant,Very high undergraduate,"Four-year, large, primarily nonresidential",3420,1859,1561,311,169,142,3420,373,2359,688,961,548,413,65,33,32,88,58,30,14,11,3,UT03
230056,Broadview College, ,1902 W 7800 S,West Jordan,UT,84088,-111.942296,40.609883,Private for-profit,No graduate offering,No,Suburb: Large,Special Focus Two-Year: Other Fields,Not classified (Exclusively Undergraduate),Exclusively undergraduate two-year,"Two-year, very small",1,0,1,0,0,0,1,0,1,0,1,0,1,0,0,0,0,0,0,0,0,0,UT04
230171,Dixie State University,Dixie,225 S University Avenue,Saint George,UT,84770-3876,-113.565903,37.102769,Public,Graduate degree or certificate offering,No,City: Small,Baccalaureate Colleges: Diverse Fields,Postbaccalaureate: Single program-Business,Very high undergraduate,"Four-year, medium, primarily nonresidential",57,20,37,1,0,1,57,2,23,32,24,13,11,0,0,0,0,0,0,0,0,0,UT02
230366,Eagle Gate College-Murray, ,5588 South Green Street,Murray,UT,84123-6965,-111.903609,40.649984,Private for-profit,Graduate degree or certificate offering,No,Suburb: Large,Special Focus Four-Year: Other Health Professions Schools,Not classified (Exclusively Undergraduate),Very high undergraduate,"Four-year, very small, primarily nonresidential",23,6,17,0,0,0,23,0,23,0,2,0,2,0,0,0,0,0,0,0,0,0,UT04
230603,Southern Utah University, ,351 West University Blvd,Cedar City,UT,84720,-113.070146,37.674617,Public,Graduate degree or certificate offering,No,Town: Remote,Master's Colleges & Universities: Larger Programs,"Postbaccalaureate: Education-dominant, with Arts & Sciences",Very high undergraduate,"Four-year, medium, primarily nonresidential",1956,956,1000,54,27,27,1956,1638,255,63,511,222,289,26,16,10,0,0,0,0,0,0,UT02
230728,Utah State University, ,Old Main Hill,Logan,UT,84322-1400,-111.81391,41.740748,Public,Graduate degree or certificate offering,No,City: Small,Doctoral Universities: Very High Research Activity,"Research Doctoral: Comprehensive programs, with medical/veterinary school",Very high undergraduate,"Four-year, large, primarily nonresidential",3739,1530,2209,220,119,101,3739,1731,1313,695,993,491,502,34,19,15,93,59,34,2,2,0,UT01
230737,Utah Valley University,UVU,800 W University Parkway,Orem,UT,84058-5999,-111.716456,40.281078,Public,Graduate degree or certificate offering,No,City: Small,Master's Colleges & Universities: Larger Programs,"Postbaccalaureate: Business-dominant, with Arts & Sciences",Very high undergraduate,"Four-year, large, primarily nonresidential",842,411,431,14,11,3,842,187,406,249,292,149,143,3,2,1,0,0,0,0,0,0,UT03
230764,University of Utah,The U,"201 Presidents Circle, ROOM 201",Salt Lake City,UT,84112-9008,-111.846044,40.762484,Public,Graduate degree or certificate offering,No,City: Midsize,Doctoral Universities: Very High Research Activity,"Research Doctoral: Comprehensive programs, with medical/veterinary school",Majority undergraduate,"Four-year, large, primarily residential",9235,4709,4526,1195,762,433,9235,1516,5525,2194,2283,1202,1081,258,144,114,355,194,161,111,65,46,UT01
230782,Weber State University,WSU,3848 Harrison Blvd.,Ogden,UT,84408-1001,-111.944845,41.192591,Public,Graduate degree or certificate offering,No,City: Small,Master's Colleges & Universities: Larger Programs,"Postbaccalaureate: Other-dominant, with Arts & Sciences",Very high undergraduate,"Four-year, large, primarily nonresidential",1116,470,646,33,18,15,1116,628,443,45,294,141,153,8,4,4,0,0,0,0,0,0,UT01
230807,Westminster College,Westminster|Westminster College Salt Lake|Westminster College Salt Lake City|Westminster College Salt Lake City Utah|Westminster College of Salt Lake|Westminster College of Salt Lake City|Westminster College of Salt Lake City Utah|Westminster Griffins|Griffins|Salt Lake Griffins|Utah Griffins,1840 South 1300 East,Salt Lake City,UT,84105,-111.855757,40.730779,Private not-for-profit,Graduate degree or certificate offering,No,City: Midsize,Master's Colleges & Universities: Medium Programs,"Postbaccalaureate: Business-dominant, with Arts & Sciences",High undergraduate,"Four-year, small, highly residential",535,175,360,23,8,15,535,98,188,249,215,72,143,4,3,1,0,0,0,0,0,0,UT02
230816,Bennington College,Bennington,One College Drive,Bennington,VT,05201-6003,-73.237799,42.919547,Private not-for-profit,Graduate degree or certificate offering,No,Town: Distant,Baccalaureate Colleges: Arts & Sciences Focus,"Postbaccalaureate: Other-dominant, with Arts & Sciences",High undergraduate,"Four-year, very small, highly residential",147,28,119,1,1,0,147,139,8,0,40,7,33,0,0,0,0,0,0,0,0,0,VT00
230834,Castleton University, ,62 Alumni Dr,Castleton,VT,05735,-73.180842,43.608397,Public,Graduate degree or certificate offering,No,Town: Distant,Master's Colleges & Universities: Small Programs,"Postbaccalaureate: Education-dominant, with other professional programs",High undergraduate,"Four-year, small, highly residential",1232,263,969,6,1,5,1232,90,61,1081,45,16,29,0,0,0,0,0,0,0,0,0,VT00
230852,Champlain College, ,163 S Willard St,Burlington,VT,05401,-73.202746,44.473287,Private not-for-profit,Graduate degree or certificate offering,No,City: Small,Master's Colleges & Universities: Larger Programs,"Postbaccalaureate: Business-dominant, with other professional programs",Very high undergraduate,"Four-year, small, primarily residential",1105,519,586,0,0,0,1105,1093,6,6,329,143,186,0,0,0,0,0,0,0,0,0,VT00
230889,Goddard College, ,123 Pitkin Road,Plainfield,VT,05667-9432,-72.438388,44.279087,Private not-for-profit,Graduate degree or certificate offering,No,Rural: Distant,Master's Colleges & Universities: Small Programs,Postbaccalaureate: Arts & sciences-dominant,Majority graduate,"Four-year, very small, primarily nonresidential",285,75,210,0,0,0,285,0,0,285,77,22,55,0,0,0,0,0,0,0,0,0,VT00
230913,Northern Vermont University, ,337 College Hill,Johnson,VT,05656-9464,-72.671154,44.641736,Public,Graduate degree or certificate offering,No,Rural: Distant,Master's Colleges & Universities: Small Programs,"Postbaccalaureate: Other-dominant, with Arts & Sciences",Very high undergraduate,"Four-year, small, primarily residential",436,79,357,5,0,5,436,51,51,334,78,12,66,0,0,0,0,0,0,0,0,0,VT00
230959,Middlebury College, ,Old Chapel,Middlebury,VT,05753,-73.176068,44.009117,Private not-for-profit,Graduate degree or certificate offering,No,Town: Distant,Baccalaureate Colleges: Arts & Sciences Focus,Research Doctoral: Single program-Other,Very high undergraduate,"Four-year, small, highly residential",535,170,365,65,22,43,535,535,0,0,105,30,75,11,4,7,1,0,1,0,0,0,VT00
230995,Norwich University, ,158 Harmon Drive,Northfield,VT,05663-1035,-72.659783,44.140237,Private not-for-profit,Graduate degree or certificate offering,No,Town: Distant,Master's Colleges & Universities: Larger Programs,Postbaccalaureate: Comprehensive programs,High undergraduate,"Four-year, medium, primarily residential",1553,1052,501,0,0,0,1553,12,1541,0,413,286,127,0,0,0,0,0,0,0,0,0,VT00
231059,Saint Michael's College, ,One Winooski Park,Colchester,VT,05439,-73.167069,44.494558,Private not-for-profit,Graduate degree or certificate offering,No,Suburb: Midsize,Baccalaureate Colleges: Arts & Sciences Focus,"Postbaccalaureate: Education-dominant, with other professional programs",Very high undergraduate,"Four-year, small, highly residential",583,114,469,11,5,6,583,113,150,320,84,26,58,6,4,2,0,0,0,0,0,0,VT00
231068,SIT Graduate Institute,SIT; School for International Training,1 Kipling Rd,Brattleboro,VT,05302-0676,-72.56738,42.891035,Private not-for-profit,Graduate degree or certificate offering,No,Rural: Fringe,Master's Colleges & Universities: Small Programs,"Postbaccalaureate: Education-dominant, with Arts & Sciences",Majority graduate,Exclusively graduate/professional,158,45,113,14,9,5,158,135,11,12,48,18,30,4,3,1,0,0,0,0,0,0,VT00
231147,Vermont Law School,VLS,164 Chelsea Street,South Royalton,VT,05068-0096,-72.520919,43.821406,Private not-for-profit,Graduate degree or certificate offering,No,Rural: Remote,Special Focus Four-Year: Law Schools,Postbaccalaureate: Single program-Other,Exclusively graduate,Exclusively graduate/professional,864,326,538,16,4,12,864,204,284,376,120,52,68,3,0,3,0,0,0,0,0,0,VT00
231165,Vermont Technical College,VT Tech  VTC,124 Admin Drive,Randolph,VT,05061,-72.604498,43.939623,Public,Graduate degree or certificate offering,No,Rural: Remote,Baccalaureate/Associate's Colleges: Mixed Baccalaureate/Associate's,Postbaccalaureate: Single program-Other,Very high undergraduate,"Four-year, very small, primarily residential",7,6,1,0,0,0,7,0,0,7,2,2,0,1,1,0,0,0,0,0,0,0,VT00
231174,University of Vermont,UVM,85 S Prospect St,Burlington,VT,05405-0160,-73.196646,44.477325,Public,Graduate degree or certificate offering,No,City: Small,Doctoral Universities: High Research Activity,Research Doctoral: STEM-dominant,High undergraduate,"Four-year, large, highly residential",2439,945,1494,160,99,61,2439,327,941,1171,458,165,293,23,12,11,72,35,37,14,11,3,VT00
231420,Averett University,AU,420 W Main St,Danville,VA,24541,-79.413203,36.577287,Private not-for-profit,Graduate degree or certificate offering,No,Town: Distant,Master's Colleges & Universities: Medium Programs,"Postbaccalaureate: Business-dominant, with other professional programs",High undergraduate,"Four-year, small, highly residential",357,110,247,0,0,0,357,353,4,0,126,41,85,0,0,0,0,0,0,0,0,0,VA05
231554,Bluefield University, ,3000 College Avenue,Bluefield,VA,24605,-81.246233,37.244557,Private not-for-profit,Graduate degree or certificate offering,No,Town: Distant,Master's Colleges & Universities: Medium Programs,"Postbaccalaureate: Other-dominant, with Arts & Sciences",High undergraduate,"Four-year, very small, highly residential",317,97,220,1,1,0,317,188,0,129,142,45,97,0,0,0,0,0,0,0,0,0,VA09
231581,Bridgewater College,BC|Bridgewater,402 E College St,Bridgewater,VA,22812-1599,-78.969007,38.378484,Private not-for-profit,Graduate degree or certificate offering,No,Suburb: Small,Baccalaureate Colleges: Arts & Sciences Focus,"Postbaccalaureate: Other-dominant, with Arts & Sciences",Very high undergraduate,"Four-year, small, highly residential",51,21,30,1,1,0,51,0,36,15,30,12,18,0,0,0,0,0,0,0,0,0,VA06
231624,William & Mary,William & Mary,200 Richmond Road,Williamsburg,VA,23187-8795,-76.708214,37.269489,Public,Graduate degree or certificate offering,No,Suburb: Small,Doctoral Universities: High Research Activity,"Research Doctoral: Comprehensive programs, no medical/veterinary school",High undergraduate,"Four-year, medium, highly residential",3270,1531,1739,284,167,117,3270,1851,909,510,744,413,331,104,57,47,60,30,30,19,15,4,VA01
231651,Regent University, ,1000 Regent University Dr,Virginia Beach,VA,23464,-76.194627,36.801173,Private not-for-profit,Graduate degree or certificate offering,No,City: Large,Doctoral/Professional Universities,Research Doctoral: Professional-dominant,Majority undergraduate,"Four-year, medium, primarily nonresidential",7723,2672,5051,261,106,155,7723,6749,539,435,1094,361,733,8,2,6,271,99,172,1,1,0,VA02
231712,Christopher Newport University,CNU,1 Avenue of the Arts,Newport News,VA,23606-3072,-76.494364,37.062495,Public,Graduate degree or certificate offering,No,City: Midsize,Master's Colleges & Universities: Small Programs,"Postbaccalaureate: Education-dominant, with Arts & Sciences",Very high undergraduate,"Four-year, medium, highly residential",125,62,63,1,1,0,125,14,91,20,85,40,45,1,1,0,0,0,0,0,0,0,VA03
231970,Eastern Virginia Medical School, ,700w. Olney,Norfolk,VA,23507,-76.300694,36.861232,Public,Graduate degree or certificate offering,No,City: Midsize,Special Focus Four-Year: Research Institutions,Research Doctoral: Professional-dominant,Exclusively graduate,Exclusively graduate/professional,1450,541,909,0,0,0,1450,270,57,1123,303,85,218,0,0,0,33,11,22,0,0,0,VA03
232025,Emory & Henry College, ,30461 Garnand Drive,Emory,VA,24327-0947,-81.829142,36.772857,Private not-for-profit,Graduate degree or certificate offering,No,Rural: Fringe,Master's Colleges & Universities: Medium Programs,"Postbaccalaureate: Other-dominant, with other professional programs",High undergraduate,"Four-year, small, highly residential",376,108,268,1,1,0,376,0,376,0,78,13,65,0,0,0,0,0,0,0,0,0,VA09
232043,Eastern Mennonite University,Eastern mennonite univ  EMU university  EMU college  EMU  Eastern mennonite  Eastern mennonite college  EMC   Eastern mennonite seminary  Eastern menonite,1200 Park Rd,Harrisonburg,VA,22802-2462,-78.880326,38.471134,Private not-for-profit,Graduate degree or certificate offering,No,City: Small,Master's Colleges & Universities: Medium Programs,"Postbaccalaureate: Other-dominant, with Arts & Sciences",High undergraduate,"Four-year, small, highly residential",782,164,618,14,4,10,782,609,139,34,79,18,61,5,1,4,0,0,0,0,0,0,VA06
232089,Ferrum College, ,215 Ferrum Mountain Road,Ferrum,VA,24088-9000,-80.021639,36.926912,Private not-for-profit,Graduate degree or certificate offering,No,Rural: Distant,Baccalaureate Colleges: Diverse Fields,Not classified (Exclusively Undergraduate),Very high undergraduate,"Four-year, very small, highly residential",14,4,10,0,0,0,14,14,0,0,0,0,0,0,0,0,0,0,0,0,0,0,VA09
232186,George Mason University,Mason,4400 University Dr,Fairfax,VA,22030-4444,-77.307428,38.829976,Public,Graduate degree or certificate offering,No,Suburb: Large,Doctoral Universities: Very High Research Activity,"Research Doctoral: Comprehensive programs, no medical/veterinary school",High undergraduate,"Four-year, large, primarily nonresidential",14279,5715,8564,1673,851,822,14279,8308,4698,1273,3107,1112,1995,494,238,256,281,130,151,53,30,23,VA11
232265,Hampton University, ,200 William R. Harvey Way,Hampton,VA,23668-0099,-76.339161,37.019944,Private not-for-profit,Graduate degree or certificate offering,Yes,City: Midsize,Doctoral/Professional Universities,Research Doctoral: Professional-dominant,High undergraduate,"Four-year, medium, highly residential",501,146,355,22,12,10,501,141,0,360,120,38,82,6,3,3,25,11,14,4,4,0,VA03
232308,Hollins University,Hollins College,7916 Williamson Rd NW,Roanoke,VA,24020,-79.943277,37.354201,Private not-for-profit,Graduate degree or certificate offering,No,Suburb: Midsize,Baccalaureate Colleges: Arts & Sciences Focus,"Postbaccalaureate: Other-dominant, with Arts & Sciences",Very high undergraduate,"Four-year, very small, highly residential",239,67,172,3,1,2,239,111,100,28,61,15,46,1,1,0,0,0,0,0,0,0,VA06
232423,James Madison University,JMU,800 South Main Street,Harrisonburg,VA,22807,-78.870484,38.436311,Public,Graduate degree or certificate offering,No,City: Small,Doctoral Universities: High Research Activity,Research Doctoral: Professional-dominant,Very high undergraduate,"Four-year, large, primarily residential",2196,614,1582,73,29,44,2196,622,1325,249,706,181,525,13,8,5,37,8,29,3,1,2,VA06
232557,Liberty University, ,1971 University Blvd,Lynchburg,VA,24515,-79.18222,37.350232,Private not-for-profit,Graduate degree or certificate offering,No,City: Small,Doctoral/Professional Universities,Research Doctoral: Professional-dominant,Majority undergraduate,"Four-year, large, primarily nonresidential",64558,25376,39182,276,136,140,64558,63329,956,273,10229,4073,6156,140,64,76,796,361,435,12,6,6,VA05
232566,Longwood University, ,201 High St,Farmville,VA,23909,-78.39575,37.301137,Public,Graduate degree or certificate offering,No,Town: Remote,Master's Colleges & Universities: Medium Programs,"Postbaccalaureate: Education-dominant, with other professional programs",High undergraduate,"Four-year, medium, highly residential",1273,322,951,13,6,7,1273,691,247,335,204,19,185,1,0,1,0,0,0,0,0,0,VA05
232609,University of Lynchburg,Lynchburg,1501 Lakeside Dr,Lynchburg,VA,24501-3113,-79.181653,37.399774,Private not-for-profit,Graduate degree or certificate offering,No,City: Small,Doctoral/Professional Universities,Research Doctoral: Single program-Other,Majority undergraduate,"Four-year, small, highly residential",1234,439,795,18,7,11,1234,610,454,170,160,45,115,3,1,2,9,3,6,0,0,0,VA05
232672,Mary Baldwin University,MBU,318 Prospect Street,Staunton,VA,24401,-79.069273,38.153884,Private not-for-profit,Graduate degree or certificate offering,No,City: Small,Doctoral/Professional Universities,"Postbaccalaureate: Other-dominant, with Arts & Sciences",Majority undergraduate,"Four-year, small, highly residential",848,152,696,3,0,3,848,419,259,170,145,24,121,0,0,0,0,0,0,0,0,0,VA06
232681,University of Mary Washington,Mary Washington College,1301 College Ave,Fredericksburg,VA,22401-5300,-77.476055,38.302492,Public,Graduate degree or certificate offering,No,Suburb: Midsize,Baccalaureate Colleges: Arts & Sciences Focus,"Postbaccalaureate: Education-dominant, with Arts & Sciences",Very high undergraduate,"Four-year, medium, highly residential",345,108,237,4,1,3,345,186,139,20,146,32,114,3,0,3,0,0,0,0,0,0,VA07
232706,Marymount University, ,2807 N Glebe Rd,Arlington,VA,22207-4299,-77.128785,38.905562,Private not-for-profit,Graduate degree or certificate offering,No,City: Midsize,Doctoral/Professional Universities,"Postbaccalaureate: Other-dominant, with Arts & Sciences",Majority undergraduate,"Four-year, small, primarily residential",1547,464,1083,178,61,117,1547,315,1140,92,438,105,333,84,23,61,14,8,6,0,0,0,VA08
232797,American National University, ,1813 East Main Street,Salem,VA,24153,-80.023602,37.299743,Private for-profit,Graduate degree or certificate offering,No,Suburb: Midsize,Baccalaureate/Associate's Colleges: Mixed Baccalaureate/Associate's,"Postbaccalaureate: Business-dominant, with Arts & Sciences",High undergraduate,"Four-year, very small, primarily nonresidential",125,77,48,7,3,4,125,23,102,0,25,14,11,2,1,1,0,0,0,0,0,0,VA06
232885,Sentara College of Health Sciences,Sentara College,"1441 Crossways Blvd, Suite 105",Chesapeake,VA,23320,-76.243308,36.777043,Private not-for-profit,Graduate degree or certificate offering,No,Suburb: Large,Special Focus Four-Year: Other Health Professions Schools,Not classified (Exclusively Undergraduate),High undergraduate,"Four-year, very small, primarily nonresidential",80,5,75,0,0,0,80,15,65,0,15,1,14,0,0,0,0,0,0,0,0,0,VA03
232937,Norfolk State University,Norfolk State; NSU,700 Park Avenue,Norfolk,VA,23504-8000,-76.261375,36.848429,Public,Graduate degree or certificate offering,Yes,City: Midsize,Master's Colleges & Universities: Medium Programs,Research Doctoral: Professional-dominant,Very high undergraduate,"Four-year, medium, highly residential",571,210,361,44,30,14,571,127,312,132,124,44,80,8,5,3,10,6,4,0,0,0,VA03
232982,Old Dominion University,"ODU, Old Dominion",5115 Hampton Blvd,Norfolk,VA,23529,-76.30666,36.886418,Public,Graduate degree or certificate offering,No,City: Midsize,Doctoral Universities: Very High Research Activity,"Research Doctoral: Comprehensive programs, no medical/veterinary school",High undergraduate,"Four-year, large, primarily residential",6082,2446,3636,453,269,184,6082,4236,921,925,980,371,609,54,32,22,150,65,85,37,30,7,VA03
233277,Radford University, ,801 East Main St.,Radford,VA,24142,-80.549728,37.136907,Public,Graduate degree or certificate offering,No,Suburb: Small,Doctoral/Professional Universities,Postbaccalaureate: Comprehensive programs,High undergraduate,"Four-year, medium, highly residential",5787,814,4973,14,9,5,5787,4924,612,251,417,87,330,7,5,2,0,0,0,0,0,0,VA09
233301,Randolph College,Randolph|Randolph-Macon Woman's College|Randolph Macon Women's College|Randolph-Macon Womens College|Randolph Macon Womens College|R-MWC|RMWC|Randolf-Macon Women's College|Randolf Macon Women's College|Randolf|Randolph Lynchburg|RC|Lynchburg Randolph,2500 Rivermont Ave,Lynchburg,VA,24503-1555,-79.171887,37.437315,Private not-for-profit,Graduate degree or certificate offering,No,City: Small,Baccalaureate Colleges: Arts & Sciences Focus,Postbaccalaureate: Single program-Education,High undergraduate,"Four-year, very small, highly residential",71,30,41,0,0,0,71,5,66,0,17,11,6,0,0,0,0,0,0,0,0,0,VA05
233374,University of Richmond,UR/U of Richmond/Richmond,410 Westhampton Way,University of Richmond,VA,23173,-77.538806,37.577393,Private not-for-profit,Graduate degree or certificate offering,No,City: Midsize,Baccalaureate Colleges: Arts & Sciences Focus,"Postbaccalaureate: Other-dominant, with Arts & Sciences",High undergraduate,"Four-year, medium, highly residential",905,354,551,18,8,10,905,387,368,150,104,44,60,3,2,1,0,0,0,0,0,0,VA04
233541,Shenandoah University,SU,1460 University Dr,Winchester,VA,22601-5195,-78.157433,39.167355,Private not-for-profit,Graduate degree or certificate offering,No,City: Small,Doctoral/Professional Universities,Research Doctoral: Professional-dominant,Majority undergraduate,"Four-year, medium, highly residential",2532,578,1954,89,19,70,2532,829,1241,462,300,74,226,0,0,0,124,36,88,2,0,2,VA06
233684,Strayer University-Virginia, ,2121 15th Street N,Arlington,VA,22201,-77.085294,38.890995,Private for-profit,Graduate degree or certificate offering,No,City: Midsize,Master's Colleges & Universities: Larger Programs,"Postbaccalaureate: Business-dominant, with Arts & Sciences",High undergraduate,"Four-year, small, primarily nonresidential",1341,482,859,64,20,44,1341,1341,0,0,411,165,246,28,10,18,0,0,0,0,0,0,VA08
233718,Sweet Briar College, ,134 Chapel Drive,Sweet Briar,VA,24595-9998,-79.081014,37.556725,Private not-for-profit,Graduate degree or certificate offering,No,Suburb: Midsize,Baccalaureate Colleges: Arts & Sciences Focus,Postbaccalaureate: Single program-Education,Very high undergraduate,"Four-year, very small, highly residential",6,0,6,0,0,0,6,0,0,6,4,0,4,0,0,0,0,0,0,0,0,0,VA05
233842,Union Presbyterian Seminary,Union Presbyterian,3401 Brook Rd,Richmond,VA,23227,-77.449314,37.578928,Private not-for-profit,Graduate degree or certificate offering,No,City: Midsize,Special Focus Four-Year: Faith-Related Institutions,Research Doctoral: Single program-Other,Exclusively graduate,Exclusively graduate/professional,180,70,110,3,2,1,180,0,73,107,39,14,25,0,0,0,0,0,0,0,0,0,VA04
233921,Virginia Polytechnic Institute and State University,Virginia Tech,"210 Burruss Hall, 800 Drillfield Dr.",Blacksburg,VA,24061-0131,-80.423675,37.229012,Public,Graduate degree or certificate offering,No,City: Small,Doctoral Universities: Very High Research Activity,"Research Doctoral: Comprehensive programs, with medical/veterinary school",High undergraduate,"Four-year, large, primarily residential",8060,4586,3474,2100,1407,693,8060,2085,4023,1952,1429,830,599,342,237,105,489,292,197,221,148,73,VA09
234030,Virginia Commonwealth University,VCU,910 W Franklin St,Richmond,VA,23284-2512,-77.452697,37.54962,Public,Graduate degree or certificate offering,No,City: Midsize,Doctoral Universities: Very High Research Activity,"Research Doctoral: Comprehensive programs, with medical/veterinary school",High undergraduate,"Four-year, large, primarily residential",8148,2810,5338,565,298,267,8148,69,5199,2880,1274,427,847,50,22,28,370,126,244,42,22,20,VA04
234076,University of Virginia-Main Campus,University of Virginia  UVa  UVA,1827 University Avenue,Charlottesville,VA,22903-2628,-78.503428,38.035665,Public,Graduate degree or certificate offering,No,Suburb: Small,Doctoral Universities: Very High Research Activity,"Research Doctoral: Comprehensive programs, with medical/veterinary school",Majority undergraduate,"Four-year, large, primarily residential",9658,4459,5199,1568,864,704,9658,2798,5158,1702,2170,1037,1133,427,220,207,328,178,150,100,70,30,VA05
234137,Virginia University of Lynchburg, ,2058 Garfield Ave,Lynchburg,VA,24501,-79.151615,37.395187,Private not-for-profit,Graduate degree or certificate offering,Yes,City: Small,Baccalaureate/Associate's Colleges: Mixed Baccalaureate/Associate's,"Postbaccalaureate: Other-dominant, with Arts & Sciences",Majority graduate,"Four-year, very small, highly residential",360,153,207,0,0,0,360,360,0,0,0,0,0,0,0,0,0,0,0,0,0,0,VA05
234155,Virginia State University,VSU,1 Hayden Drive,Petersburg,VA,23806,-77.419026,37.234692,Public,Graduate degree or certificate offering,Yes,Suburb: Large,Master's Colleges & Universities: Medium Programs,Research Doctoral: Professional-dominant,Very high undergraduate,"Four-year, medium, highly residential",863,232,631,50,27,23,863,32,0,831,79,34,45,14,8,6,11,2,9,1,0,1,VA04
234164,Virginia Union University,VUU,1500 N Lombardy St,Richmond,VA,23220,-77.450903,37.562405,Private not-for-profit,Graduate degree or certificate offering,Yes,City: Midsize,Baccalaureate Colleges: Arts & Sciences Focus,"Postbaccalaureate: Other-dominant, with other professional programs",High undergraduate,"Four-year, small, highly residential",422,216,206,7,5,2,422,0,422,0,85,42,43,2,1,1,0,0,0,0,0,0,VA04
234173,Virginia Wesleyan University,VWU | Marlins | VA Wesleyan | Wesleyan,5817 Wesleyan Drive,Virginia Beach,VA,23455,-76.18606,36.868417,Private not-for-profit,Graduate degree or certificate offering,No,City: Large,Baccalaureate Colleges: Arts & Sciences Focus,"Postbaccalaureate: Business-dominant, with other professional programs",Very high undergraduate,"Four-year, small, highly residential",116,47,69,1,0,1,116,105,0,11,36,18,18,0,0,0,0,0,0,0,0,0,VA02
234207,Washington and Lee University,"Washington and Lee, W&L, WLU",204 West Washington Street,Lexington,VA,24450-2116,-79.443018,37.788939,Private not-for-profit,Graduate degree or certificate offering,No,Town: Distant,Baccalaureate Colleges: Arts & Sciences Focus,Postbaccalaureate: Single program-Other,High undergraduate,"Four-year, small, highly residential",363,185,178,13,4,9,363,0,358,5,0,0,0,0,0,0,0,0,0,0,0,0,VA06
234827,Central Washington University,CWU,400 East University Way,Ellensburg,WA,98926,-120.538368,47.002687,Public,Graduate degree or certificate offering,No,Town: Distant,Master's Colleges & Universities: Larger Programs,Postbaccalaureate: Comprehensive programs,Very high undergraduate,"Four-year, medium, primarily residential",997,429,568,32,17,15,997,493,429,75,322,127,195,5,1,4,0,0,0,0,0,0,WA08
234915,City University of Seattle,CityU,"521 Wall Street, Suite 100",Seattle,WA,98121,-122.344594,47.617381,Private not-for-profit,Graduate degree or certificate offering,No,City: Large,Doctoral/Professional Universities,Research Doctoral: Professional-dominant,Majority graduate,"Four-year, very small, primarily nonresidential",1609,632,977,208,98,110,1609,885,644,80,404,150,254,97,46,51,25,11,14,0,0,0,WA07
235097,Eastern Washington University,EWU,526 5th Street,Cheney,WA,99004-2496,-117.583808,47.490667,Public,Graduate degree or certificate offering,No,Town: Fringe,Master's Colleges & Universities: Larger Programs,Postbaccalaureate: Comprehensive programs,High undergraduate,"Four-year, medium, primarily residential",3500,1071,2429,12,5,7,3500,2907,593,0,832,207,625,2,1,1,0,0,0,0,0,0,WA05
235167,The Evergreen State College,Evergreen|TESC|,2700 Evergreen Pkwy NW,Olympia,WA,98505-0001,-122.977492,47.07382,Public,Graduate degree or certificate offering,No,Suburb: Midsize,Master's Colleges & Universities: Medium Programs,"Postbaccalaureate: Other-dominant, with Arts & Sciences",Very high undergraduate,"Four-year, small, primarily residential",271,86,185,2,2,0,271,0,0,271,81,26,55,1,1,0,0,0,0,0,0,0,WA10
235316,Gonzaga University, ,E 502 Boone Ave,Spokane,WA,99258-0001,-117.400625,47.666531,Private not-for-profit,Graduate degree or certificate offering,No,City: Midsize,Doctoral/Professional Universities,Research Doctoral: Single program-Other,High undergraduate,"Four-year, medium, highly residential",3109,1072,2037,159,51,108,3109,2014,979,116,620,224,396,34,8,26,12,6,6,2,1,1,WA05
235422,Heritage University, ,3240 Fort Rd,Toppenish,WA,98948,-120.394972,46.3748,Private not-for-profit,Graduate degree or certificate offering,No,Rural: Fringe,Master's Colleges & Universities: Small Programs,"Postbaccalaureate: Education-dominant, with Arts & Sciences",High undergraduate,"Four-year, very small, primarily nonresidential",228,67,161,0,0,0,228,14,29,185,104,37,67,0,0,0,0,0,0,0,0,0,WA04
235547,Bastyr University, ,14500 Juanita Drive NE,Kenmore,WA,98028-4966,-122.251708,47.729935,Private not-for-profit,Graduate degree or certificate offering,No,Suburb: Large,Doctoral/Professional Universities,"Postbaccalaureate: Other-dominant, with Arts & Sciences",Majority graduate,"Four-year, very small, primarily residential",843,125,718,23,6,17,843,0,843,0,123,12,111,2,0,2,0,0,0,0,0,0,WA01
236133,Northwest University, ,5520 108th Ave NE,Kirkland,WA,98083-0579,-122.192763,47.657945,Private not-for-profit,Graduate degree or certificate offering,No,Suburb: Large,Master's Colleges & Universities: Medium Programs,Research Doctoral: Single program-Other,Majority undergraduate,"Four-year, small, highly residential",368,137,231,47,16,31,368,5,63,300,126,39,87,10,3,7,7,1,6,0,0,0,WA01
236230,Pacific Lutheran University,PLU,12180 Park Ave South,Tacoma,WA,98447-0003,-122.440421,47.14516,Private not-for-profit,Graduate degree or certificate offering,No,Suburb: Large,Master's Colleges & Universities: Medium Programs,"Postbaccalaureate: Other-dominant, with Arts & Sciences",High undergraduate,"Four-year, small, highly residential",607,166,441,15,4,11,607,77,333,197,149,47,102,2,2,0,0,0,0,0,0,0,WA10
236328,University of Puget Sound, ,1500 N. Warner Street,Tacoma,WA,98416,-122.478982,47.26308,Private not-for-profit,Graduate degree or certificate offering,No,City: Midsize,Baccalaureate Colleges: Arts & Sciences Focus,"Postbaccalaureate: Other-dominant, with other professional programs",High undergraduate,"Four-year, small, highly residential",345,71,274,0,0,0,345,0,0,345,92,23,69,0,0,0,0,0,0,0,0,0,WA06
236452,Saint Martin's University, ,5000 Abbey Way SE,Lacey,WA,98503-7500,-122.816354,47.041068,Private not-for-profit,Graduate degree or certificate offering,No,City: Small,Master's Colleges & Universities: Small Programs,"Postbaccalaureate: Other-dominant, with Arts & Sciences",Very high undergraduate,"Four-year, small, primarily residential",266,113,153,10,6,4,266,0,20,246,86,34,52,4,2,2,0,0,0,0,0,0,WA10
236577,Seattle Pacific University,SPU,3307 3rd Ave W,Seattle,WA,98119-1997,-122.361667,47.650214,Private not-for-profit,Graduate degree or certificate offering,No,City: Large,Doctoral/Professional Universities,Research Doctoral: Professional-dominant,High undergraduate,"Four-year, medium, highly residential",1040,288,752,60,13,47,1040,466,390,184,256,65,191,16,3,13,54,8,46,4,0,4,WA07
236595,Seattle University,Seattle U,900 Broadway,Seattle,WA,98122-4340,-122.318851,47.608859,Private not-for-profit,Graduate degree or certificate offering,No,City: Large,Doctoral/Professional Universities,"Postbaccalaureate: Other-dominant, with Arts & Sciences",Majority undergraduate,"Four-year, medium, highly residential",3269,1135,2134,305,113,192,3269,167,1824,1278,589,203,386,109,42,67,0,0,0,0,0,0,WA09
236896,Walla Walla University,Walla Walla College,204 S College Ave,College Place,WA,99324-1198,-118.389555,46.048088,Private not-for-profit,Graduate degree or certificate offering,No,Suburb: Small,Master's Colleges & Universities: Small Programs,"Postbaccalaureate: Other-dominant, with Arts & Sciences",High undergraduate,"Four-year, small, highly residential",260,61,199,18,9,9,260,117,124,19,105,20,85,0,0,0,0,0,0,0,0,0,WA05
236939,Washington State University, ,French Administration Building,Pullman,WA,99164-5910,-117.158168,46.730448,Public,Graduate degree or certificate offering,No,Town: Distant,Doctoral Universities: Very High Research Activity,"Research Doctoral: Comprehensive programs, with medical/veterinary school",High undergraduate,"Four-year, large, primarily residential",6570,3096,3474,1060,639,421,6570,4324,1912,334,925,450,475,170,100,70,292,145,147,121,77,44,WA05
236948,University of Washington-Seattle Campus,"UW-Seattle, UDub, UW, Washington",1400 NE Campus Parkway,Seattle,WA,98195-4550,-122.30514,47.65538,Public,Graduate degree or certificate offering,No,City: Large,Doctoral Universities: Very High Research Activity,"Research Doctoral: Comprehensive programs, with medical/veterinary school",Majority undergraduate,"Four-year, large, primarily residential",17461,7717,9744,3360,1709,1651,17461,403,1688,15370,4293,1907,2386,1035,496,539,650,365,285,194,123,71,WA07
237011,Western Washington University,Western Washington State College|Western Washington College of Education,516 High Street,Bellingham,WA,98225-9008,-122.485734,48.737812,Public,Graduate degree or certificate offering,No,City: Small,Master's Colleges & Universities: Larger Programs,Postbaccalaureate: Comprehensive programs,Very high undergraduate,"Four-year, large, primarily residential",1216,452,764,14,5,9,1216,72,139,1005,272,99,173,10,4,6,0,0,0,0,0,0,WA02
237066,Whitworth University,Whitworth College,300 W Hawthorne Rd,Spokane,WA,99251,-117.416714,47.753358,Private not-for-profit,Graduate degree or certificate offering,No,Suburb: Large,Master's Colleges & Universities: Medium Programs,"Postbaccalaureate: Education-dominant, with other professional programs",Very high undergraduate,"Four-year, small, highly residential",489,151,338,11,3,8,489,18,255,216,181,56,125,0,0,0,0,0,0,0,0,0,WA05
237118,Alderson Broaddus University,Alderson-Broaddus College,101 College Hill Drive,Philippi,WV,26416-2035,-80.047728,39.158067,Private not-for-profit,Graduate degree or certificate offering,No,Town: Distant,Baccalaureate Colleges: Diverse Fields,"Postbaccalaureate: Other-dominant, with Arts & Sciences",High undergraduate,"Four-year, very small, highly residential",170,66,104,28,22,6,170,37,0,133,40,15,25,0,0,0,0,0,0,0,0,0,WV02
237136,Appalachian Bible College, ,161 College Drive,Mount Hope,WV,25880-9557,-81.198867,37.853335,Private not-for-profit,Graduate degree or certificate offering,No,Rural: Fringe,Special Focus Four-Year: Faith-Related Institutions,Postbaccalaureate: Single program-Other,Very high undergraduate,"Four-year, very small, highly residential",21,13,8,2,1,1,21,5,2,14,3,2,1,2,1,1,0,0,0,0,0,0,WV01
237181,Bethany College, ,31 E Campus Dr,Bethany,WV,26032,-80.560056,40.205819,Private not-for-profit,Graduate degree or certificate offering,No,Rural: Fringe,Baccalaureate Colleges: Arts & Sciences Focus,Postbaccalaureate: Single program-Education,Very high undergraduate,"Four-year, very small, highly residential",9,6,3,1,1,0,9,0,0,9,4,2,2,1,1,0,0,0,0,0,0,0,WV02
237312,University of Charleston, ,"2300 MacCorkle Avenue,  SE",Charleston,WV,25304,-81.616244,38.333367,Private not-for-profit,Graduate degree or certificate offering,No,City: Small,Doctoral/Professional Universities,"Postbaccalaureate: Business-dominant, with other professional programs",Majority undergraduate,"Four-year, small, primarily residential",1064,652,412,34,23,11,1064,738,114,212,197,127,70,7,2,5,0,0,0,0,0,0,WV01
237330,Concord University, ,1000 Vermillion Street,Athens,WV,24712,-81.006696,37.423723,Public,Graduate degree or certificate offering,No,Town: Distant,Master's Colleges & Universities: Medium Programs,"Postbaccalaureate: Other-dominant, with other professional programs",High undergraduate,"Four-year, small, highly residential",549,102,447,0,0,0,549,471,8,70,104,18,86,0,0,0,0,0,0,0,0,0,WV01
237367,Fairmont State University,Fairmont State   Fairmont State College,1201 Locust Ave,Fairmont,WV,26554-2470,-80.162433,39.483079,Public,Graduate degree or certificate offering,No,Town: Distant,Master's Colleges & Universities: Small Programs,"Postbaccalaureate: Education-dominant, with other professional programs",Very high undergraduate,"Four-year, medium, primarily residential",347,100,247,3,1,2,347,293,46,8,80,26,54,1,1,0,0,0,0,0,0,0,WV02
237525,Marshall University, ,1 John Marshall Dr,Huntington,WV,25755,-82.428964,38.422482,Public,Graduate degree or certificate offering,No,City: Small,Doctoral Universities: High Research Activity,Research Doctoral: Professional-dominant,High undergraduate,"Four-year, medium, primarily residential",4224,1430,2794,173,98,75,4224,1860,1400,964,763,294,469,98,65,33,22,8,14,1,0,1,WV01
237783,Salem University, ,223 W Main St,Salem,WV,26426,-80.571767,39.288632,Private for-profit,Graduate degree or certificate offering,No,Rural: Distant,Master's Colleges & Universities: Medium Programs,"Postbaccalaureate: Business-dominant, with other professional programs",High undergraduate,"Four-year, very small, primarily residential",342,145,197,16,11,5,342,322,20,0,107,51,56,9,7,2,0,0,0,0,0,0,WV02
237792,Shepherd University, ,301 North King St,Shepherdstown,WV,25443,-77.804101,39.433071,Public,Graduate degree or certificate offering,No,Town: Fringe,Master's Colleges & Universities: Small Programs,"Postbaccalaureate: Business-dominant, with Arts & Sciences",Very high undergraduate,"Four-year, small, primarily residential",2394,412,1982,9,5,4,2394,2129,188,77,50,26,24,3,2,1,0,0,0,0,0,0,WV02
237880,West Virginia School of Osteopathic Medicine,WVSOM,400 Lee Street North,Lewisburg,WV,24901,-80.43782,37.804273,Public,Graduate degree or certificate offering,No,Town: Distant,Special Focus Four-Year: Medical Schools & Centers,Postbaccalaureate: Single program-Other,Exclusively graduate,Exclusively graduate/professional,800,396,404,0,0,0,800,0,0,800,0,0,0,0,0,0,0,0,0,0,0,0,WV01
237899,West Virginia State University,WVSU  STATE,Rte 25,Institute,WV,25112-1000,-81.765034,38.380541,Public,Graduate degree or certificate offering,Yes,Suburb: Midsize,Master's Colleges & Universities: Small Programs,"Postbaccalaureate: Education-dominant, with Arts & Sciences",Very high undergraduate,"Four-year, small, primarily nonresidential",645,180,465,13,7,6,645,30,64,551,54,24,30,6,3,3,0,0,0,0,0,0,WV01
237905,West Virginia University Hospital Departments of Rad Tech and Nutrition,WVU Medicine Imaging Science Education Programs,Medical Ctr Dr,Morgantown,WV,26506-8062,-79.957959,39.654269,Private not-for-profit,Graduate degree or certificate offering,No,City: Small,nan,nan,nan,nan,7,1,6,0,0,0,7,0,0,7,0,0,0,0,0,0,0,0,0,0,0,0,WV02
237932,West Liberty University, ,208 University Drive,West Liberty,WV,26074,-80.602256,40.164417,Public,Graduate degree or certificate offering,No,Rural: Fringe,Master's Colleges & Universities: Medium Programs,"Postbaccalaureate: Business-dominant, with Arts & Sciences",High undergraduate,"Four-year, small, highly residential",535,194,341,9,6,3,535,183,352,0,129,48,81,0,0,0,0,0,0,0,0,0,WV02
237969,West Virginia Wesleyan College, ,59 College Ave,Buckhannon,WV,26201-2994,-80.218969,38.990661,Private not-for-profit,Graduate degree or certificate offering,No,Town: Remote,Baccalaureate Colleges: Diverse Fields,"Postbaccalaureate: Business-dominant, with Arts & Sciences",Very high undergraduate,"Four-year, small, highly residential",96,22,74,3,3,0,96,89,7,0,39,18,21,4,3,1,0,0,0,0,0,0,WV02
238032,West Virginia University, ,PO Box 6201,Morgantown,WV,26506,-79.954391,39.634371,Public,Graduate degree or certificate offering,No,City: Small,Doctoral Universities: Very High Research Activity,"Research Doctoral: Comprehensive programs, with medical/veterinary school",High undergraduate,"Four-year, large, primarily residential",6915,3076,3839,786,440,346,6915,3075,2587,1253,1480,658,822,136,70,66,185,111,74,74,50,24,WV02
238078,Wheeling University, ,316 Washington Ave,Wheeling,WV,26003,-80.690804,40.070873,Private not-for-profit,Graduate degree or certificate offering,No,City: Small,Master's Colleges & Universities: Medium Programs,"Postbaccalaureate: Other-dominant, with other professional programs",Majority undergraduate,"Four-year, very small, highly residential",279,111,168,0,0,0,279,120,159,0,58,13,45,0,0,0,0,0,0,0,0,0,WV02
238193,Alverno College, ,3400 S 43rd  St,Milwaukee,WI,53234-3922,-87.965174,42.982842,Private not-for-profit,Graduate degree or certificate offering,No,City: Large,Master's Colleges & Universities: Larger Programs,"Postbaccalaureate: Education-dominant, with Arts & Sciences",Majority undergraduate,"Four-year, small, primarily nonresidential",918,114,804,8,3,5,918,185,407,326,222,30,192,2,1,1,0,0,0,0,0,0,WI04
238263,Madison Area Technical College,Madison College,1701 Wright Street,Madison,WI,53704-2599,-89.327921,43.12183,Public,Graduate degree or certificate offering,No,City: Large,Associate's Colleges: High Career & Technical-Mixed Traditional/Nontraditional,Not classified (Exclusively Undergraduate),Exclusively undergraduate two-year,"Two-year, large",62,18,44,2,0,2,62,47,14,1,0,0,0,0,0,0,0,0,0,0,0,0,WI02
238324,Bellin College, ,3201 Eaton Road,Green Bay,WI,54311,-87.921722,44.468277,Private not-for-profit,Graduate degree or certificate offering,No,Rural: Fringe,Special Focus Four-Year: Other Health Professions Schools,Postbaccalaureate: Single program-Other,High undergraduate,"Four-year, very small, primarily nonresidential",203,85,118,0,0,0,203,43,68,92,21,2,19,0,0,0,0,0,0,0,0,0,WI08
238430,Cardinal Stritch University,Stritch,6801 N Yates Rd,Milwaukee,WI,53217-3985,-87.909045,43.139752,Private not-for-profit,Graduate degree or certificate offering,No,Suburb: Large,Doctoral/Professional Universities,Research Doctoral: Single program-Education,Majority undergraduate,"Four-year, very small, primarily residential",801,238,563,36,13,23,801,435,214,152,220,64,156,13,6,7,25,8,17,3,2,1,WI04
238458,Carroll University, ,100 N East Ave,Waukesha,WI,53186,-88.228114,43.004527,Private not-for-profit,Graduate degree or certificate offering,No,City: Small,Master's Colleges & Universities: Larger Programs,"Postbaccalaureate: Other-dominant, with Arts & Sciences",High undergraduate,"Four-year, medium, highly residential",656,201,455,3,3,0,656,67,217,372,190,52,138,0,0,0,0,0,0,0,0,0,WI05
238476,Carthage College,Carthage,2001 Alford Park Dr,Kenosha,WI,53140-1994,-87.820924,42.622969,Private not-for-profit,Graduate degree or certificate offering,No,Suburb: Midsize,Master's Colleges & Universities: Small Programs,"Postbaccalaureate: Education-dominant, with other professional programs",Very high undergraduate,"Four-year, small, highly residential",151,66,85,12,5,7,151,12,106,33,68,32,36,7,2,5,0,0,0,0,0,0,WI01
238616,Concordia University-Wisconsin,CUW,12800 N Lake Shore Dr,Mequon,WI,53097-2402,-87.91552,43.253387,Private not-for-profit,Graduate degree or certificate offering,No,Suburb: Large,Doctoral/Professional Universities,Research Doctoral: Single program-Other,Majority undergraduate,"Four-year, medium, highly residential",3095,829,2266,335,158,177,3095,1481,1300,314,588,178,410,145,66,79,33,13,20,0,0,0,WI06
238661,Edgewood College, ,1000 Edgewood College Drive,Madison,WI,53711-1997,-89.422884,43.057059,Private not-for-profit,Graduate degree or certificate offering,No,City: Large,Doctoral/Professional Universities,Research Doctoral: Single program-Education,High undergraduate,"Four-year, small, primarily residential",835,240,595,21,8,13,835,103,359,373,128,40,88,5,1,4,26,11,15,5,3,2,WI02
238980,Lakeland University, ,W3718 South Drive,Plymouth,WI,53073,-87.883414,43.841573,Private not-for-profit,Graduate degree or certificate offering,No,Rural: Fringe,Master's Colleges & Universities: Larger Programs,"Postbaccalaureate: Business-dominant, with other professional programs",High undergraduate,"Four-year, small, primarily nonresidential",873,256,617,4,2,2,873,83,550,240,202,63,139,3,1,2,0,0,0,0,0,0,WI06
239071,Maranatha Baptist University,"MBBC, Maranatha College, Maranatha, Maranatha Baptist College, Maranatha Bible College, Maranatha Baptist Bible College, Marantha, Maranatha University, Maranatha Baptist University, MBU, Maranatha Bible University",745 West Main Street,Watertown,WI,53094,-88.737016,43.195013,Private not-for-profit,Graduate degree or certificate offering,No,Town: Fringe,Master's Colleges & Universities: Small Programs,"Postbaccalaureate: Education-dominant, with other professional programs",High undergraduate,"Four-year, very small, highly residential",401,230,171,8,6,2,401,246,98,57,66,30,36,0,0,0,0,0,0,0,0,0,WI05
239080,Marian University,Marian University of Fond du Lac,45 S National Ave,Fond Du Lac,WI,54935-4699,-88.420638,43.777411,Private not-for-profit,Graduate degree or certificate offering,No,City: Small,Master's Colleges & Universities: Medium Programs,Research Doctoral: Single program-Education,High undergraduate,"Four-year, small, primarily residential",510,115,395,0,0,0,510,385,56,69,88,12,76,0,0,0,0,0,0,0,0,0,WI06
239105,Marquette University, ,1250 W Wisconsin Avenue,Milwaukee,WI,53233,-87.927961,43.03903,Private not-for-profit,Graduate degree or certificate offering,No,City: Large,Doctoral Universities: High Research Activity,"Research Doctoral: Comprehensive programs, with medical/veterinary school",Majority undergraduate,"Four-year, large, highly residential",3912,1547,2365,252,161,91,3912,315,2848,749,764,256,508,34,17,17,60,39,21,17,15,2,WI04
239169,Medical College of Wisconsin, ,8701 Watertown Plank Road,Milwaukee,WI,53226-0509,-88.022674,43.044527,Private not-for-profit,Graduate degree or certificate offering,No,Suburb: Large,Special Focus Four-Year: Research Institutions,Research Doctoral: STEM-dominant,Exclusively graduate,Exclusively graduate/professional,1522,670,852,122,62,60,1522,77,362,1083,50,15,35,3,2,1,41,16,25,10,4,6,WI04
239318,Milwaukee School of Engineering,MSOE,1025 N Broadway,Milwaukee,WI,53202-3109,-87.907691,43.045364,Private not-for-profit,Graduate degree or certificate offering,No,City: Large,Master's Colleges & Universities: Medium Programs,"Postbaccalaureate: Business-dominant, with Arts & Sciences",Very high undergraduate,"Four-year, small, highly residential",202,107,95,10,10,0,202,10,65,127,104,65,39,11,11,0,0,0,0,0,0,0,WI04
239390,Mount Mary University,Mount Mary College  MMU  MMC  Women  Wisconsin,2900 N. Menomonee River Pky,Milwaukee,WI,53222-4597,-88.030732,43.072507,Private not-for-profit,Graduate degree or certificate offering,No,City: Large,Master's Colleges & Universities: Larger Programs,"Postbaccalaureate: Other-dominant, with Arts & Sciences",Majority undergraduate,"Four-year, small, primarily residential",671,67,604,5,0,5,671,163,268,240,177,13,164,0,0,0,0,0,0,0,0,0,WI04
239424,Nashotah House, ,2777 Mission Rd,Nashotah,WI,53058-9793,-88.423743,43.082193,Private not-for-profit,Graduate degree or certificate offering,No,Suburb: Large,Special Focus Four-Year: Faith-Related Institutions,Postbaccalaureate: Single program-Other,Exclusively graduate,Exclusively graduate/professional,152,125,27,0,0,0,152,5,48,99,13,9,4,0,0,0,0,0,0,0,0,0,WI05
239637,Sacred Heart Seminary and School of Theology,SHSST,7335 S Hwy 100,Franklin,WI,53132,-88.04438,42.910829,Private not-for-profit,Graduate degree or certificate offering,No,Suburb: Large,Special Focus Four-Year: Faith-Related Institutions,Postbaccalaureate: Single program-Other,Exclusively graduate,Exclusively graduate/professional,107,93,14,22,22,0,107,11,96,0,15,11,4,6,6,0,0,0,0,0,0,0,WI01
239716,Saint Norbert College,SNC,100 Grant St,De Pere,WI,54115-2099,-88.067812,44.44483,Private not-for-profit,Graduate degree or certificate offering,No,Suburb: Midsize,Baccalaureate Colleges: Arts & Sciences Focus,"Postbaccalaureate: Business-dominant, with Arts & Sciences",Very high undergraduate,"Four-year, small, highly residential",99,39,60,0,0,0,99,5,55,39,22,6,16,0,0,0,0,0,0,0,0,0,WI08
240107,Viterbo University,Viterbo,900 Viterbo Drive,La Crosse,WI,54601-8804,-91.244297,43.803133,Private not-for-profit,Graduate degree or certificate offering,No,City: Small,Master's Colleges & Universities: Larger Programs,"Postbaccalaureate: Education-dominant, with other professional programs",Majority undergraduate,"Four-year, small, highly residential",1097,290,807,20,18,2,1097,295,568,234,247,72,175,13,13,0,0,0,0,0,0,0,WI03
240189,University of Wisconsin-Whitewater, ,800 W Main St,Whitewater,WI,53190-1790,-88.742368,42.835563,Public,Graduate degree or certificate offering,No,Town: Distant,Master's Colleges & Universities: Larger Programs,Postbaccalaureate: Comprehensive programs,Very high undergraduate,"Four-year, large, primarily residential",2141,948,1193,33,22,11,2141,1485,416,240,492,213,279,16,11,5,0,0,0,0,0,0,WI01
240213,Wisconsin School of Professional Psychology,WSPP,9120 W Hampton Ave,Milwaukee,WI,53225-4960,-88.026735,43.10534,Private not-for-profit,Graduate degree or certificate offering,No,City: Large,Special Focus Four-Year: Other Health Professions Schools,Postbaccalaureate: Single program-Other,Exclusively graduate,Exclusively graduate/professional,91,19,72,0,0,0,91,0,0,91,16,2,14,0,0,0,0,0,0,0,0,0,WI04
240268,University of Wisconsin-Eau Claire, ,105 Garfield Ave,Eau Claire,WI,54701,-91.501906,44.798284,Public,Graduate degree or certificate offering,No,City: Small,Master's Colleges & Universities: Medium Programs,"Postbaccalaureate: Business-dominant, with Arts & Sciences",Very high undergraduate,"Four-year, medium, primarily residential",850,396,454,32,21,11,850,674,122,54,186,82,104,5,2,3,0,0,0,0,0,0,WI03
240277,University of Wisconsin-Green Bay, ,2420 Nicolet Dr,Green Bay,WI,54311-7001,-87.919973,44.532298,Public,Graduate degree or certificate offering,No,City: Midsize,Master's Colleges & Universities: Medium Programs,"Postbaccalaureate: Other-dominant, with Arts & Sciences",Very high undergraduate,"Four-year, medium, primarily residential",553,210,343,8,6,2,553,322,170,61,158,43,115,3,2,1,0,0,0,0,0,0,WI08
240329,University of Wisconsin-La Crosse, ,1725 State St,La Crosse,WI,54601-9959,-91.23186,43.81568,Public,Graduate degree or certificate offering,No,City: Small,Doctoral/Professional Universities,"Postbaccalaureate: Other-dominant, with Arts & Sciences",Very high undergraduate,"Four-year, medium, primarily residential",1198,439,759,43,29,14,1198,715,430,53,392,151,241,20,17,3,0,0,0,0,0,0,WI03
240338,Wisconsin Lutheran College,"WLC, Wisconsin Lutheran",8800 W Bluemound Rd,Milwaukee,WI,53226-4699,-88.022718,43.036943,Private not-for-profit,Graduate degree or certificate offering,No,City: Large,Baccalaureate Colleges: Diverse Fields,Postbaccalaureate: Single program-Education,Very high undergraduate,"Four-year, small, highly residential",174,51,123,2,0,2,174,77,68,29,45,12,33,1,0,1,0,0,0,0,0,0,WI04
240365,University of Wisconsin-Oshkosh, ,800 Algoma Blvd,Oshkosh,WI,54901,-88.549369,44.026206,Public,Graduate degree or certificate offering,No,City: Small,Doctoral/Professional Universities,Postbaccalaureate: Comprehensive programs,Very high undergraduate,"Four-year, medium, primarily residential",1532,500,1032,13,6,7,1532,638,692,202,300,107,193,2,1,1,0,0,0,0,0,0,WI06
240374,University of Wisconsin-Parkside, ,900 Wood Rd,Kenosha,WI,53144,-87.855231,42.647718,Public,Graduate degree or certificate offering,No,Suburb: Midsize,Master's Colleges & Universities: Medium Programs,"Postbaccalaureate: Business-dominant, with Arts & Sciences",Very high undergraduate,"Four-year, medium, primarily nonresidential",872,439,433,49,26,23,872,738,132,2,153,77,76,21,13,8,0,0,0,0,0,0,WI01
240392,Herzing University-Madison, ,5218 E. Terrace Dr.,Madison,WI,53718,-89.291561,43.14415,Private not-for-profit,Graduate degree or certificate offering,No,City: Large,Master's Colleges & Universities: Larger Programs,"Postbaccalaureate: Other-dominant, with other professional programs",Majority undergraduate,"Four-year, small, primarily nonresidential",1615,234,1381,0,0,0,1615,1615,0,0,262,45,217,0,0,0,0,0,0,0,0,0,WI02
240417,University of Wisconsin-Stout, ,712 S Broadway St,Menomonie,WI,54751,-91.926653,44.873187,Public,Graduate degree or certificate offering,No,Town: Distant,Master's Colleges & Universities: Larger Programs,"Postbaccalaureate: Education-dominant, with Arts & Sciences",Very high undergraduate,"Four-year, medium, primarily residential",1492,494,998,32,19,13,1492,1091,283,118,316,124,192,14,6,8,0,0,0,0,0,0,WI03
240426,University of Wisconsin-Superior, ,1605 Catlin Ave,Superior,WI,54880-4500,-92.091007,46.717629,Public,Graduate degree or certificate offering,No,Suburb: Midsize,Master's Colleges & Universities: Medium Programs,"Postbaccalaureate: Education-dominant, with Arts & Sciences",Very high undergraduate,"Four-year, small, primarily residential",538,158,380,1,1,0,538,473,38,27,184,51,133,0,0,0,0,0,0,0,0,0,WI07
240444,University of Wisconsin-Madison, ,500 Lincoln Dr,Madison,WI,53706-1380,-89.404098,43.075409,Public,Graduate degree or certificate offering,No,City: Large,Doctoral Universities: Very High Research Activity,"Research Doctoral: Comprehensive programs, with medical/veterinary school",Majority undergraduate,"Four-year, large, primarily residential",13075,6246,6829,3179,1820,1359,13075,3246,8347,1482,2562,1221,1341,785,453,332,696,405,291,232,142,90,WI02
240453,University of Wisconsin-Milwaukee,UWM,2200 E Kenwood Blvd,Milwaukee,WI,53211,-87.880488,43.076848,Public,Graduate degree or certificate offering,No,City: Large,Doctoral Universities: Very High Research Activity,"Research Doctoral: Comprehensive programs, no medical/veterinary school",High undergraduate,"Four-year, large, primarily nonresidential",5319,2029,3290,679,379,300,5319,2237,2403,679,1301,482,819,120,65,55,171,79,92,60,39,21,WI04
240462,University of Wisconsin-Platteville, ,1 University Plaza,Platteville,WI,53818-3099,-90.48622,42.733451,Public,Graduate degree or certificate offering,No,Town: Distant,Master's Colleges & Universities: Larger Programs,"Postbaccalaureate: Business-dominant, with Arts & Sciences",Very high undergraduate,"Four-year, medium, primarily residential",855,478,377,31,15,16,855,798,22,35,252,137,115,17,6,11,0,0,0,0,0,0,WI03
240471,University of Wisconsin-River Falls, ,410 S 3rd St,River Falls,WI,54022-5001,-92.622641,44.8534,Public,Graduate degree or certificate offering,No,Town: Distant,Master's Colleges & Universities: Medium Programs,"Postbaccalaureate: Education-dominant, with Arts & Sciences",Very high undergraduate,"Four-year, medium, primarily residential",530,159,371,13,5,8,530,385,131,14,169,48,121,7,2,5,0,0,0,0,0,0,WI03
240480,University of Wisconsin-Stevens Point,UW-Stevens Point,2100 Main St,Stevens Point,WI,54481-3897,-89.570934,44.529582,Public,Graduate degree or certificate offering,No,Town: Distant,Master's Colleges & Universities: Medium Programs,"Postbaccalaureate: Other-dominant, with Arts & Sciences",Very high undergraduate,"Four-year, medium, primarily residential",777,208,569,5,1,4,777,421,338,18,177,37,140,1,0,1,0,0,0,0,0,0,WI03
240727,University of Wyoming,UW,Corner of Ninth and Ivinson,Laramie,WY,82071,-105.57931,41.311773,Public,Graduate degree or certificate offering,No,Town: Remote,Doctoral Universities: High Research Activity,Research Doctoral: STEM-dominant,High undergraduate,"Four-year, large, primarily residential",2880,1272,1608,346,213,133,2880,1213,1172,495,440,187,253,45,25,20,93,62,31,33,24,9,WY00
240754,University of Guam,UOG,"303 University Drive, UOG Station",Mangilao,GU,96923,144.803978,13.433047,Public,Graduate degree or certificate offering,No,Town: Remote,Master's Colleges & Universities: Medium Programs,"Postbaccalaureate: Education-dominant, with Arts & Sciences",Very high undergraduate,"Four-year, small, primarily nonresidential",412,134,278,5,2,3,412,23,63,326,135,42,93,1,0,1,0,0,0,0,0,0,GU98
241100,American University of Puerto Rico, ,"Carr. #2, Km.14.4, Bo. Hato Tejas",Bayamon,PR,00960-2037,-66.186631,18.407058,Private not-for-profit,Graduate degree or certificate offering,No,City: Midsize,Baccalaureate Colleges: Diverse Fields,Postbaccalaureate: Single program-Education,Very high undergraduate,"Four-year, very small, primarily nonresidential",26,13,13,0,0,0,26,26,0,0,2,1,1,0,0,0,0,0,0,0,0,0,PR98
241128,American University of Puerto Rico, ,Carretera Estatal #2 Km.48.1,Manati,PR,00674-1082,-66.478655,18.434072,Private not-for-profit,Graduate degree or certificate offering,No,Suburb: Large,Baccalaureate Colleges: Diverse Fields,Postbaccalaureate: Single program-Education,Very high undergraduate,"Four-year, very small, primarily nonresidential",12,3,9,0,0,0,12,12,0,0,9,2,7,0,0,0,0,0,0,0,0,0,PR98
241191,Universidad Adventista de las Antillas, ,Carr 106 Km 2.2 Int,Mayaguez,PR,00680-0000,-67.111207,18.205685,Private not-for-profit,Graduate degree or certificate offering,No,Suburb: Midsize,Master's Colleges & Universities: Small Programs,"Postbaccalaureate: Other-dominant, with other professional programs",Very high undergraduate,"Four-year, very small, primarily residential",124,59,65,0,0,0,124,17,29,78,22,12,10,0,0,0,0,0,0,0,0,0,PR98
241216,Atlantic University College, ,Colton St. # 9,Guaynabo,PR,00970,-66.111714,18.357395,Private not-for-profit,Graduate degree or certificate offering,No,City: Small,Master's Colleges & Universities: Small Programs,"Postbaccalaureate: Other-dominant, with Arts & Sciences",Very high undergraduate,"Four-year, small, primarily nonresidential",132,75,57,0,0,0,132,0,0,132,59,32,27,0,0,0,0,0,0,0,0,0,PR98
241225,Universidad Central de Bayamon,UCB,Avenida Zaya Verde La Milagrosa Barrio Hato Tejas,Bayamón,PR,00960-1725,-66.180773,18.398864,Private not-for-profit,Graduate degree or certificate offering,No,City: Midsize,Master's Colleges & Universities: Small Programs,"Postbaccalaureate: Other-dominant, with Arts & Sciences",High undergraduate,"Four-year, very small, primarily nonresidential",253,66,187,4,3,1,253,0,253,0,46,15,31,1,1,0,0,0,0,0,0,0,PR98
241304,Columbia Central University-Caguas, ,Carr 183 Km 1.7,Caguas,PR,00726,-66.022543,18.22329,Private for-profit,Graduate degree or certificate offering,No,City: Small,Special Focus Four-Year: Other Health Professions Schools,"Postbaccalaureate: Other-dominant, with other professional programs",High undergraduate,"Four-year, very small, primarily nonresidential",262,45,217,0,0,0,262,233,13,16,80,10,70,0,0,0,0,0,0,0,0,0,PR98
241331,Albizu University-San Juan,Albizu University-San Juan,"151 Tanca St, Corner San Francisco St, Old San Juan",San Juan,PR,00902-3711,-66.113908,18.466573,Private not-for-profit,Graduate degree or certificate offering,No,City: Large,Special Focus Four-Year: Other Health Professions Schools,Research Doctoral: Single program-Other,Majority graduate,"Four-year, small, primarily nonresidential",1947,325,1622,1,1,0,1947,0,947,1000,295,38,257,1,1,0,62,11,51,0,0,0,PR98
241377,Caribbean University-Bayamon, ,167 Ave.  Km 21.2,Bayamon,PR,00960-0493,-66.168315,18.383136,Private not-for-profit,Graduate degree or certificate offering,No,City: Midsize,Master's Colleges & Universities: Small Programs,Research Doctoral: Single program-Other,Majority undergraduate,"Four-year, very small, primarily nonresidential",375,156,219,0,0,0,375,337,38,0,63,13,50,0,0,0,1,0,1,0,0,0,PR98
241386,Caribbean University-Carolina, ,Calle Ignacio Arzuaga #208,Carolina,PR,00985,-65.960036,18.380193,Private not-for-profit,Graduate degree or certificate offering,No,Suburb: Large,Baccalaureate Colleges: Diverse Fields,"Postbaccalaureate: Business-dominant, with other professional programs",Very high undergraduate,"Four-year, very small, primarily nonresidential",51,5,46,0,0,0,51,39,12,0,6,1,5,0,0,0,0,0,0,0,0,0,PR98
241395,Pontifical Catholic University of Puerto Rico-Arecibo, ,Carretera 662 KM 2.3,Arecibo,PR,00614-4045,-66.679114,18.446006,Private not-for-profit,Graduate degree or certificate offering,No,Suburb: Small,Doctoral/Professional Universities,Research Doctoral: Single program-Other,Majority undergraduate,"Four-year, very small, primarily nonresidential",415,98,317,0,0,0,415,2,28,385,38,5,33,0,0,0,11,4,7,0,0,0,PR98
241410,Pontifical Catholic University of Puerto Rico-Ponce,PUCPR,2250 Boulevard Luis A. Ferre Aguayo Suite 608,Ponce,PR,00717-9997,-66.617138,18.00165,Private not-for-profit,Graduate degree or certificate offering,No,City: Midsize,Doctoral/Professional Universities,Research Doctoral: Professional-dominant,High undergraduate,"Four-year, medium, primarily nonresidential",1909,595,1314,3,1,2,1909,22,142,1745,179,53,126,1,1,0,41,16,25,0,0,0,PR98
241614,Universidad Teologica del Caribe,UTC,"Road 848 Km. 0.5 Callejon Marquez, Bo. Saint Just",Trujillo Alto,PR,00978-0901,-66.010617,18.373928,Private not-for-profit,Graduate degree or certificate offering,No,Suburb: Large,Special Focus Four-Year: Faith-Related Institutions,Postbaccalaureate: Single program-Other,High undergraduate,"Four-year, very small, primarily nonresidential",134,61,73,0,0,0,134,23,46,65,13,6,7,0,0,0,0,0,0,0,0,0,PR98
241739,Universidad Ana G. Mendez-Cupey Campus,UAGM Cupey,1399 Ave. Ana G. Mendez,San Juan,PR,00926-2602,-66.061647,18.387183,Private not-for-profit,Graduate degree or certificate offering,No,City: Large,Master's Colleges & Universities: Larger Programs,Research Doctoral: Single program-Education,High undergraduate,"Four-year, medium, primarily nonresidential",2210,736,1474,0,0,0,2210,0,1948,262,540,162,378,0,0,0,12,5,7,0,0,0,PR98
241766,Conservatory of Music of Puerto Rico, ,951 Ponce de Leon Avenue,San Juan,PR,00907-3373,-66.078811,18.454016,Public,Graduate degree or certificate offering,No,City: Large,"Special Focus Four-Year: Arts, Music & Design Schools","Postbaccalaureate: Education-dominant, with Arts & Sciences",Very high undergraduate,"Four-year, very small, primarily nonresidential",16,12,4,3,3,0,16,0,0,16,4,2,2,0,0,0,0,0,0,0,0,0,PR98
241793,Center for Advanced Studies On Puerto Rico and the Caribbean,Centro de Estudios Avanzados,Calle Del Cristo #52,San Juan,PR,00901,-66.11841,18.466567,Private not-for-profit,Graduate degree or certificate offering,No,City: Large,Master's Colleges & Universities: Small Programs,Postbaccalaureate: Arts & sciences-dominant,Exclusively graduate,Exclusively graduate/professional,451,220,231,0,0,0,451,0,0,451,35,19,16,0,0,0,0,0,0,0,0,0,PR98
241836,EDP University of Puerto Rico Inc-San Sebastian,EDP,Betances # 49,San Sebastian,PR,00685,-66.992287,18.338036,Private not-for-profit,Graduate degree or certificate offering,No,Suburb: Large,Special Focus Four-Year: Other Health Professions Schools,Postbaccalaureate: Single program-Other,Very high undergraduate,"Four-year, very small, primarily nonresidential",75,20,55,0,0,0,75,0,0,75,19,4,15,0,0,0,0,0,0,0,0,0,PR98
242617,Inter American University of Puerto Rico-San German, ,Rd. 102 Km. 30.6,San German,PR,00683,-67.05082,18.08353,Private not-for-profit,Graduate degree or certificate offering,No,City: Small,Master's Colleges & Universities: Small Programs,Research Doctoral: Professional-dominant,High undergraduate,"Four-year, medium, primarily nonresidential",666,214,452,0,0,0,666,35,129,502,64,24,40,0,0,0,21,5,16,0,0,0,PR98
242626,Inter American University of Puerto Rico-Aguadilla, ,"Carr. 459 Int. 463, Barrio Corrales Sector Calero",Aguadilla,PR,00603,-67.121671,18.467886,Private not-for-profit,Graduate degree or certificate offering,No,Suburb: Large,Master's Colleges & Universities: Small Programs,"Postbaccalaureate: Business-dominant, with Arts & Sciences",Very high undergraduate,"Four-year, medium, primarily nonresidential",232,82,150,0,0,0,232,19,113,100,63,19,44,0,0,0,0,0,0,0,0,0,PR98
242635,Inter American University of Puerto Rico-Arecibo, ,"Hwy 2 Km 80.4, Bo San Daniel Sector Las Canelas",Arecibo,PR,00614,-66.75901,18.47509,Private not-for-profit,Graduate degree or certificate offering,No,City: Small,Master's Colleges & Universities: Medium Programs,"Postbaccalaureate: Education-dominant, with Arts & Sciences",High undergraduate,"Four-year, small, primarily nonresidential",388,105,283,0,0,0,388,97,168,123,90,24,66,0,0,0,0,0,0,0,0,0,PR98
242644,Inter American University of Puerto Rico-Barranquitas, ,Bo Helechal Highway 156 Intersection 719,Barranquitas,PR,00794,-66.303153,18.182777,Private not-for-profit,Graduate degree or certificate offering,No,Suburb: Large,Baccalaureate Colleges: Diverse Fields,"Postbaccalaureate: Other-dominant, with Arts & Sciences",Very high undergraduate,"Four-year, small, primarily nonresidential",145,43,102,0,0,0,145,61,56,28,25,6,19,0,0,0,0,0,0,0,0,0,PR98
242653,Inter American University of Puerto Rico-Metro, ,Highway #1 Km 16 3 Corner Francisco Sein St,San Juan,PR,00919,-66.077711,18.368988,Private not-for-profit,Graduate degree or certificate offering,No,City: Large,Master's Colleges & Universities: Larger Programs,Research Doctoral: Professional-dominant,Majority undergraduate,"Four-year, medium, primarily nonresidential",2509,779,1730,0,0,0,2509,124,725,1660,527,173,354,0,0,0,28,10,18,0,0,0,PR98
242662,Inter American University of Puerto Rico-Ponce,Inter Ponce,104 Turpeaux Industrial Park Rd1,Mercedita,PR,00715-1602,-66.578498,18.007388,Private not-for-profit,Graduate degree or certificate offering,No,Suburb: Midsize,Baccalaureate Colleges: Diverse Fields,"Postbaccalaureate: Business-dominant, with other professional programs",High undergraduate,"Four-year, medium, primarily nonresidential",579,180,399,0,0,0,579,380,54,145,89,27,62,0,0,0,12,4,8,0,0,0,PR98
242680,Inter American University of Puerto Rico-Fajardo, ,Calle Union-Batey Central Highway 195,Fajardo,PR,00738-7003,-65.648052,18.329222,Private not-for-profit,Graduate degree or certificate offering,No,Suburb: Small,Baccalaureate Colleges: Diverse Fields,"Postbaccalaureate: Education-dominant, with Arts & Sciences",Very high undergraduate,"Four-year, small, primarily nonresidential",121,42,79,0,0,0,121,12,84,25,18,5,13,0,0,0,0,0,0,0,0,0,PR98
242699,Inter American University of Puerto Rico-Guayama, ,Bo Machete Highway 744 Km 1.2,Guayama,PR,00784,-66.108164,17.96635,Private not-for-profit,Graduate degree or certificate offering,No,City: Small,Baccalaureate Colleges: Diverse Fields,"Postbaccalaureate: Other-dominant, with other professional programs",Very high undergraduate,"Four-year, small, primarily nonresidential",161,71,90,0,0,0,161,64,81,16,26,5,21,0,0,0,0,0,0,0,0,0,PR98
242705,Inter American University of Puerto Rico-Bayamon, ,500 Carr. Dr. John Will Harris,Bayamon,PR,00957-6257,-66.182473,18.351631,Private not-for-profit,Graduate degree or certificate offering,No,City: Midsize,Baccalaureate Colleges: Diverse Fields,"Postbaccalaureate: Other-dominant, with Arts & Sciences",Very high undergraduate,"Four-year, medium, primarily nonresidential",105,31,74,0,0,0,105,10,72,23,28,4,24,0,0,0,0,0,0,0,0,0,PR98
242723,Inter American University of Puerto Rico-School of Law, ,Calle Federico Costa 170 Urb Ind Tres Monjitas,San Juan,PR,00936-8351,-66.072656,18.428145,Private not-for-profit,Graduate degree or certificate offering,No,City: Large,Special Focus Four-Year: Law Schools,Postbaccalaureate: Single program-Other,Exclusively graduate,Exclusively graduate/professional,772,285,487,0,0,0,772,7,293,472,11,3,8,0,0,0,0,0,0,0,0,0,PR98
242972,NUC University, ,Carr. #2 Edificio National College Plaza,Bayamon,PR,00960,-66.157027,18.396872,Private for-profit,Graduate degree or certificate offering,No,City: Midsize,Master's Colleges & Universities: Larger Programs,"Postbaccalaureate: Business-dominant, with other professional programs",Very high undergraduate,"Four-year, large, primarily nonresidential",1798,435,1363,0,0,0,1798,1032,766,0,574,125,449,0,0,0,0,0,0,0,0,0,PR98
243081,Ponce Health Sciences University, ,388 Calle Luis F. Sala,Ponce,PR,00716-2347,-66.620307,17.993201,Private for-profit,Graduate degree or certificate offering,No,City: Midsize,Special Focus Four-Year: Medical Schools & Centers,Research Doctoral: STEM-dominant,Exclusively graduate,Exclusively graduate/professional,717,306,411,0,0,0,717,0,0,717,88,34,54,0,0,0,4,1,3,0,0,0,PR98
243197,University of Puerto Rico-Mayaguez,UPRM|RUM|Colegio|Colegio de Mayagüez|UPR-Mayaguez|CAAM|Recinto de Mayagüez|,259 Boulevard Alfonso Valdez,Mayaguez,PR,00681,-67.139172,18.211142,Public,Graduate degree or certificate offering,No,City: Small,Master's Colleges & Universities: Medium Programs,Research Doctoral: STEM-dominant,Very high undergraduate,"Four-year, large, primarily nonresidential",952,504,448,198,124,74,952,0,60,892,146,81,65,25,14,11,14,7,7,8,5,3,PR98
243203,University of Puerto Rico-Medical Sciences, ,"Rio Piedras Medical Center, Americo Miranda Avenue",San Juan,PR,00936-5067,-66.074894,18.396548,Public,Graduate degree or certificate offering,No,City: Large,Special Focus Four-Year: Medical Schools & Centers,Research Doctoral: Single program-Other,Majority graduate,"Four-year, small, primarily nonresidential",1881,663,1218,0,0,0,1881,0,1881,0,201,61,140,0,0,0,9,4,5,0,0,0,PR98
243221,University of Puerto Rico-Rio Piedras, ,39 Avenida Ponce de Leon,San Juan,PR,00931-0000,-66.050009,18.402826,Public,Graduate degree or certificate offering,No,City: Large,Doctoral Universities: High Research Activity,"Research Doctoral: Comprehensive programs, no medical/veterinary school",High undergraduate,"Four-year, large, primarily nonresidential",3327,1236,2091,0,0,0,3327,7,521,2799,286,86,200,0,0,0,79,35,44,0,0,0,PR98
243346,Universidad Ana G. Mendez-Carolina Campus,UAGM Carolina,Carr. # 190 Esq. Calle 220 Bo. Sabana Abajo,Carolina,PR,00985-0985,-65.983869,18.414805,Private not-for-profit,Graduate degree or certificate offering,No,Suburb: Large,Master's Colleges & Universities: Larger Programs,"Postbaccalaureate: Other-dominant, with other professional programs",High undergraduate,"Four-year, medium, primarily nonresidential",1533,349,1184,0,0,0,1533,0,1223,310,396,89,307,0,0,0,0,0,0,0,0,0,PR98
243443,Universidad del Sagrado Corazon,Sagrado,Calle Rosales Esq San Antonio Pda 26 1/2,Santurce,PR,00907,-66.059617,18.441166,Private not-for-profit,Graduate degree or certificate offering,No,City: Large,Master's Colleges & Universities: Medium Programs,"Postbaccalaureate: Other-dominant, with Arts & Sciences",Very high undergraduate,"Four-year, medium, primarily nonresidential",524,174,350,0,0,0,524,0,524,0,185,59,126,0,0,0,0,0,0,0,0,0,PR98
243498,Seminario Evangelico de Puerto Rico, ,776 Ponce de Leon Avenue,San Juan,PR,00925,-66.052816,18.407003,Private not-for-profit,Graduate degree or certificate offering,No,City: Large,Special Focus Four-Year: Faith-Related Institutions,"Postbaccalaureate: Other-dominant, with Arts & Sciences",Exclusively graduate,Exclusively graduate/professional,159,104,55,0,0,0,159,0,0,159,30,20,10,0,0,0,0,0,0,0,0,0,PR98
243568,Universidad Central Del Caribe,UCC,Ramon Ruiz Arnau University Hospital Laurel Ave,Bayamon,PR,00960-6032,-66.153758,18.366171,Private not-for-profit,Graduate degree or certificate offering,No,City: Midsize,Special Focus Four-Year: Medical Schools & Centers,Research Doctoral: Single program-Other,Majority graduate,"Four-year, very small, primarily nonresidential",424,186,238,0,0,0,424,0,424,0,10,2,8,0,0,0,3,1,2,0,0,0,PR98
243577,Universidad Politecnica de Puerto Rico, ,377 Ponce de Leon Ave,Hato Rey,PR,00919,-66.056084,18.422195,Private not-for-profit,Graduate degree or certificate offering,No,City: Large,Master's Colleges & Universities: Medium Programs,"Postbaccalaureate: Other-dominant, with Arts & Sciences",High undergraduate,"Four-year, small, primarily nonresidential",876,553,323,0,0,0,876,389,108,379,220,134,86,0,0,0,0,0,0,0,0,0,PR98
243586,Pontifical Catholic University of Puerto Rico-Mayaguez,PUCPR-Mayaguez,482 Sur Calle Ramon Emerito Betances,Mayaguez,PR,00680-1713,-67.145695,18.182375,Private not-for-profit,Graduate degree or certificate offering,No,City: Small,Baccalaureate Colleges: Diverse Fields,"Postbaccalaureate: Education-dominant, with Arts & Sciences",Very high undergraduate,"Four-year, very small, primarily nonresidential",111,29,82,1,1,0,111,3,17,91,24,5,19,0,0,0,0,0,0,0,0,0,PR98
243601,Universidad Ana G. Mendez-Gurabo Campus,UAGM Gurabo,Carr. # 189 Km 3.3,Gurabo,PR,00778-3030,-66.006259,18.239647,Private not-for-profit,Graduate degree or certificate offering,No,Suburb: Large,Doctoral/Professional Universities,Research Doctoral: Professional-dominant,High undergraduate,"Four-year, large, primarily nonresidential",3071,949,2122,0,0,0,3071,39,2447,585,872,276,596,0,0,0,32,10,22,0,0,0,PR98
243665,University of the Virgin Islands,UVI,2 John Brewers Bay,Charlotte Amalie,VI,00802-9990,-64.972866,18.344193,Public,Graduate degree or certificate offering,Yes,Town: Remote,Master's Colleges & Universities: Small Programs,Research Doctoral: Single program-Education,Very high undergraduate,"Four-year, small, primarily nonresidential",296,68,228,20,6,14,296,204,62,30,43,10,33,1,0,1,6,1,5,0,0,0,VI98
243744,Stanford University, , ,Stanford,CA,94305,-122.167359,37.429434,Private not-for-profit,Graduate degree or certificate offering,No,Suburb: Large,Doctoral Universities: Very High Research Activity,"Research Doctoral: Comprehensive programs, with medical/veterinary school",Majority graduate,"Four-year, large, highly residential",11414,6705,4709,3931,2505,1426,11414,0,1801,9613,2203,1214,989,734,414,320,817,516,301,287,204,83,CA16
243780,Purdue University-Main Campus,Purdue-West Lafayette|Purdue|PU|Purdue-WL,Hovde Hall of Administration,West Lafayette,IN,47907-2040,-86.914435,40.428206,Public,Graduate degree or certificate offering,No,City: Small,Doctoral Universities: Very High Research Activity,"Research Doctoral: Comprehensive programs, with medical/veterinary school",High undergraduate,"Four-year, large, primarily residential",12802,7203,5599,4461,2941,1520,12802,4139,5102,3561,2255,1229,1026,800,508,292,786,490,296,450,299,151,IN04
243823,Parker University, ,2540 Walnut Hill Lane,Dallas,TX,75229-5668,-96.893564,32.880335,Private not-for-profit,Graduate degree or certificate offering,No,City: Large,Master's Colleges & Universities: Larger Programs,"Postbaccalaureate: Other-dominant, with Arts & Sciences",Majority graduate,"Four-year, small, primarily nonresidential",1610,841,769,12,7,5,1610,175,932,503,86,42,44,0,0,0,0,0,0,0,0,0,TX33
243832,EDP University of Puerto Rico Inc-San Juan,EDP University of PR Inc.,560 Ponce de Leon Ave.  Cr. Arroyo St.,San Juan,PR,00919-2303,-66.055403,18.415375,Private not-for-profit,Graduate degree or certificate offering,No,City: Large,Baccalaureate/Associate's Colleges: Mixed Baccalaureate/Associate's,"Postbaccalaureate: Other-dominant, with Arts & Sciences",Very high undergraduate,"Four-year, very small, primarily nonresidential",161,73,88,0,0,0,161,33,53,75,29,8,21,0,0,0,0,0,0,0,0,0,PR98
245652,St. John's College, ,1160 Camino Cruz Blanca,Santa Fe,NM,87505-4599,-105.912478,35.666974,Private not-for-profit,Graduate degree or certificate offering,No,Rural: Fringe,Baccalaureate Colleges: Arts & Sciences Focus,"Postbaccalaureate: Other-dominant, with Arts & Sciences",High undergraduate,"Four-year, very small, highly residential",126,76,50,4,2,2,126,126,0,0,49,28,21,3,2,1,0,0,0,0,0,0,NM03
245777,Bais Medrash Elyon, ,73 Main Street,Monsey,NY,10952,-74.069798,41.114079,Private not-for-profit,No graduate offering,No,Suburb: Large,Special Focus Four-Year: Faith-Related Institutions,Not classified (Exclusively Undergraduate),Majority graduate,"Four-year, very small, highly residential",63,63,0,0,0,0,63,0,0,63,0,0,0,0,0,0,0,0,0,0,0,0,NY17
245838,Antioch University-Los Angeles,AULA|Antioch|Antiok|Antioc|Antoich,400 Corporate Pointe,Culver City,CA,90230-7615,-118.384458,33.988533,Private not-for-profit,Graduate degree or certificate offering,No,Suburb: Large,Master's Colleges & Universities: Larger Programs,Postbaccalaureate: Comprehensive programs,Majority graduate,"Four-year, very small, primarily nonresidential",1081,284,797,9,0,9,1081,1081,0,0,244,63,181,0,0,0,0,0,0,0,0,0,CA37
245847,Antioch University-Santa Barbara,AUSB,602 Anacapa Street,Santa Barbara,CA,93101,-119.6958,34.419203,Private not-for-profit,Graduate degree or certificate offering,No,City: Small,Master's Colleges & Universities: Small Programs,"Postbaccalaureate: Other-dominant, with Arts & Sciences",Majority graduate,"Four-year, very small, primarily nonresidential",318,70,248,15,2,13,318,318,0,0,81,13,68,11,1,10,0,0,0,0,0,0,CA24
245865,Antioch University-New England,Antioch New England Graduate School,40 Avon St,Keene,NH,03431,-72.293798,42.932344,Private not-for-profit,Graduate degree or certificate offering,No,Town: Distant,Master's Colleges & Universities: Larger Programs,Research Doctoral: Single program-Other,Exclusively graduate,Exclusively graduate/professional,1313,230,1083,29,8,21,1313,1313,0,0,196,40,156,9,2,7,10,3,7,3,2,1,NH02
245883,Antioch University-Seattle, ,2326 6th Ave,Seattle,WA,98121-1814,-122.346318,47.615916,Private not-for-profit,Graduate degree or certificate offering,No,City: Large,Master's Colleges & Universities: Medium Programs,"Postbaccalaureate: Other-dominant, with Arts & Sciences",Majority graduate,"Four-year, very small, primarily nonresidential",844,129,715,13,2,11,844,844,0,0,145,31,114,3,1,2,1,0,1,0,0,0,WA07
245892,Antioch University, ,900 Dayton St,Yellow Springs,OH,45387,-83.908684,39.80321,Private not-for-profit,Graduate degree or certificate offering,No,Rural: Fringe,nan,nan,nan,nan,336,79,257,11,2,9,336,168,0,168,27,4,23,0,0,0,26,5,21,0,0,0,OH10
245953,Mid-America Christian University,Gulf Coast Bible College|Mid-America Bible College|MACU,3500 SW 119th St,Oklahoma City,OK,73170-9797,-97.578297,35.347785,Private not-for-profit,Graduate degree or certificate offering,No,City: Large,Master's Colleges & Universities: Medium Programs,"Postbaccalaureate: Business-dominant, with other professional programs",Majority undergraduate,"Four-year, small, primarily nonresidential",645,195,450,24,16,8,645,506,38,101,138,50,88,1,1,0,0,0,0,0,0,0,OK04
246345,Houston Graduate School of Theology, ,4300-C West Bellfort,Houston,TX,77035-3602,-95.448846,29.673594,Private not-for-profit,Graduate degree or certificate offering,No,City: Large,Special Focus Four-Year: Faith-Related Institutions,"Postbaccalaureate: Other-dominant, with other professional programs",Exclusively graduate,Exclusively graduate/professional,152,55,97,7,4,3,152,152,0,0,26,11,15,4,1,3,0,0,0,0,0,0,TX09
246789,Unification Theological Seminary,UTS,4 West 43rd Street,New York,NY,10036,-73.981154,40.754309,Private not-for-profit,Graduate degree or certificate offering,No,City: Large,Special Focus Four-Year: Faith-Related Institutions,Postbaccalaureate: Single program-Other,Exclusively graduate,Exclusively graduate/professional,148,90,58,39,27,12,148,104,24,20,24,12,12,8,5,3,0,0,0,0,0,0,NY12
247162,Ecumenical Theological Seminary,ETS,2930 Woodward Ave,Detroit,MI,48201-3035,-83.055266,42.344129,Private not-for-profit,Graduate degree or certificate offering,No,City: Large,Special Focus Four-Year: Faith-Related Institutions,Research Doctoral: Single program-Other,Majority graduate,Exclusively graduate/professional,99,43,56,2,1,1,99,98,0,1,8,2,6,0,0,0,6,2,4,0,0,0,MI13
247649,Landmark College, ,19 River Rd South,Putney,VT,05346,-72.512549,42.977172,Private not-for-profit,Graduate degree or certificate offering,No,Rural: Distant,Baccalaureate/Associate's Colleges: Mixed Baccalaureate/Associate's,Not classified (Exclusively Undergraduate),Very high undergraduate,"Four-year, very small, highly residential",155,18,137,0,0,0,155,155,0,0,0,0,0,0,0,0,0,0,0,0,0,0,VT00
247773,Yeshiva Gedolah of Greater Detroit, ,24600 Greenfield Rd,Oak Park,MI,48237,-83.200754,42.471924,Private not-for-profit,Graduate degree or certificate offering,No,Suburb: Large,Special Focus Four-Year: Faith-Related Institutions,Postbaccalaureate: Single program-Other,Very high undergraduate,"Four-year, very small, highly residential",5,5,0,0,0,0,5,0,0,5,1,1,0,0,0,0,0,0,0,0,0,0,MI11
247825,Austin Graduate School of Theology, ,7640 Guadalupe St,Austin,TX,78752,-97.711751,30.343842,Private not-for-profit,Graduate degree or certificate offering,No,City: Large,nan,nan,nan,nan,8,7,1,0,0,0,8,0,0,8,3,2,1,0,0,0,0,0,0,0,0,0,TX37
248934,ECPI University,ECPI,5555 Greenwich Rd,Virginia Beach,VA,23462,-76.178773,36.842526,Private for-profit,Graduate degree or certificate offering,No,City: Large,Master's Colleges & Universities: Medium Programs,"Postbaccalaureate: Other-dominant, with Arts & Sciences",Very high undergraduate,"Four-year, large, primarily nonresidential",477,235,242,4,2,2,477,350,32,95,181,85,96,4,2,2,0,0,0,0,0,0,VA02
251312,South University-Columbia, ,9 Science Court,Columbia,SC,29203,-80.961839,34.098042,Private for-profit,Graduate degree or certificate offering,No,Suburb: Large,Doctoral/Professional Universities,"Postbaccalaureate: Other-dominant, with other professional programs",Majority undergraduate,"Four-year, very small, primarily nonresidential",307,70,237,0,0,0,307,62,67,178,93,19,74,0,0,0,0,0,0,0,0,0,SC06
262022,Bethel Seminary-San Diego,Bethel University/Bethel Seminary San Diego,6116 Arosa St,San Diego,CA,92115,-117.06605,32.765387,Private not-for-profit,Graduate degree or certificate offering,No,City: Large,nan,nan,nan,nan,31,5,26,2,0,2,31,31,0,0,18,4,14,2,1,1,0,0,0,0,0,0,CA51
262086,University of Massachusetts Global, ,16355 Laguna Canyon Road,Irvine,CA,92618,-117.769012,33.656401,Private not-for-profit,Graduate degree or certificate offering,No,City: Large,Doctoral/Professional Universities,Research Doctoral: Single program-Education,Majority undergraduate,"Four-year, medium, primarily nonresidential",6772,1830,4942,4,1,3,6772,6772,0,0,1652,507,1145,0,0,0,54,14,40,0,0,0,CA47
262129,New College of Florida, ,5800 Bay Shore Road,Sarasota,FL,34243-2109,-82.55858,27.384925,Public,Graduate degree or certificate offering,No,City: Small,Baccalaureate Colleges: Arts & Sciences Focus,Postbaccalaureate: Single program-Other,Very high undergraduate,"Four-year, very small, highly residential",30,16,14,5,1,4,30,0,30,0,12,5,7,4,1,3,0,0,0,0,0,0,FL17
363907,Caribbean University-Ponce, ,AVE. EDNITA NAZARIO #1015,Ponce,PR,00716-7733,-66.59425,18.006633,Private not-for-profit,Graduate degree or certificate offering,No,City: Midsize,Baccalaureate Colleges: Diverse Fields,Research Doctoral: Single program-Other,Majority undergraduate,"Four-year, very small, primarily nonresidential",330,172,158,0,0,0,330,90,125,115,27,4,23,0,0,0,0,0,0,0,0,0,PR98
363916,Caribbean University-Vega Baja, ,"Carr 671 K.M. 5, Sector El Criollo, Bo. Algarrobo",Vega Baja,PR,00964,-66.40315,18.444882,Private not-for-profit,Graduate degree or certificate offering,No,Suburb: Large,Baccalaureate Colleges: Diverse Fields,Postbaccalaureate: Single program-Education,Very high undergraduate,"Four-year, very small, primarily nonresidential",27,11,16,0,0,0,27,15,12,0,1,0,1,0,0,0,0,0,0,0,0,0,PR98
363934,University of Advancing Technology, ,2625 W Baseline Rd,Tempe,AZ,85283,-111.976087,33.377712,Private for-profit,Graduate degree or certificate offering,No,City: Midsize,Baccalaureate Colleges: Diverse Fields,"Postbaccalaureate: Other-dominant, with Arts & Sciences",Very high undergraduate,"Four-year, very small, primarily residential",69,52,17,4,4,0,69,18,51,0,10,7,3,1,1,0,0,0,0,0,0,0,AZ03
366003,South Florida Bible College and Theological Seminary,SFBC,2200 SW 10th Street,Deerfield Beach,FL,33442,-80.134508,26.30294,Private not-for-profit,Graduate degree or certificate offering,No,City: Small,Baccalaureate Colleges: Diverse Fields,"Postbaccalaureate: Other-dominant, with other professional programs",High undergraduate,"Four-year, very small, primarily nonresidential",112,52,60,39,11,28,112,68,42,2,23,7,16,13,3,10,0,0,0,0,0,0,FL23
366368,New York Academy of Art, ,111 Franklin St,New York,NY,10013-2911,-74.006019,40.718388,Private not-for-profit,Graduate degree or certificate offering,No,City: Large,"Special Focus Four-Year: Arts, Music & Design Schools",Postbaccalaureate: Single program-Other,Exclusively graduate,Exclusively graduate/professional,124,47,77,27,11,16,124,0,7,117,46,16,30,11,5,6,0,0,0,0,0,0,NY10
366605,Southwest Acupuncture College-Santa Fe, ,"2100 Calle de la Vuelta,  Suite D103",Santa Fe,NM,87505,-105.95544,35.6607,Private for-profit,Graduate degree or certificate offering,No,City: Small,Special Focus Four-Year: Other Health Professions Schools,Postbaccalaureate: Single program-Other,Exclusively graduate,Exclusively graduate/professional,36,9,27,0,0,0,36,0,36,0,4,0,4,0,0,0,0,0,0,0,0,0,NM03
366711,California State University-San Marcos, ,333 S Twin Oaks Valley Rd,San Marcos,CA,92096-0001,-117.159013,33.130569,Public,Graduate degree or certificate offering,No,Suburb: Large,Master's Colleges & Universities: Larger Programs,Postbaccalaureate: Comprehensive programs,Very high undergraduate,"Four-year, large, primarily nonresidential",1461,430,1031,104,54,50,1461,1383,76,2,492,144,348,62,36,26,0,0,0,0,0,0,CA50
367884,Hodges University,International College,4501 Colonial Blvd,Fort Myers,FL,33966,-81.821419,26.610865,Private not-for-profit,Graduate degree or certificate offering,No,City: Small,Master's Colleges & Universities: Small Programs,"Postbaccalaureate: Other-dominant, with Arts & Sciences",High undergraduate,"Four-year, very small, primarily nonresidential",154,39,115,0,0,0,154,137,17,0,37,13,24,0,0,0,0,0,0,0,0,0,FL19
367954,University of St. Augustine for Health Sciences,University of St. Augustine,700 Windy Point Drive,San Marcos,CA,92069,-117.165964,33.151849,Private for-profit,Graduate degree or certificate offering,No,Suburb: Large,Special Focus Four-Year: Other Health Professions Schools,Research Doctoral: Single program-Education,Exclusively graduate,Exclusively graduate/professional,6072,1807,4265,26,10,16,6072,1045,5027,0,450,59,391,0,0,0,16,1,15,0,0,0,CA50
369002,Massachusetts School of Law, ,500 Federal St Woodland Park,Andover,MA,01810,-71.19954,42.682106,Private not-for-profit,Graduate degree or certificate offering,No,Suburb: Large,Special Focus Four-Year: Law Schools,Postbaccalaureate: Single program-Other,Exclusively graduate,Exclusively graduate/professional,368,136,232,0,0,0,368,0,368,0,0,0,0,0,0,0,0,0,0,0,0,0,MA06
369516,Bryan University, ,4255 Nature Center Way,Springfield,MO,65804,-93.248107,37.135397,Private for-profit,Graduate degree or certificate offering,No,City: Midsize,Baccalaureate/Associate's Colleges: Mixed Baccalaureate/Associate's,Postbaccalaureate: Single program-Business,Very high undergraduate,"Four-year, very small, primarily nonresidential",19,2,17,0,0,0,19,18,0,1,7,1,6,0,0,0,0,0,0,0,0,0,MO07
369659,Oregon College of Oriental Medicine,OCOM,75 NW Couch,Portland,OR,97209,-122.671099,45.524121,Private not-for-profit,Graduate degree or certificate offering,No,City: Large,Special Focus Four-Year: Other Health Professions Schools,Postbaccalaureate: Single program-Other,Exclusively graduate,Exclusively graduate/professional,294,67,227,2,1,1,294,0,227,67,58,10,48,0,0,0,0,0,0,0,0,0,OR01
372073,Fremont College, ,18000 Studebaker Road Suite 900A,Cerritos,CA,90703,-118.097019,33.868382,Private for-profit,Graduate degree or certificate offering,No,Suburb: Large,Baccalaureate/Associate's Colleges: Mixed Baccalaureate/Associate's,Postbaccalaureate: Single program-Business,Very high undergraduate,"Four-year, very small, primarily nonresidential",13,5,8,0,0,0,13,13,0,0,9,4,5,0,0,0,0,0,0,0,0,0,CA45
374024,Adler Graduate School, ,10225 Yellow Circle Dr.,Minnetonka,MN,55343,-93.410236,44.893479,Private not-for-profit,Graduate degree or certificate offering,No,City: Small,Special Focus Four-Year: Other Health Professions Schools,Postbaccalaureate: Single program-Other,Exclusively graduate,Exclusively graduate/professional,346,73,273,0,0,0,346,123,223,0,77,18,59,0,0,0,0,0,0,0,0,0,MN03
377555,University of Washington-Bothell Campus,"UWB, UW-B, UW-Bothell",18115 Campus Way NE,Bothell,WA,98011-8246,-122.191293,47.759773,Public,Graduate degree or certificate offering,No,Suburb: Large,Master's Colleges & Universities: Larger Programs,"Postbaccalaureate: Business-dominant, with Arts & Sciences",Very high undergraduate,"Four-year, medium, primarily nonresidential",735,356,379,120,31,89,735,58,41,636,211,90,121,34,13,21,0,0,0,0,0,0,WA01
377564,University of Washington-Tacoma Campus,"UWT, UW-T, UW-Tacoma",1900 Commerce St,Tacoma,WA,98402-3100,-122.438541,47.244594,Public,Graduate degree or certificate offering,No,City: Midsize,Master's Colleges & Universities: Larger Programs,"Postbaccalaureate: Other-dominant, with Arts & Sciences",High undergraduate,"Four-year, medium, primarily nonresidential",989,381,608,120,59,61,989,35,114,840,416,181,235,65,32,33,0,0,0,0,0,0,WA06
378576,Pacific College of Health and Science, ,7445 Mission Valley Rd Ste 105,San Diego,CA,92108-4407,-117.16073,32.778391,Private for-profit,Graduate degree or certificate offering,No,City: Large,Special Focus Four-Year: Other Health Professions Schools,Postbaccalaureate: Single program-Other,Majority graduate,"Four-year, small, primarily nonresidential",1237,229,1008,0,0,0,1237,685,345,207,20,1,19,0,0,0,0,0,0,0,0,0,CA51
381352,Colorado School of Traditional Chinese Medicine,CSTCM,1441 York St Ste 302,Denver,CO,80206,-104.960118,39.739437,Private for-profit,Graduate degree or certificate offering,No,City: Large,Special Focus Four-Year: Other Health Professions Schools,Postbaccalaureate: Single program-Other,Exclusively graduate,Exclusively graduate/professional,114,23,91,0,0,0,114,0,114,0,28,4,24,0,0,0,0,0,0,0,0,0,CO01
381459,Phoenix Seminary, ,7901 E. Shea Blvd.,Scottsdale,AZ,85260,-111.910665,33.581645,Private not-for-profit,Graduate degree or certificate offering,No,City: Midsize,Special Focus Four-Year: Faith-Related Institutions,Research Doctoral: Single program-Other,Exclusively graduate,Exclusively graduate/professional,379,247,132,1,1,0,379,32,132,215,38,25,13,0,0,0,6,5,1,0,0,0,AZ01
383020,Midwest College of Oriental Medicine-Racine, ,6232 Bankers Road,Racine,WI,53403-9747,-87.856679,42.678051,Private for-profit,Graduate degree or certificate offering,No,Suburb: Midsize,Special Focus Four-Year: Other Health Professions Schools,Postbaccalaureate: Single program-Other,Majority graduate,Exclusively graduate/professional,77,12,65,1,0,1,77,0,77,0,9,1,8,0,0,0,0,0,0,0,0,0,WI01
384306,Acupuncture and Integrative Medicine College-Berkeley,AIMC Berkeley,2550 Shattuck Avenue,Berkeley,CA,94704,-122.267636,37.862754,Private not-for-profit,Graduate degree or certificate offering,No,City: Midsize,Special Focus Four-Year: Other Health Professions Schools,Postbaccalaureate: Single program-Other,Exclusively graduate,Exclusively graduate/professional,141,36,105,2,1,1,141,0,0,141,18,3,15,0,0,0,0,0,0,0,0,0,CA12
384412,University of the Potomac-Washington DC Campus, ,1401 H Street NW,Washington,DC,20005,-77.032531,38.90054,Private for-profit,Graduate degree or certificate offering,No,City: Large,Special Focus Four-Year: Business & Management Schools,"Postbaccalaureate: Business-dominant, with other professional programs",Majority graduate,"Four-year, very small, primarily nonresidential",345,198,147,306,186,120,345,38,0,307,37,22,15,27,19,8,0,0,0,0,0,0,DC98
385415,Albert Einstein College of Medicine, ,1300 Morris Park Avenue,Bronx,NY,10461-1900,-73.846327,40.852847,Private not-for-profit,Graduate degree or certificate offering,No,City: Large,Special Focus Four-Year: Research Institutions,Research Doctoral: STEM-dominant,Exclusively graduate,Exclusively graduate/professional,1245,572,673,50,21,29,1245,31,195,1019,53,26,27,2,1,1,25,13,12,2,1,1,NY14
385619,Everglades University, ,"5002 T-Rex Avenue, Suite 100",Boca Raton,FL,33431,-80.108331,26.391218,Private not-for-profit,Graduate degree or certificate offering,No,City: Small,Master's Colleges & Universities: Small Programs,"Postbaccalaureate: Other-dominant, with Arts & Sciences",High undergraduate,"Four-year, small, primarily nonresidential",495,232,263,2,2,0,495,244,39,212,185,92,93,2,2,0,0,0,0,0,0,0,FL23
386472,Herzing University-Orlando, ,1865 SR 436,Winter Park,FL,32792,-81.312669,28.615784,Private not-for-profit,Graduate degree or certificate offering,No,Suburb: Large,Special Focus Four-Year: Other Health Professions Schools,Postbaccalaureate: Single program-Business,Very high undergraduate,"Four-year, very small, primarily nonresidential",6,2,4,0,0,0,6,6,0,0,3,1,2,0,0,0,0,0,0,0,0,0,FL07
399911,Soka University of America,Soka; SUA,1 University Drive,Aliso Viejo,CA,92656-8081,-117.735344,33.554546,Private not-for-profit,Graduate degree or certificate offering,No,Suburb: Large,Baccalaureate Colleges: Arts & Sciences Focus,Postbaccalaureate: Single program-Education,Very high undergraduate,"Four-year, very small, highly residential",11,3,8,9,2,7,11,0,0,11,6,1,5,6,1,5,0,0,0,0,0,0,CA40
401223,World Mission University, ,500 Shatto Pl Ste 600,Los Angeles,CA,90020,-118.289484,34.064918,Private not-for-profit,Graduate degree or certificate offering,No,City: Large,Special Focus Four-Year: Faith-Related Institutions,"Postbaccalaureate: Other-dominant, with Arts & Sciences",Majority undergraduate,"Four-year, very small, primarily nonresidential",218,86,132,142,63,79,218,126,92,0,40,14,26,26,12,14,0,0,0,0,0,0,CA34
401250,Yo San University of Traditional Chinese Medicine,Yo San University,13315 W. Washington Boulevard,Los Angeles,CA,90066,-118.442756,33.993287,Private not-for-profit,Graduate degree or certificate offering,No,Suburb: Large,Special Focus Four-Year: Other Health Professions Schools,Postbaccalaureate: Single program-Other,Exclusively graduate,Exclusively graduate/professional,166,35,131,4,1,3,166,125,41,0,13,3,10,0,0,0,0,0,0,0,0,0,CA36
404222,Inter American University of Puerto Rico-School of Optometry, ,500 John Will Harris Avenue,Bayamon,PR,00957,-66.182473,18.351631,Private not-for-profit,Graduate degree or certificate offering,No,City: Midsize,Special Focus Four-Year: Other Health Professions Schools,Postbaccalaureate: Single program-Other,Exclusively graduate,Exclusively graduate/professional,214,77,137,0,0,0,214,0,0,214,0,0,0,0,0,0,0,0,0,0,0,0,PR98
404338,Schiller International University, ,400 N Tampa St. Suite 1700,Tampa,FL,33602,-82.459292,27.947866,Private for-profit,Graduate degree or certificate offering,No,City: Large,Special Focus Four-Year: Business & Management Schools,"Postbaccalaureate: Business-dominant, with Arts & Sciences",Majority undergraduate,"Four-year, very small, primarily nonresidential",11,4,7,0,0,0,11,8,3,0,7,3,4,0,0,0,0,0,0,0,0,0,FL14
407629,Lake Erie College of Osteopathic Medicine,LECOM,1858 W Grandview Blvd,Erie,PA,16509-1025,-80.105969,42.080699,Private not-for-profit,Graduate degree or certificate offering,No,City: Small,Special Focus Four-Year: Medical Schools & Centers,Research Doctoral: Single program-Other,Majority graduate,Exclusively graduate/professional,4495,2127,2368,0,0,0,4495,0,478,4017,294,129,165,0,0,0,0,0,0,0,0,0,PA16
408844,Florida National University-Main Campus, ,4425 West. Jose Regueiro (20th) Avenue,Hialeah,FL,33012,-80.321846,25.86178,Private for-profit,Graduate degree or certificate offering,No,Suburb: Large,Master's Colleges & Universities: Medium Programs,"Postbaccalaureate: Other-dominant, with other professional programs",Very high undergraduate,"Four-year, small, primarily nonresidential",491,133,358,21,11,10,491,123,282,86,147,42,105,9,4,5,0,0,0,0,0,0,FL26
409254,Erikson Institute,The Erikson Institute,451 N. LaSalle Street,Chicago,IL,60654-4510,-87.632178,41.890663,Private not-for-profit,Graduate degree or certificate offering,No,City: Large,Master's Colleges & Universities: Medium Programs,"Postbaccalaureate: Education-dominant, with other professional programs",Exclusively graduate,Exclusively graduate/professional,525,16,509,18,0,18,525,268,194,63,143,4,139,4,0,4,0,0,0,0,0,0,IL07
409616,Roger Williams University School of Law, ,Ten Metacom Ave,Bristol,RI,02809-5171,-71.261978,41.650974,Private not-for-profit,Graduate degree or certificate offering,No,Suburb: Large,Special Focus Four-Year: Law Schools,Postbaccalaureate: Single program-Other,Exclusively graduate,Exclusively graduate/professional,524,222,302,9,0,9,524,168,356,0,3,3,0,0,0,0,0,0,0,0,0,0,RI01
409698,California State University-Monterey Bay,CSUMB,100 Campus Center,Seaside,CA,93955-8001,-121.796178,36.652397,Public,Graduate degree or certificate offering,No,Suburb: Midsize,Master's Colleges & Universities: Larger Programs,"Postbaccalaureate: Business-dominant, with Arts & Sciences",High undergraduate,"Four-year, medium, highly residential",1031,304,727,27,4,23,1031,719,311,1,351,106,245,7,1,6,0,0,0,0,0,0,CA19
413413,Capella University, ,"225 South 6th Street, 9th Floor",Minneapolis,MN,55402-3389,-93.268796,44.976286,Private for-profit,Graduate degree or certificate offering,No,City: Large,Doctoral/Professional Universities,Research Doctoral: Professional-dominant,Majority graduate,"Four-year, large, primarily nonresidential",42849,7507,35342,260,85,175,42849,42849,0,0,6634,1097,5537,40,15,25,1395,313,1082,14,6,8,MN05
414595,Pacific College of Health and Science,Pacific College of Health and Science,110 William St. 19th Fl,New York,NY,10038,-74.006721,40.7088,Private for-profit,Graduate degree or certificate offering,No,City: Large,Special Focus Four-Year: Other Health Professions Schools,Postbaccalaureate: Single program-Other,Majority graduate,"Four-year, very small, primarily nonresidential",504,97,407,1,0,1,504,19,473,12,83,17,66,0,0,0,0,0,0,0,0,0,NY10
414878,Trine University-Regional/Non-Traditional Campuses, ,9910 Dupont Circle Drive East,Fort Wayne,IN,46825,-85.106453,41.172352,Private not-for-profit,Graduate degree or certificate offering,No,City: Large,Master's Colleges & Universities: Medium Programs,"Postbaccalaureate: Business-dominant, with Arts & Sciences",Majority graduate,"Four-year, very small, primarily nonresidential",1038,731,307,799,590,209,1038,219,747,72,236,140,96,105,72,33,0,0,0,0,0,0,IN03
414966,Phillips Theological Seminary, ,901 N Mingo Rd,Tulsa,OK,74116-5612,-95.868146,36.167983,Private not-for-profit,Graduate degree or certificate offering,No,City: Large,Special Focus Four-Year: Faith-Related Institutions,Research Doctoral: Single program-Other,Exclusively graduate,Exclusively graduate/professional,216,109,107,1,1,0,216,31,76,109,17,6,11,0,0,0,4,2,2,0,0,0,OK01
416801,The University of Texas MD Anderson Cancer Center,MD Anderson Cancer Center| MD Anderson Hospital|MD Anderson Hospital and Tumor Institute|MDACC|UTMDACC|Anderson Cancer Center,1515 Holcombe Blvd.,Houston,TX,77030-4009,-95.396804,29.707016,Public,Graduate degree or certificate offering,No,City: Large,Special Focus Four-Year: Other Health Professions Schools,Postbaccalaureate: Single program-Other,Very high undergraduate,"Four-year, very small, primarily nonresidential",55,16,39,9,3,6,55,11,0,44,22,7,15,3,1,2,0,0,0,0,0,0,TX09
417053,Cedars Sinai Medical Center, ,8700 Beverly Boulevard,Los Angeles,CA,90048-0000,-118.380175,34.075598,Private not-for-profit,Graduate degree or certificate offering,No,City: Large,nan,nan,nan,nan,98,46,52,11,5,6,98,0,0,98,29,12,17,0,0,0,4,1,3,0,0,0,CA30
418126,New York College of Health Professions, ,6801 Jericho Tpk,Syosset,NY,11791-4413,-73.516191,40.809329,Private not-for-profit,Graduate degree or certificate offering,No,Suburb: Large,Special Focus Four-Year: Other Health Professions Schools,Postbaccalaureate: Single program-Other,Majority undergraduate,"Four-year, very small, primarily nonresidential",147,48,99,18,6,12,147,0,133,14,28,10,18,2,1,1,0,0,0,0,0,0,NY03
420042,University of Phoenix-Hawaii, ,949 Kaokila Blvd,Kapolei,HI,96707-2082,-158.08161,21.334103,Private for-profit,Graduate degree or certificate offering,No,Suburb: Large,Baccalaureate Colleges: Diverse Fields,Postbaccalaureate: Single program-Business,Very high undergraduate,"Four-year, very small, primarily nonresidential",13,10,3,0,0,0,13,1,2,10,7,6,1,0,0,0,0,0,0,0,0,0,HI01
420246,Southwest College of Naturopathic Medicine & Health Sciences, ,2140 E Broadway Rd,Tempe,AZ,85282,-111.89442,33.40789,Private not-for-profit,Graduate degree or certificate offering,No,City: Midsize,Special Focus Four-Year: Other Health Professions Schools,Postbaccalaureate: Single program-Other,Exclusively graduate,Exclusively graduate/professional,622,96,526,0,0,0,622,200,422,0,0,0,0,0,0,0,0,0,0,0,0,0,AZ04
420705,Bakke Graduate University,BGU,"8515 Greenville Ave, Suite S206",Dallas,TX,75243-7039,-96.753976,32.894605,Private not-for-profit,Graduate degree or certificate offering,No,City: Large,Special Focus Four-Year: Faith-Related Institutions,Research Doctoral: Single program-Other,Exclusively graduate,Exclusively graduate/professional,168,108,60,58,42,16,168,162,6,0,5,0,5,2,0,2,13,9,4,8,4,4,TX32
422695,Pacific College, ,3160 Red Hill Ave,Costa Mesa,CA,92626,-117.873382,33.680043,Private for-profit,Graduate degree or certificate offering,No,City: Midsize,Special Focus Four-Year: Other Health Professions Schools,Not classified (Exclusively Undergraduate),Very high undergraduate,"Four-year, very small, primarily nonresidential",17,1,16,0,0,0,17,17,0,0,0,0,0,0,0,0,0,0,0,0,0,0,CA47
423643,Midwestern University-Glendale, ,19555 N 59th Ave,Glendale,AZ,85308,-112.183633,33.663853,Private not-for-profit,Graduate degree or certificate offering,No,Suburb: Large,Special Focus Four-Year: Medical Schools & Centers,"Postbaccalaureate: Other-dominant, with Arts & Sciences",Exclusively graduate,Exclusively graduate/professional,4257,1800,2457,113,47,66,4257,61,0,4196,372,112,260,2,0,2,0,0,0,0,0,0,AZ08
426314,Embry-Riddle Aeronautical University-Worldwide,Embry Riddle Aeronautical University-Worldwide,1 Aerospace Blvd.,Daytona Beach,FL,32114-3900,-81.048367,29.189903,Private not-for-profit,Graduate degree or certificate offering,No,City: Small,Master's Colleges & Universities: Larger Programs,Research Doctoral: Single program-Other,Majority undergraduate,"Four-year, medium, primarily nonresidential",4915,3628,1287,313,241,72,4915,4633,164,118,1266,934,332,75,57,18,10,7,3,2,2,0,FL06
428259,Ottawa University-Milwaukee,Ottawa University - Milwaukee,"245 South Executive Drive, Suite 340",Brookfield,WI,53005,-88.115185,43.02963,Private not-for-profit,Graduate degree or certificate offering,No,Suburb: Large,Baccalaureate Colleges: Diverse Fields,"Postbaccalaureate: Business-dominant, with other professional programs",Majority undergraduate,"Four-year, very small, primarily nonresidential",155,61,94,0,0,0,155,144,11,0,32,11,21,0,0,0,0,0,0,0,0,0,WI05
429085,American College of Acupuncture and Oriental Med, ,9100 Park  West Drive,Houston,TX,77063-4104,-95.524765,29.735747,Private for-profit,Graduate degree or certificate offering,No,City: Large,Special Focus Four-Year: Other Health Professions Schools,Postbaccalaureate: Single program-Other,Exclusively graduate,Exclusively graduate/professional,141,36,105,18,9,9,141,13,128,0,27,7,20,5,3,2,0,0,0,0,0,0,TX07
429094,AOMA Graduate School of Integrative Medicine,AOMA,4701 Westgate Blvd,Austin,TX,78745,-97.800643,30.228551,Private for-profit,Graduate degree or certificate offering,No,City: Large,Special Focus Four-Year: Other Health Professions Schools,Research Doctoral: Single program-Other,Exclusively graduate,Exclusively graduate/professional,180,36,144,1,0,1,180,0,0,180,24,6,18,0,0,0,2,2,0,0,0,0,TX37
430184,Strayer University-Maryland, ,5110 Auth Way,Suitland,MD,20746,-76.918039,38.827438,Private for-profit,Graduate degree or certificate offering,No,Suburb: Large,Special Focus Four-Year: Business & Management Schools,"Postbaccalaureate: Business-dominant, with Arts & Sciences",High undergraduate,"Four-year, small, primarily nonresidential",554,156,398,2,1,1,554,554,0,0,165,46,119,1,0,1,0,0,0,0,0,0,MD04
430670,San Juan Bautista School of Medicine, ,Carretera 172  Urb. Turabo Gardens,Caguas,PR,00725-4968,-66.050389,18.220528,Private not-for-profit,Graduate degree or certificate offering,No,City: Small,Special Focus Four-Year: Medical Schools & Centers,Postbaccalaureate: Single program-Other,Majority graduate,"Four-year, very small, primarily nonresidential",312,125,187,0,0,0,312,0,0,312,16,2,14,0,0,0,0,0,0,0,0,0,PR98
430704,Texas Health and Science University,THSU,4005 Menchaca Rd,Austin,TX,78704,-97.785289,30.233143,Private for-profit,Graduate degree or certificate offering,No,City: Large,Special Focus Four-Year: Other Health Professions Schools,"Postbaccalaureate: Other-dominant, with other professional programs",Majority graduate,"Four-year, very small, primarily nonresidential",105,37,68,37,10,27,105,0,105,0,32,10,22,15,3,12,0,0,0,0,0,0,TX37
432348,Appalachian School of Law, ,1169 Edgewater Drive,Grundy,VA,24614,-82.095648,37.277669,Private not-for-profit,Graduate degree or certificate offering,No,Rural: Remote,Special Focus Four-Year: Law Schools,Postbaccalaureate: Single program-Other,Exclusively graduate,Exclusively graduate/professional,178,96,82,6,3,3,178,0,40,138,0,0,0,0,0,0,0,0,0,0,0,0,VA09
433004,American University of Health Sciences,AUHS,1600 East Hill St,Signal Hill,CA,90755-3612,-118.171366,33.796849,Private for-profit,Graduate degree or certificate offering,No,Suburb: Large,Special Focus Four-Year: Other Health Professions Schools,Not classified (Exclusively Undergraduate),High undergraduate,"Four-year, very small, primarily nonresidential",136,52,84,0,0,0,136,0,0,136,2,1,1,0,0,0,0,0,0,0,0,0,CA42
433387,Western Governors University,WGU Western Governors,4001 South 700 East Suite 700,Salt Lake City,UT,84107,-111.869752,40.68481,Private not-for-profit,Graduate degree or certificate offering,No,Suburb: Large,Master's Colleges & Universities: Larger Programs,"Postbaccalaureate: Business-dominant, with Arts & Sciences",Majority undergraduate,"Four-year, large, primarily nonresidential",65330,19336,45994,52,28,24,65330,65330,0,0,22759,6705,16054,27,14,13,0,0,0,0,0,0,UT04
433420,California Aeronautical University,California Aeronautical University,1450 Boughton Drive,Bakersfield,CA,93308,-119.049264,35.434905,Private for-profit,Graduate degree or certificate offering,No,Suburb: Large,Special Focus Four-Year: Engineering and Other Technology-Related Schools,"Postbaccalaureate: Other-dominant, with other professional programs",Very high undergraduate,"Four-year, very small, highly residential",7,6,1,0,0,0,7,3,0,4,2,2,0,0,0,0,0,0,0,0,0,0,CA20
433536,Herzing University-New Orleans, ,3900 N. Causeway Blvd.,Metairie,LA,70002,-90.155851,30.019252,Private not-for-profit,Graduate degree or certificate offering,No,City: Midsize,Baccalaureate/Associate's Colleges: Mixed Baccalaureate/Associate's,Postbaccalaureate: Single program-Business,Very high undergraduate,"Four-year, very small, primarily nonresidential",26,5,21,0,0,0,26,26,0,0,7,0,7,0,0,0,0,0,0,0,0,0,LA01
433660,Florida Gulf Coast University, ,10501 Fgcu Blvd S,Fort Myers,FL,33965-6565,-81.7726,26.463638,Public,Graduate degree or certificate offering,No,Suburb: Large,Doctoral/Professional Universities,Research Doctoral: Single program-Education,Very high undergraduate,"Four-year, large, primarily residential",1994,606,1388,27,14,13,1994,751,705,538,395,107,288,6,3,3,5,3,2,0,0,0,FL19
434441,Florida College of Integrative Medicine,FCIM,7100 Lake Ellenor Dr,Orlando,FL,32809-5721,-81.401757,28.46359,Private for-profit,Graduate degree or certificate offering,No,Suburb: Large,Special Focus Four-Year: Other Health Professions Schools,Postbaccalaureate: Single program-Other,Exclusively graduate,Exclusively graduate/professional,97,16,81,4,3,1,97,0,0,97,18,2,16,0,0,0,0,0,0,0,0,0,FL10
434715,Florida Coastal School of Law, ,"4600 Touchton Road E, Suite #1150",Jacksonville,FL,32246,-81.550506,30.263653,Private for-profit,Graduate degree or certificate offering,No,City: Large,nan,nan,nan,nan,225,96,129,0,0,0,225,225,0,0,0,0,0,0,0,0,0,0,0,0,0,0,FL05
435000,Louisiana State University Health Sciences Center-Shreveport,LSUHSC-S|LSU Health Sciences Center-Shreveport|LSU Health Sciences Center - Shreveport|LSU Health Sciences Center in Shreveport|LSU Health Sciences Center at Shreveport|Louisiana State University Health Sciences Center at Shreveport|Louisiana State University Health Sciences Center in Shreveport|LSU Health Shreveport,1501 Kings Hwy,Shreveport,LA,71103,-93.761018,32.480683,Public,Graduate degree or certificate offering,No,City: Midsize,Special Focus Four-Year: Medical Schools & Centers,Research Doctoral: Single program-Other,Majority graduate,"Four-year, very small, primarily nonresidential",1108,381,727,41,20,21,1108,65,115,928,73,7,66,1,1,0,9,2,7,3,1,2,LA04
436261,Southwest Acupuncture College-Boulder, ,6630 Gunpark Dr Suite 200,Boulder,CO,80301,-105.199471,40.069443,Private for-profit,Graduate degree or certificate offering,No,City: Midsize,Special Focus Four-Year: Other Health Professions Schools,Postbaccalaureate: Single program-Other,Exclusively graduate,Exclusively graduate/professional,55,10,45,0,0,0,55,0,55,0,11,3,8,0,0,0,0,0,0,0,0,0,CO02
436614,International Baptist College and Seminary, ,2211 W Germann Road,Chandler,AZ,85286,-111.879629,33.273788,Private not-for-profit,Graduate degree or certificate offering,No,City: Large,Special Focus Four-Year: Faith-Related Institutions,"Postbaccalaureate: Other-dominant, with other professional programs",High undergraduate,"Four-year, very small, primarily residential",38,30,8,0,0,0,38,7,29,2,8,6,2,0,0,0,0,0,0,0,0,0,AZ05
437097,University of Management and Technology, ,"1901 Fort Myer Drive, Suite 700",Arlington,VA,22209-1609,-77.072001,38.89743,Private for-profit,Graduate degree or certificate offering,No,City: Midsize,Doctoral/Professional Universities,Research Doctoral: Single program-Other,Majority undergraduate,"Four-year, very small, primarily nonresidential",516,337,179,0,0,0,516,514,0,2,224,147,77,0,0,0,23,14,9,0,0,0,VA08
437316,Linfield University-School of Nursing,Linfield-Good Samaritan School of Nursing|Linfield Nursing|Linfeld College Nursing|Lynfield Nursing|Lynnfield Nursing|Linfeild Nursing|Linfield College Nursing|Good Samaritan Nursing|Linfield School of Nursing|Lynfield School of Nursing|Lynnfield School of Nursing|Linfeild School of Nursing|Portland Campus|Good Sam Nursing|Linfield|LC|Lindfield|Lynfield|Linnfield|Lynnfield|Linfeld|Lindfield College|Lynfield College|Linnfield College|Lynnfield College|Linfeld College|Linfield University|Lindfield University|Lynfield University|Lynnfield University|Linfeld University|Linfeild|Linfeild College|Linfeild University|Wildcats|Linfield College Portland |Portland School of Nursing,2900 NE 132nd Avenue,Portland,OR,97230,-122.524887,45.543942,Private not-for-profit,Graduate degree or certificate offering,No,City: Large,Special Focus Four-Year: Other Health Professions Schools,Not classified (Exclusively Undergraduate),Very high undergraduate,"Four-year, very small, primarily nonresidential",21,1,20,0,0,0,21,21,0,0,0,0,0,0,0,0,0,0,0,0,0,0,OR03
437325,Linfield University-Online and Continuing Education,OCE|Linfield OCE|Online Programs|Linfield Online Programs|Linfield ADP|Linfield DCE|ADP|DCE|Linfield Adult Degree Program|Linfield Nursing|Linfeld Nursing|Lynfield Nursing|Lynnfield Nursing|Linfeild Nursing|Linfield College Nursing|Linfield School of Nursing|Linfeld School of Nursing|Lynfield School of Nursing|Lynnfield School of Nursing|Linfeild School of Nursing|Linfield|LC|Lindfield|Lynfield|Linnfield|Lynnfield|Linfeld|Lindfield College|Lynfield College|Linnfield College|Lynnfield College|Linfeld College|Linfield University|Lindfield University|Lynfield University|Lynnfield University|Linfeld University|Linfeild|Linfeild College|Linfeild University|,900 SE Baker Street,McMinnville,OR,97128-6894,-123.199637,45.201148,Private not-for-profit,Graduate degree or certificate offering,No,Town: Distant,Special Focus Four-Year: Other Health Professions Schools,Not classified (Exclusively Undergraduate),Very high undergraduate,"Four-year, very small, primarily nonresidential",23,6,17,0,0,0,23,23,0,0,0,0,0,0,0,0,0,0,0,0,0,0,OR06
438498,Stratford University, ,2900 Eisenhower Avenue,Alexandria,VA,22314,-77.083035,38.801799,Private for-profit,Graduate degree or certificate offering,No,City: Midsize,Master's Colleges & Universities: Medium Programs,"Postbaccalaureate: Business-dominant, with Arts & Sciences",High undergraduate,"Four-year, small, primarily nonresidential",412,205,207,106,57,49,412,97,254,61,127,68,59,56,33,23,0,0,0,0,0,0,VA08
438586,American InterContinental University-Atlanta,AIU Atlanta,"6600 Peachtree Dunwoody Road, 500 Embassy Row",Atlanta,GA,30328,-84.354907,33.938779,Private for-profit,Graduate degree or certificate offering,No,City: Midsize,Master's Colleges & Universities: Medium Programs,"Postbaccalaureate: Business-dominant, with Arts & Sciences",Very high undergraduate,"Four-year, small, primarily nonresidential",265,95,170,1,0,1,265,233,30,2,101,29,72,0,0,0,0,0,0,0,0,0,GA06
439020,Midwest College of Oriental Medicine-Skokie, ,8950 Gross Point Rd. Suite 400,Skokie,IL,60077,-87.754597,42.044312,Private for-profit,Graduate degree or certificate offering,No,City: Small,Special Focus Four-Year: Other Health Professions Schools,Postbaccalaureate: Single program-Other,Majority graduate,Exclusively graduate/professional,65,17,48,0,0,0,65,0,65,0,10,2,8,0,0,0,0,0,0,0,0,0,IL09
439394,East West College of Natural Medicine, ,3808 N. Tamiami Tr,Sarasota,FL,34234-0000,-82.551571,27.368451,Private for-profit,Graduate degree or certificate offering,No,City: Small,Special Focus Four-Year: Other Health Professions Schools,Postbaccalaureate: Single program-Other,Exclusively graduate,Exclusively graduate/professional,112,19,93,0,0,0,112,0,112,0,27,7,20,0,0,0,0,0,0,0,0,0,FL17
439446,Atlantic Institute of Oriental Medicine, ,"100 E Broward Blvd, Suite 100",Fort Lauderdale,FL,33301-3510,-80.142235,26.121964,Private not-for-profit,Graduate degree or certificate offering,No,City: Midsize,Special Focus Four-Year: Other Health Professions Schools,Postbaccalaureate: Single program-Other,Majority graduate,"Four-year, very small, primarily nonresidential",131,19,112,14,0,14,131,0,0,131,28,5,23,0,0,0,0,0,0,0,0,0,FL23
439701,The King's University, ,2121 E. Southlake Boulevard,Southlake,TX,76092,-97.121526,32.93973,Private not-for-profit,Graduate degree or certificate offering,No,Suburb: Large,Special Focus Four-Year: Faith-Related Institutions,"Postbaccalaureate: Other-dominant, with other professional programs",Majority undergraduate,"Four-year, very small, primarily nonresidential",431,212,219,17,11,6,431,195,105,131,41,26,15,4,2,2,0,0,0,0,0,0,TX24
439783,New York College of Traditional Chinese Medicine,New York Institute of Chinese Medicine,"200 Old Country Road, Suite 500",Mineola,NY,11501,-73.638911,40.73945,Private not-for-profit,Graduate degree or certificate offering,No,Suburb: Large,Special Focus Four-Year: Other Health Professions Schools,Postbaccalaureate: Single program-Other,Majority graduate,Exclusively graduate/professional,142,42,100,8,2,6,142,32,100,10,53,16,37,5,1,4,0,0,0,0,0,0,NY03
439817,Northeastern Seminary, ,2265 Westside Dr,Rochester,NY,14624,-77.8007,43.122873,Private not-for-profit,Graduate degree or certificate offering,No,Suburb: Large,Special Focus Four-Year: Faith-Related Institutions,Postbaccalaureate: Single program-Other,Exclusively graduate,Exclusively graduate/professional,246,128,118,6,4,2,246,138,86,22,24,13,11,0,0,0,0,0,0,0,0,0,NY25
439914,Seattle Institute of East Asian Medicine,SIEAM,226 South Orcas Street,Seattle,WA,98108,-122.331171,47.552127,Private not-for-profit,Graduate degree or certificate offering,No,City: Large,Special Focus Four-Year: Other Health Professions Schools,Postbaccalaureate: Single program-Other,Exclusively graduate,Exclusively graduate/professional,42,13,29,0,0,0,42,0,0,42,5,3,2,0,0,0,0,0,0,0,0,0,WA07
439969,Acupuncture and Massage College, ,10506 N Kendall Drive,Miami,FL,33176,-80.364141,25.686382,Private for-profit,Graduate degree or certificate offering,No,City: Small,Special Focus Four-Year: Other Health Professions Schools,Postbaccalaureate: Single program-Other,Majority graduate,"Four-year, small, primarily nonresidential",145,42,103,2,0,2,145,0,0,145,37,12,25,0,0,0,0,0,0,0,0,0,FL27
440004,Upper Valley Educators Institute,"UVEI, UVTI, UVTTP",194 Dartmouth College Highway,Lebanon,NH,03766-1358,-72.230822,43.637595,Private not-for-profit,Graduate degree or certificate offering,No,Town: Remote,nan,nan,nan,nan,56,22,34,0,0,0,56,0,0,56,0,0,0,0,0,0,0,0,0,0,0,0,NH02
440031,Keck Graduate Institute,KGI | Keck Graduate Institute of Applied Life Sciences,535 Watson Dr,Claremont,CA,91711,-117.72351,34.093329,Private not-for-profit,Graduate degree or certificate offering,No,Suburb: Large,Master's Colleges & Universities: Larger Programs,Research Doctoral: Single program-Other,Exclusively graduate,Exclusively graduate/professional,762,281,481,100,35,65,762,55,0,707,140,53,87,19,7,12,4,3,1,1,1,0,CA28
440396,New Saint Andrews College,NSA,405 S. Main Street,Moscow,ID,83843-1525,-117.001804,46.731422,Private not-for-profit,Graduate degree or certificate offering,No,Town: Distant,Baccalaureate Colleges: Arts & Sciences Focus,Postbaccalaureate: Single program-Other,High undergraduate,"Four-year, very small, primarily nonresidential",77,47,30,0,0,0,77,14,42,21,7,4,3,0,0,0,0,0,0,0,0,0,ID01
440794,Pillar College, ,"60 Park Place, Suite 701",Newark,NJ,07102,-74.169153,40.738539,Private not-for-profit,Graduate degree or certificate offering,No,City: Large,Baccalaureate Colleges: Arts & Sciences Focus,"Postbaccalaureate: Other-dominant, with other professional programs",Majority undergraduate,"Four-year, very small, primarily nonresidential",146,36,110,31,14,17,146,146,0,0,34,10,24,0,0,0,0,0,0,0,0,0,NJ10
440828,Oregon State University-Cascades Campus, ,1500 SW Chandler Avenue,Bend,OR,97702,-121.333703,44.042795,Public,Graduate degree or certificate offering,No,City: Small,nan,nan,nan,nan,554,133,421,1,0,1,554,0,17,537,0,0,0,0,0,0,0,0,0,0,0,0,OR05
441104,Richmont Graduate University, ,1815 McCallie Ave,Chattanooga,TN,37404,-85.274642,35.036337,Private not-for-profit,Graduate degree or certificate offering,No,City: Midsize,Special Focus Four-Year: Other Health Professions Schools,Postbaccalaureate: Single program-Other,Exclusively graduate,Exclusively graduate/professional,357,78,279,0,0,0,357,53,201,103,87,24,63,0,0,0,0,0,0,0,0,0,TN03
441131,The Seattle School of Theology & Psychology,The Seattle School,2501 Elliott Avenue,Seattle,WA,98121,-122.350945,47.613373,Private not-for-profit,Graduate degree or certificate offering,No,City: Large,Special Focus Four-Year: Other Health Professions Schools,"Postbaccalaureate: Other-dominant, with other professional programs",Exclusively graduate,Exclusively graduate/professional,301,72,229,3,1,2,301,296,0,5,57,15,42,0,0,0,0,0,0,0,0,0,WA07
441238,Irell & Manella Graduate School of Biological Sciences at City of Hope, ,1500 East Duarte Road,Duarte,CA,91010-3000,-117.972791,34.129048,Private not-for-profit,Graduate degree or certificate offering,No,Suburb: Large,Special Focus Four-Year: Other Health Professions Schools,Research Doctoral: Single program-Other,Exclusively graduate,Exclusively graduate/professional,92,35,57,27,9,18,92,0,0,92,1,0,1,1,0,1,12,4,8,2,1,1,CA31
441636,American Institute of Alternative Medicine,AIAM,6685 Doubletree Ave,Columbus,OH,43229,-82.988733,40.102442,Private for-profit,Graduate degree or certificate offering,No,City: Large,Special Focus Four-Year: Other Health Professions Schools,Postbaccalaureate: Single program-Other,Very high undergraduate,"Four-year, small, primarily nonresidential",27,4,23,0,0,0,27,0,0,27,7,1,6,0,0,0,0,0,0,0,0,0,OH03
441690,Universidad Pentecostal Mizpa, ,Bo Caimito Rd 199 Km 0.3,Rio Piedras,PR,00928,-66.085117,18.358258,Private not-for-profit,Graduate degree or certificate offering,No,City: Large,Special Focus Four-Year: Faith-Related Institutions,Postbaccalaureate: Single program-Other,High undergraduate,"Four-year, very small, primarily nonresidential",25,15,10,0,0,0,25,0,0,25,7,5,2,0,0,0,0,0,0,0,0,0,PR98
441900,Nevada State College,NS,1300 Nevada State Drive,Henderson,NV,89002,-114.938044,35.982345,Public,Graduate degree or certificate offering,No,Rural: Fringe,Baccalaureate Colleges: Diverse Fields,Not classified (Exclusively Undergraduate),Very high undergraduate,"Four-year, small, primarily nonresidential",72,5,67,0,0,0,72,0,25,47,2,0,2,0,0,0,0,0,0,0,0,0,NV01
441937,California State University-Channel Islands,CSU Channel Islands,1 University Drive,Camarillo,CA,93012,-119.04356,34.162949,Public,Graduate degree or certificate offering,No,Suburb: Midsize,Master's Colleges & Universities: Small Programs,"Postbaccalaureate: Business-dominant, with Arts & Sciences",Very high undergraduate,"Four-year, medium, primarily nonresidential",592,247,345,49,22,27,592,592,0,0,86,53,33,14,8,6,0,0,0,0,0,0,CA26
442064,Won Institute of Graduate Studies, ,800 Jacksonville Rd,Warminster,PA,18974,-75.078944,40.201117,Private not-for-profit,Graduate degree or certificate offering,No,Suburb: Large,Special Focus Four-Year: Other Health Professions Schools,"Postbaccalaureate: Other-dominant, with Arts & Sciences",Exclusively graduate,Exclusively graduate/professional,175,40,135,3,2,1,175,50,125,0,23,7,16,0,0,0,0,0,0,0,0,0,PA01
442295,Ave Maria School of Law, ,1025 Commons Circle,Naples,FL,34119,-81.731358,26.242138,Private not-for-profit,Graduate degree or certificate offering,No,Suburb: Large,Special Focus Four-Year: Law Schools,Postbaccalaureate: Single program-Other,Exclusively graduate,Exclusively graduate/professional,321,144,177,5,3,2,321,321,0,0,0,0,0,0,0,0,0,0,0,0,0,0,FL26
442356,Pennsylvania College of Health Sciences,PA College,850 Greenfield Road,Lancaster,PA,17601,-76.247035,40.060419,Private not-for-profit,Graduate degree or certificate offering,No,Suburb: Large,Special Focus Four-Year: Other Health Professions Schools,Postbaccalaureate: Single program-Other,Very high undergraduate,"Four-year, small, primarily nonresidential",218,33,185,0,0,0,218,99,96,23,25,1,24,0,0,0,0,0,0,0,0,0,PA11
442426,St Louis College of Health Careers-Fenton,SLCHC,1297 North Highway Drive,Fenton,MO,63026,-90.470904,38.544635,Private for-profit,Graduate degree or certificate offering,No,Suburb: Large,Special Focus Four-Year: Other Health Professions Schools,Not classified (Exclusively Undergraduate),Very high undergraduate,"Four-year, very small, primarily nonresidential",29,4,25,0,0,0,29,29,0,0,2,0,2,0,0,0,0,0,0,0,0,0,MO02
442569,Grantham University, ,16025 West 113th Street,Lenexa,KS,66219,-94.771491,38.92258,Private for-profit,Graduate degree or certificate offering,No,City: Small,Master's Colleges & Universities: Larger Programs,"Postbaccalaureate: Business-dominant, with Arts & Sciences",High undergraduate,"Four-year, medium, primarily nonresidential",1527,777,750,0,0,0,1527,1527,0,0,420,236,184,0,0,0,0,0,0,0,0,0,KS03
442639,University of the Potomac-VA Campus, ,7799 LEESBURG PIKE,FALLS CHURCH,VA,22043-2536,-77.216062,38.906944,Private for-profit,Graduate degree or certificate offering,No,Suburb: Large,Special Focus Four-Year: Business & Management Schools,"Postbaccalaureate: Business-dominant, with other professional programs",Majority graduate,"Four-year, very small, primarily nonresidential",392,255,137,364,237,127,392,0,0,392,160,106,54,135,90,45,0,0,0,0,0,0,VA08
442806,Edward Via College of Osteopathic Medicine, ,2265 Kraft Dr,Blacksburg,VA,24060,-80.406018,37.199659,Private not-for-profit,Graduate degree or certificate offering,No,City: Small,Special Focus Four-Year: Medical Schools & Centers,Postbaccalaureate: Single program-Other,Exclusively graduate,Exclusively graduate/professional,2132,1012,1120,0,0,0,2132,0,0,2132,0,0,0,0,0,0,0,0,0,0,0,0,VA09
442842,Pacific College of Health Science-Chicago, ,"65 East Wacker Place, 21st fl",Chicago,IL,60601,-87.625488,41.886588,Private for-profit,Graduate degree or certificate offering,No,City: Large,Special Focus Four-Year: Other Health Professions Schools,Postbaccalaureate: Single program-Other,Majority graduate,Exclusively graduate/professional,214,29,185,1,0,1,214,15,194,5,17,2,15,0,0,0,0,0,0,0,0,0,IL07
442930,University of Antelope Valley,UAV,44055 Sierra Highway,Lancaster,CA,93534,-118.134968,34.683587,Private for-profit,Graduate degree or certificate offering,No,Suburb: Large,Baccalaureate Colleges: Diverse Fields,"Postbaccalaureate: Education-dominant, with other professional programs",Very high undergraduate,"Four-year, very small, primarily nonresidential",46,21,25,1,1,0,46,32,6,8,23,11,12,0,0,0,0,0,0,0,0,0,CA27
443030,NorthShore University HealthSystem School of Nurse Anesthesia, ,"2650 Ridge Ave, Rm G603C",Evanston,IL,60201-1718,-87.684445,42.065549,Private not-for-profit,Graduate degree or certificate offering,No,City: Small,nan,nan,nan,nan,95,31,64,0,0,0,95,0,0,95,0,0,0,0,0,0,0,0,0,0,0,0,IL09
443049,Faith International University,Faith Seminary,3504 N Pearl St,Tacoma,WA,98407-0186,-122.51687,47.280168,Private not-for-profit,Graduate degree or certificate offering,No,City: Midsize,Master's Colleges & Universities: Small Programs,Research Doctoral: Professional-dominant,Majority graduate,"Four-year, very small, primarily nonresidential",230,132,98,18,13,5,230,50,85,95,48,26,22,5,5,0,8,6,2,2,2,0,WA06
443058,Family of Faith Christian University,Family of Faith College,30 Kinville,Shawnee,OK,74802,-96.901413,35.462234,Private not-for-profit,Graduate degree or certificate offering,No,Rural: Distant,Special Focus Four-Year: Faith-Related Institutions,Postbaccalaureate: Single program-Other,Majority graduate,"Four-year, very small, primarily nonresidential",153,75,78,10,7,3,153,153,0,0,11,4,7,1,1,0,0,0,0,0,0,0,OK05
443076,Hood Theological Seminary, ,1810 Lutheran Synod Drive,Salisbury,NC,28144,-80.480643,35.644603,Private not-for-profit,Graduate degree or certificate offering,No,Suburb: Midsize,Special Focus Four-Year: Faith-Related Institutions,Postbaccalaureate: Single program-Other,Exclusively graduate,Exclusively graduate/professional,171,95,76,2,2,0,171,0,165,6,22,15,7,0,0,0,0,0,0,0,0,0,NC08
443128,International Technological University,ITU,3120 Scott Blvd,Santa Clara,CA,95054,-121.963426,37.377192,Private not-for-profit,Graduate degree or certificate offering,No,City: Midsize,Master's Colleges & Universities: Larger Programs,Research Doctoral: Single program-Other,Exclusively graduate,Exclusively graduate/professional,386,183,203,376,178,198,386,0,0,386,158,77,81,158,77,81,0,0,0,0,0,0,CA17
443340,Williamson Christian College,WCC  DBA- Williamson College,274 Mallory Station Rd.,Franklin,TN,37067,-86.828311,35.95616,Private not-for-profit,Graduate degree or certificate offering,No,City: Small,Special Focus Four-Year: Business & Management Schools,Postbaccalaureate: Single program-Business,Majority undergraduate,"Four-year, very small, primarily nonresidential",23,11,12,5,2,3,23,0,0,23,5,5,0,0,0,0,0,0,0,0,0,0,TN07
443410,DigiPen Institute of Technology,DIT|DigiPen|,9931 Willows Rd NE,Redmond,WA,98052,-122.150603,47.68871,Private for-profit,Graduate degree or certificate offering,No,City: Small,Baccalaureate Colleges: Diverse Fields,"Postbaccalaureate: Other-dominant, with Arts & Sciences",Very high undergraduate,"Four-year, small, primarily nonresidential",59,44,15,23,19,4,59,35,24,0,32,22,10,20,16,4,0,0,0,0,0,0,WA01
443562,Dewey University-Hato Rey, ,Barbosa Ave #427 3rd Floor - Malco Bldg,Hato Rey,PR,00910,-66.043033,18.417614,Private not-for-profit,Graduate degree or certificate offering,No,City: Large,Special Focus Four-Year: Other Health Professions Schools,Postbaccalaureate: Single program-Other,Majority undergraduate,"Four-year, very small, primarily nonresidential",240,66,174,0,0,0,240,0,0,240,44,16,28,0,0,0,0,0,0,0,0,0,PR98
443599,American College of Healthcare Sciences, ,5005 S. Macadam Ave,Portland,OR,97239,-122.675858,45.486902,Private for-profit,Graduate degree or certificate offering,No,City: Large,Special Focus Four-Year: Other Health Professions Schools,Postbaccalaureate: Single program-Other,Majority undergraduate,"Four-year, very small, primarily nonresidential",456,31,425,0,0,0,456,456,0,0,87,7,80,0,0,0,0,0,0,0,0,0,OR01
443702,"Bexley Hall Seabury Western Theological Seminary Federation, Inc.",Bexley Hall Seminary  Bexley Hall   Bexley Hall Episcopal Seminary  Bexley Institute  Seabury-Western Theological Seminary,1407 East 60th Street,Chicago,IL,60637,-87.591173,41.785693,Private not-for-profit,Graduate degree or certificate offering,No,City: Large,Special Focus Four-Year: Faith-Related Institutions,Postbaccalaureate: Single program-Other,Exclusively graduate,Exclusively graduate/professional,98,52,46,0,0,0,98,22,68,8,9,2,7,0,0,0,0,0,0,0,0,0,IL01
443766,Strayer University-Tennessee, ,2620 Thousand Oaks Blvd Ste 1100,Memphis,TN,38118,-89.899255,35.077513,Private for-profit,Graduate degree or certificate offering,No,City: Large,Special Focus Four-Year: Business & Management Schools,"Postbaccalaureate: Business-dominant, with Arts & Sciences",High undergraduate,"Four-year, small, primarily nonresidential",537,86,451,0,0,0,537,537,0,0,116,14,102,0,0,0,0,0,0,0,0,0,TN09
443784,Strayer University-Pennsylvania, ,3800 Horizon Blvd Ste 100,Trevose,PA,19053,-74.965749,40.137976,Private for-profit,Graduate degree or certificate offering,No,Suburb: Large,Master's Colleges & Universities: Small Programs,"Postbaccalaureate: Business-dominant, with Arts & Sciences",High undergraduate,"Four-year, very small, primarily nonresidential",306,105,201,1,1,0,306,306,0,0,65,27,38,1,1,0,0,0,0,0,0,0,PA01
444103,Byzantine Catholic Seminary of Saints Cyril and Methodius,B.C.S.,3605 Perrysville Avenue,Pittsburgh,PA,15214-2229,-80.015825,40.484409,Private not-for-profit,Graduate degree or certificate offering,No,City: Large,Special Focus Four-Year: Faith-Related Institutions,Postbaccalaureate: Single program-Other,Exclusively graduate,Exclusively graduate/professional,51,46,5,0,0,0,51,34,17,0,7,7,0,0,0,0,0,0,0,0,0,0,PA12
444130,Northcentral University, ,11355 N. Torrey Pines Road,La Jolla,CA,92037,-117.243889,32.910805,Private not-for-profit,Graduate degree or certificate offering,No,City: Large,Doctoral/Professional Universities,Research Doctoral: Professional-dominant,Majority graduate,"Four-year, medium, primarily nonresidential",16640,4265,12375,0,0,0,16640,16640,0,0,1029,286,743,0,0,0,772,250,522,0,0,0,CA50
444413,Beis Medrash Heichal Dovid, ,211 Beach Seventeenth Street,Far Rockaway,NY,11691-4433,-73.751633,40.596845,Private not-for-profit,Graduate degree or certificate offering,No,City: Large,Special Focus Four-Year: Faith-Related Institutions,Not classified (Exclusively Undergraduate),Very high undergraduate,"Four-year, very small, highly residential",20,20,0,0,0,0,20,0,0,20,0,0,0,0,0,0,0,0,0,0,0,0,NY05
444699,Institute of Clinical Acupuncture & Oriental Med, ,"100 N. Beretania Street, Suite 203B",Honolulu,HI,96817,-157.86111,21.313602,Private for-profit,Graduate degree or certificate offering,No,City: Large,Special Focus Four-Year: Other Health Professions Schools,Postbaccalaureate: Single program-Other,Exclusively graduate,Exclusively graduate/professional,59,11,48,0,0,0,59,0,59,0,14,1,13,0,0,0,0,0,0,0,0,0,HI01
444778,Charlotte Christian College and Theological Seminary,CCCTS,"7520 East Independence Blvd, Suite 100",Charlotte,NC,28227-9446,-80.737194,35.159664,Private not-for-profit,Graduate degree or certificate offering,No,City: Large,Special Focus Four-Year: Faith-Related Institutions,Postbaccalaureate: Single program-Other,Majority graduate,"Four-year, very small, primarily nonresidential",100,28,72,0,0,0,100,79,19,2,7,1,6,0,0,0,0,0,0,0,0,0,NC14
444787,Nightingale College, ,175 S Main St Suite 400,Salt Lake City,UT,84111,-111.890777,40.76528,Private for-profit,Graduate degree or certificate offering,No,City: Midsize,Special Focus Four-Year: Other Health Professions Schools,Not classified (Exclusively Undergraduate),Very high undergraduate,"Four-year, small, primarily nonresidential",3,0,3,0,0,0,3,3,0,0,0,0,0,0,0,0,0,0,0,0,0,0,UT01
445027,American InterContinental University,AIU,2200 E Germann Rd,Chandler,AZ,85286,-111.804036,33.278816,Private for-profit,Graduate degree or certificate offering,No,Rural: Fringe,Master's Colleges & Universities: Larger Programs,Research Doctoral: Professional-dominant,High undergraduate,"Four-year, large, primarily nonresidential",4589,2371,2218,0,0,0,4589,4589,0,0,1219,616,603,0,0,0,86,41,45,0,0,0,AZ05
445054,Toyota Technological Institute at Chicago,TTIC,6045 S. Kenwood Avenue,Chicago,IL,60637,-87.592682,41.784721,Private not-for-profit,Graduate degree or certificate offering,No,City: Large,Special Focus Four-Year: Engineering and Other Technology-Related Schools,Research Doctoral: Single program-Other,Exclusively graduate,Exclusively graduate/professional,44,38,6,31,26,5,44,0,0,44,0,0,0,0,0,0,0,0,0,0,0,0,IL01
445133,American InterContinental University-Houston,AIU Houston,9999 Richmond Avenue,Houston,TX,77042,-95.548302,29.728216,Private for-profit,Graduate degree or certificate offering,No,City: Large,Master's Colleges & Universities: Small Programs,"Postbaccalaureate: Business-dominant, with Arts & Sciences",High undergraduate,"Four-year, very small, primarily nonresidential",96,45,51,0,0,0,96,15,61,20,39,19,20,0,0,0,0,0,0,0,0,0,TX07
445188,University of California-Merced,UC Merced,5200 North Lake Road,Merced,CA,95343-5603,-120.424944,37.366237,Public,Graduate degree or certificate offering,No,Rural: Fringe,Doctoral Universities: High Research Activity,"Research Doctoral: Comprehensive programs, no medical/veterinary school",Very high undergraduate,"Four-year, medium, primarily residential",791,429,362,292,173,119,791,68,533,190,77,40,37,31,18,13,56,24,32,17,10,7,CA13
445267,Central Methodist University-College of Graduate and Extended Studies,CMU - CGES,411 Central Methodist Square,Fayette,MO,65248-1198,-92.685253,39.150497,Private not-for-profit,Graduate degree or certificate offering,No,Town: Distant,Master's Colleges & Universities: Small Programs,"Postbaccalaureate: Education-dominant, with Arts & Sciences",High undergraduate,"Four-year, small, primarily nonresidential",595,142,453,3,2,1,595,305,161,129,97,25,72,2,1,1,0,0,0,0,0,0,MO04
445708,Johnson & Wales University-Charlotte, ,"Academic Center, 801 West Trade Street",Charlotte,NC,28202,-80.851208,35.233502,Private not-for-profit,Graduate degree or certificate offering,No,City: Large,Baccalaureate Colleges: Diverse Fields,Not classified (Exclusively Undergraduate),Very high undergraduate,"Four-year, small, highly residential",5,1,4,0,0,0,5,5,0,0,0,0,0,0,0,0,0,0,0,0,0,0,NC14
445735,Roseman University of Health Sciences,Southern Nevada Educational Services Roseman University of Health Sciences    Nevada College of Pharmacy    University of Southern Nevada,11 Sunset Way,Henderson,NV,89014,-115.064633,36.073182,Private not-for-profit,Graduate degree or certificate offering,No,City: Large,Special Focus Four-Year: Other Health Professions Schools,"Postbaccalaureate: Other-dominant, with other professional programs",Majority graduate,"Four-year, small, primarily nonresidential",1025,485,540,13,6,7,1025,38,0,987,34,20,14,0,0,0,0,0,0,0,0,0,NV01
445869,Divine Mercy University,DMU,45154 Underwood Lane,Sterling,VA,20166,-77.437576,38.979728,Private not-for-profit,Graduate degree or certificate offering,No,Suburb: Large,Special Focus Four-Year: Other Health Professions Schools,"Postbaccalaureate: Other-dominant, with Arts & Sciences",Exclusively graduate,Exclusively graduate/professional,520,201,319,21,16,5,520,449,0,71,87,32,55,3,3,0,0,0,0,0,0,0,VA10
446002,American Academy of Health and Wellness, ,"2233 Hamline Ave N, Suite 432",Roseville,MN,55113,-93.157929,45.008212,Private for-profit,Graduate degree or certificate offering,No,Suburb: Large,Special Focus Four-Year: Other Health Professions Schools,Postbaccalaureate: Single program-Other,Exclusively graduate,Exclusively graduate/professional,67,17,50,1,0,1,67,0,0,67,26,10,16,0,0,0,0,0,0,0,0,0,MN04
446039,Arizona School of Acupuncture and Oriental Medicine,ASAOM,2856 E Fort Lowell Rd,Tucson,AZ,85716-1518,-110.929118,32.264559,Private for-profit,Graduate degree or certificate offering,No,City: Large,Special Focus Four-Year: Other Health Professions Schools,Postbaccalaureate: Single program-Other,Exclusively graduate,Exclusively graduate/professional,50,16,34,2,0,2,50,0,0,50,14,4,10,0,0,0,0,0,0,0,0,0,AZ07
446048,Ave Maria University,AMU,5050 Ave Maria Blvd,Ave Maria,FL,34142-9505,-81.438945,26.335983,Private not-for-profit,Graduate degree or certificate offering,No,Rural: Distant,Baccalaureate Colleges: Arts & Sciences Focus,Postbaccalaureate: Single program-Other,Very high undergraduate,"Four-year, small, highly residential",54,32,22,1,1,0,54,11,42,1,19,10,9,1,1,0,0,0,0,0,0,0,FL26
446224,Eastern School of Acupuncture and Traditional Medicine,ESATM,"440 Franklin Street, Suite 500",Bloomfield,NJ,07003-3551,-74.19716,40.79361,Private for-profit,Graduate degree or certificate offering,No,Suburb: Large,Special Focus Four-Year: Other Health Professions Schools,Postbaccalaureate: Single program-Other,Majority graduate,Exclusively graduate/professional,75,13,62,0,0,0,75,0,75,0,15,5,10,0,0,0,0,0,0,0,0,0,NJ11
446233,Ecclesia College, ,9653 Nations Dr,Springdale,AR,72762,-94.236643,36.2141,Private not-for-profit,Graduate degree or certificate offering,No,Rural: Fringe,Baccalaureate Colleges: Diverse Fields,Postbaccalaureate: Single program-Other,Very high undergraduate,"Four-year, very small, highly residential",2,1,1,0,0,0,2,1,0,1,0,0,0,0,0,0,0,0,0,0,0,0,AR03
446394,Maple Springs Baptist Bible College and Seminary, ,4130 Belt Rd,Capitol Heights,MD,20743,-76.942465,38.86348,Private not-for-profit,Graduate degree or certificate offering,No,Suburb: Large,Special Focus Four-Year: Faith-Related Institutions,Postbaccalaureate: Single program-Other,High undergraduate,"Four-year, very small, primarily nonresidential",30,8,22,0,0,0,30,30,0,0,0,0,0,0,0,0,0,0,0,0,0,0,MD04
446561,Stanbridge University, ,2041 Business Ctr Dr Ste 107,Irvine,CA,92612,-117.857636,33.678879,Private for-profit,Graduate degree or certificate offering,No,City: Large,Special Focus Four-Year: Other Health Professions Schools,Postbaccalaureate: Single program-Other,High undergraduate,"Four-year, small, primarily nonresidential",194,29,165,0,0,0,194,5,189,0,64,5,59,0,0,0,0,0,0,0,0,0,CA47
446640,Harrisburg University of Science and Technology, ,326 Market Street,Harrisburg,PA,17101-2208,-76.880261,40.26193,Private not-for-profit,Graduate degree or certificate offering,No,City: Small,Master's Colleges & Universities: Larger Programs,Postbaccalaureate: Arts & sciences-dominant,Majority graduate,"Four-year, medium, primarily residential",4574,2386,2188,4446,2302,2144,4574,0,4574,0,1031,555,476,996,532,464,2,1,1,2,1,1,PA10
447050,United States University,USU,7675 Mission Valley Road,San Diego,CA,92108,-117.154904,32.7769,Private for-profit,Graduate degree or certificate offering,No,City: Large,Special Focus Four-Year: Other Health Professions Schools,"Postbaccalaureate: Other-dominant, with other professional programs",Majority graduate,"Four-year, small, primarily nonresidential",3255,614,2641,19,7,12,3255,254,3001,0,449,81,368,11,4,7,0,0,0,0,0,0,CA51
447263,AmeriTech College-Draper,Ameritech College of Healthcare,12257 South Business Park Drive-Ste 100,Draper,UT,84020-6545,-111.892792,40.527932,Private for-profit,Graduate degree or certificate offering,No,Suburb: Large,Special Focus Four-Year: Other Health Professions Schools,Not classified (Exclusively Undergraduate),Very high undergraduate,"Four-year, small, primarily nonresidential",182,44,138,0,0,0,182,0,182,0,0,0,0,0,0,0,0,0,0,0,0,0,UT04
447698,Phoenix Institute of Herbal Medicine & Acupuncture,PIHMA College & Clinic,301 E Bethany Home Rd Ste A100,Phoenix,AZ,85012,-112.068783,33.52289,Private for-profit,Graduate degree or certificate offering,No,City: Large,Special Focus Four-Year: Other Health Professions Schools,Postbaccalaureate: Single program-Other,Exclusively graduate,Exclusively graduate/professional,165,37,128,2,1,1,165,0,40,125,15,5,10,0,0,0,0,0,0,0,0,0,AZ01
447801,University of East-West Medicine, ,595 Lawrence Expressway,Sunnyvale,CA,94085-3922,-121.997011,37.3864,Private for-profit,Graduate degree or certificate offering,No,City: Midsize,Special Focus Four-Year: Other Health Professions Schools,Postbaccalaureate: Single program-Other,Exclusively graduate,Exclusively graduate/professional,137,43,94,0,0,0,137,0,0,137,33,9,24,0,0,0,0,0,0,0,0,0,CA17
447953,SUM Bible College and Theological Seminary,School of Urban Missions,1101 Investment Blvd. #200,El Dorado Hills,CA,95762,-121.054758,38.620833,Private not-for-profit,Graduate degree or certificate offering,No,Rural: Fringe,Special Focus Four-Year: Faith-Related Institutions,Postbaccalaureate: Single program-Other,Majority undergraduate,"Four-year, very small, primarily nonresidential",209,143,66,0,0,0,209,196,13,0,49,36,13,0,0,0,0,0,0,0,0,0,CA05
448673,Rasmussen University-Illinois, ,"6000 East State Street, 4th Floor",Rockford,IL,61108-2513,-88.998854,42.267628,Private for-profit,Graduate degree or certificate offering,No,City: Midsize,Baccalaureate/Associate's Colleges: Associate's Dominant,Postbaccalaureate: Single program-Other,Very high undergraduate,"Four-year, small, primarily nonresidential",56,7,49,0,0,0,56,56,0,0,10,1,9,0,0,0,0,0,0,0,0,0,IL17
448691,International Institute for Restorative Practices,IIRP Graduate School,531 Main Street,Bethlehem,PA,18018,-75.382203,40.621324,Private not-for-profit,Graduate degree or certificate offering,No,City: Small,Special Focus Four-Year: Other Special Focus Institutions,Postbaccalaureate: Single program-Other,Exclusively graduate,Exclusively graduate/professional,296,71,225,32,7,25,296,296,0,0,21,4,17,4,1,3,0,0,0,0,0,0,PA07
449038,Strayer University-Florida, ,5650 Breckenridge Park Drive Suite 300,Tampa,FL,33610,-82.35991,27.997442,Private for-profit,Graduate degree or certificate offering,No,Suburb: Large,Master's Colleges & Universities: Medium Programs,"Postbaccalaureate: Business-dominant, with Arts & Sciences",High undergraduate,"Four-year, very small, primarily nonresidential",476,148,328,6,2,4,476,476,0,0,135,57,78,4,2,2,0,0,0,0,0,0,FL14
449135,Dewey University-Juana Díaz, ,"Bo. Lomas, Road 149, Km. 67.02",Juana Diaz,PR,00910,-66.509285,18.057023,Private not-for-profit,Graduate degree or certificate offering,No,Suburb: Small,Special Focus Four-Year: Other Health Professions Schools,Not classified (Exclusively Undergraduate),Very high undergraduate,"Four-year, very small, primarily nonresidential",5,2,3,0,0,0,5,0,0,5,3,0,3,0,0,0,0,0,0,0,0,0,PR98
449339,American Public University System,American Military University  American Public University,111 W Congress St,Charles Town,WV,25414,-77.860121,39.287826,Private for-profit,Graduate degree or certificate offering,No,Town: Fringe,Master's Colleges & Universities: Larger Programs,Postbaccalaureate: Comprehensive programs,High undergraduate,"Four-year, large, primarily nonresidential",17631,10876,6755,258,142,116,17631,17631,0,0,2833,1720,1113,36,21,15,0,0,0,0,0,0,WV02
449348,Huntsville Bible College, ,906 Oakwood Ave,Huntsville,AL,35811-1632,-86.594888,34.750363,Private not-for-profit,Graduate degree or certificate offering,No,City: Midsize,Special Focus Four-Year: Faith-Related Institutions,Postbaccalaureate: Single program-Other,Majority undergraduate,"Four-year, very small, primarily nonresidential",35,18,17,0,0,0,35,4,8,23,2,1,1,0,0,0,0,0,0,0,0,0,AL05
449481,Dragon Rises College of Oriental Medicine,Dragon Rises College,"1000 NE 16th Ave., Building F",Gainesville,FL,32601,-82.312769,29.667368,Private not-for-profit,Graduate degree or certificate offering,No,City: Midsize,Special Focus Four-Year: Other Health Professions Schools,Postbaccalaureate: Single program-Other,Exclusively graduate,Exclusively graduate/professional,42,11,31,0,0,0,42,0,0,42,4,1,3,0,0,0,0,0,0,0,0,0,FL03
449764,Visible Music College, ,200 Madison Ave,Memphis,TN,38103,-90.049381,35.144586,Private not-for-profit,Graduate degree or certificate offering,No,City: Large,"Special Focus Four-Year: Arts, Music & Design Schools",Not classified (Exclusively Undergraduate),Very high undergraduate,"Four-year, very small, primarily residential",28,12,16,6,2,4,28,3,25,0,3,2,1,1,0,1,0,0,0,0,0,0,TN09
449834,Virginia Beach Theological Seminary, ,2221 Centerville Turnpike,Virginia Beach,VA,23464-6847,-76.189475,36.765993,Private not-for-profit,Graduate degree or certificate offering,No,City: Large,Special Focus Four-Year: Faith-Related Institutions,Postbaccalaureate: Single program-Other,Exclusively graduate,Exclusively graduate/professional,45,41,4,0,0,0,45,13,27,5,4,4,0,0,0,0,0,0,0,0,0,0,VA02
449870,University of the West,UWest,1409 Walnut Grove Ave,Rosemead,CA,91770,-118.082964,34.045985,Private not-for-profit,Graduate degree or certificate offering,No,Suburb: Large,Baccalaureate Colleges: Arts & Sciences Focus,Research Doctoral: Single program-Other,Majority undergraduate,"Four-year, very small, highly residential",131,57,74,58,26,32,131,131,0,0,24,9,15,13,3,10,2,1,1,1,1,0,CA28
449889,American College of Education, ,"101 West Ohio Street, Suite 1200",Indianapolis,IN,46204,-86.160161,39.76975,Private for-profit,Graduate degree or certificate offering,No,City: Large,Special Focus Four-Year: Other Special Focus Institutions,Research Doctoral: Single program-Education,Majority graduate,"Four-year, medium, primarily nonresidential",11603,2989,8614,322,86,236,11603,11603,0,0,3484,862,2622,87,26,61,181,65,116,10,3,7,IN07
449898,South University-Tampa, ,"4401 N Himes Ave, Suite 175",Tampa,FL,33614-7095,-82.500357,27.982269,Private for-profit,Graduate degree or certificate offering,No,City: Large,Special Focus Four-Year: Other Health Professions Schools,"Postbaccalaureate: Other-dominant, with Arts & Sciences",Majority undergraduate,"Four-year, very small, primarily nonresidential",528,99,429,14,5,9,528,117,89,322,129,26,103,5,3,2,0,0,0,0,0,0,FL14
449922,Appalachian College of Pharmacy, ,1060 Dragon Road,Oakwood,VA,24631,-82.006195,37.211629,Private not-for-profit,Graduate degree or certificate offering,No,Rural: Remote,Special Focus Four-Year: Other Health Professions Schools,Postbaccalaureate: Single program-Other,Exclusively graduate,Exclusively graduate/professional,190,81,109,1,1,0,190,0,0,190,0,0,0,0,0,0,0,0,0,0,0,0,VA09
450298,Strayer University-Delaware, ,800 North King Street Suite 101,Wilmington,DE,19801,-75.547914,39.743357,Private for-profit,Graduate degree or certificate offering,No,City: Small,Special Focus Four-Year: Business & Management Schools,"Postbaccalaureate: Business-dominant, with other professional programs",High undergraduate,"Four-year, very small, primarily nonresidential",55,15,40,0,0,0,55,55,0,0,13,4,9,0,0,0,0,0,0,0,0,0,DE00
450304,Brite Divinity School, ,2800 S. University Dr.,Fort Worth,TX,76129,-97.359137,32.710145,Private not-for-profit,Graduate degree or certificate offering,No,City: Large,Special Focus Four-Year: Faith-Related Institutions,Research Doctoral: Single program-Other,Exclusively graduate,Exclusively graduate/professional,155,60,95,9,8,1,155,155,0,0,16,6,10,0,0,0,1,1,0,0,0,0,TX12
450377,Strayer University-Alabama, ,"2 20th Street North, #150",Birmingham,AL,35203,-86.80574,33.513375,Private for-profit,Graduate degree or certificate offering,No,City: Midsize,Master's Colleges & Universities: Small Programs,"Postbaccalaureate: Business-dominant, with Arts & Sciences",High undergraduate,"Four-year, very small, primarily nonresidential",267,48,219,0,0,0,267,267,0,0,62,11,51,0,0,0,0,0,0,0,0,0,AL07
450571,Rasmussen University-Wisconsin, ,"904 South Taylor Street, Suite 100",Green Bay,WI,54303-2349,-88.080783,44.526244,Private for-profit,Graduate degree or certificate offering,No,City: Midsize,Baccalaureate/Associate's Colleges: Mixed Baccalaureate/Associate's,Postbaccalaureate: Single program-Other,Very high undergraduate,"Four-year, very small, primarily nonresidential",39,9,30,0,0,0,39,39,0,0,0,0,0,0,0,0,0,0,0,0,0,0,WI08
450933,Columbia Southern University, ,21982 University Lane,Orange Beach,AL,36561-9000,-87.653162,30.329288,Private for-profit,Graduate degree or certificate offering,No,Town: Fringe,Master's Colleges & Universities: Larger Programs,Research Doctoral: Single program-Other,Majority undergraduate,"Four-year, large, primarily nonresidential",9393,5134,4259,9,7,2,9393,9393,0,0,2073,1084,989,1,1,0,42,23,19,1,0,1,AL01
451079,Academy for Five Element Acupuncture, ,305 SE 2nd Ave,Gainesville,FL,32601,-82.321994,29.650075,Private not-for-profit,Graduate degree or certificate offering,No,City: Midsize,Special Focus Four-Year: Other Health Professions Schools,Postbaccalaureate: Single program-Other,Exclusively graduate,Exclusively graduate/professional,109,19,90,0,0,0,109,0,76,33,16,1,15,0,0,0,0,0,0,0,0,0,FL03
451103,Miami Regional University, ,700 S Royal Poinciana Blvd,Miami Springs,FL,33166,-80.267007,25.810667,Private for-profit,Graduate degree or certificate offering,No,Suburb: Large,Special Focus Four-Year: Other Health Professions Schools,"Postbaccalaureate: Other-dominant, with other professional programs",Majority undergraduate,"Four-year, very small, primarily nonresidential",1669,618,1051,0,0,0,1669,0,0,1669,494,201,293,0,0,0,0,0,0,0,0,0,FL26
451510,Charleston School of Law, ,81 Mary Street,Charleston,SC,29403,-79.938357,32.790288,Private for-profit,Graduate degree or certificate offering,No,City: Midsize,Special Focus Four-Year: Law Schools,Postbaccalaureate: Single program-Other,Exclusively graduate,Exclusively graduate/professional,644,286,358,2,1,1,644,0,0,644,0,0,0,0,0,0,0,0,0,0,0,0,SC06
453163,Strayer University-North Carolina, ,4900 Koger Boulevard Suite 400,Greensboro,NC,27407-2638,-79.882713,36.051694,Private for-profit,Graduate degree or certificate offering,No,City: Large,Master's Colleges & Universities: Larger Programs,"Postbaccalaureate: Business-dominant, with Arts & Sciences",High undergraduate,"Four-year, small, primarily nonresidential",998,184,814,3,2,1,998,998,0,0,240,54,186,2,1,1,0,0,0,0,0,0,NC06
453215,Strayer University-New Jersey, ,242 Old New Brunswick Road,Piscataway,NJ,08854,-74.474974,40.554506,Private for-profit,Graduate degree or certificate offering,No,Suburb: Large,nan,nan,nan,nan,131,35,96,4,1,3,131,131,0,0,28,10,18,1,0,1,0,0,0,0,0,0,NJ06
454227,Chamberlain University-Illinois,Chamberlain College of Nursing-Addison Chamberlain College of Nursing-Chicago Chamberlain College of Nursing-Tinley Park,1221 N. Swift Road,Addison,IL,60101,-88.038558,41.949727,Private for-profit,Graduate degree or certificate offering,No,Suburb: Large,Special Focus Four-Year: Other Health Professions Schools,Postbaccalaureate: Single program-Other,Majority undergraduate,"Four-year, large, primarily nonresidential",20685,1927,18758,51,7,44,20685,20685,0,0,4033,385,3648,11,1,10,0,0,0,0,0,0,IL08
454582,Ottawa University-Online,OU Online,1001 South Cedar,Ottawa,KS,66067,-95.264165,38.602351,Private not-for-profit,Graduate degree or certificate offering,No,Town: Distant,Baccalaureate Colleges: Diverse Fields,"Postbaccalaureate: Business-dominant, with other professional programs",Majority undergraduate,"Four-year, very small, primarily nonresidential",86,24,62,0,0,0,86,86,0,0,25,6,19,0,0,0,0,0,0,0,0,0,KS03
454689,Taft University System,Taft Law School  William Howard Taft University,"3333 South Wadsworth Boulevard, Suite D-228",Lakewood,CO,80227,-105.083815,39.656632,Private for-profit,Graduate degree or certificate offering,No,City: Midsize,Doctoral/Professional Universities,"Postbaccalaureate: Other-dominant, with other professional programs",Majority graduate,"Four-year, very small, primarily nonresidential",764,371,393,0,0,0,764,764,0,0,29,17,12,0,0,0,0,0,0,0,0,0,CO07
454829,Aspen University, ,"4615 E. Elwood St., Suite 100",Phoenix,AZ,85040,-104.939111,39.68614,Private for-profit,Graduate degree or certificate offering,No,City: Large,Special Focus Four-Year: Other Health Professions Schools,Research Doctoral: Professional-dominant,Majority undergraduate,"Four-year, medium, primarily nonresidential",4542,837,3705,0,0,0,4542,4542,0,0,575,102,473,0,0,0,52,14,38,0,0,0,AZ01
454838,Institute of Taoist Education and Acupuncture,ITEA,"317 W South Boulder Rd, Suite 5",Louisville,CO,80027,-105.139444,39.987288,Private not-for-profit,Graduate degree or certificate offering,No,Suburb: Small,Special Focus Four-Year: Other Health Professions Schools,Postbaccalaureate: Single program-Other,Exclusively graduate,Exclusively graduate/professional,35,6,29,0,0,0,35,0,0,35,4,0,4,0,0,0,0,0,0,0,0,0,CO02
454856,Denver College of Nursing, ,1401 19th St,Denver,CO,80202,-104.994725,39.75303,Private for-profit,Graduate degree or certificate offering,No,City: Large,Special Focus Four-Year: Other Health Professions Schools,Postbaccalaureate: Single program-Other,Very high undergraduate,"Four-year, small, primarily nonresidential",24,4,20,0,0,0,24,24,0,0,10,3,7,0,0,0,0,0,0,0,0,0,CO01
455099,Urshan Graduate School of Theology, ,1151 Century Tel Drive,Wentzville,MO,63385,-90.830252,38.808034,Private not-for-profit,Graduate degree or certificate offering,No,Suburb: Large,Special Focus Four-Year: Faith-Related Institutions,Postbaccalaureate: Single program-Other,Exclusively graduate,Exclusively graduate/professional,130,76,54,7,5,2,130,106,10,14,25,14,11,1,1,0,0,0,0,0,0,0,MO03
455178,Daoist Traditions College of Chinese Medical Arts, ,382 Montford Ave,Asheville,NC,28801,-82.568537,35.606831,Private for-profit,Graduate degree or certificate offering,No,City: Small,Special Focus Four-Year: Other Health Professions Schools,Postbaccalaureate: Single program-Other,Exclusively graduate,Exclusively graduate/professional,114,23,91,0,0,0,114,0,114,0,19,5,14,0,0,0,0,0,0,0,0,0,NC11
455406,Pacific Northwest University of Health Sciences,PNWU,200 University Parkway,Yakima,WA,98901,-120.45598,46.602872,Private not-for-profit,Graduate degree or certificate offering,No,Suburb: Midsize,Special Focus Four-Year: Medical Schools & Centers,Postbaccalaureate: Single program-Other,Exclusively graduate,Exclusively graduate/professional,575,252,323,7,2,5,575,0,0,575,0,0,0,0,0,0,0,0,0,0,0,0,WA04
455433,The Chicago School of Professional Psychology at Anaheim, ,"2400 E. Katella Ave., Suite 1200",Anaheim,CA,92806,-117.882312,33.804604,Private not-for-profit,Graduate degree or certificate offering,No,City: Large,Special Focus Four-Year: Other Health Professions Schools,"Postbaccalaureate: Other-dominant, with Arts & Sciences",Exclusively graduate,Exclusively graduate/professional,511,112,399,17,2,15,511,14,437,60,43,11,32,3,1,2,4,2,2,0,0,0,CA46
455664,The Chicago School of Professional Psychology at Los Angeles, ,707 Wilshire Boulevard,Los Angeles,CA,90017,-118.257045,34.049478,Private not-for-profit,Graduate degree or certificate offering,No,City: Large,Special Focus Four-Year: Other Health Professions Schools,Research Doctoral: Professional-dominant,Majority graduate,"Four-year, small, primarily nonresidential",3832,735,3097,128,23,105,3832,2948,774,110,397,81,316,12,4,8,96,24,72,2,1,1,CA34
455804,Institute of World Politics, ,1521 16th St NW,Washington,DC,20036,-77.036112,38.910537,Private not-for-profit,Graduate degree or certificate offering,No,City: Large,Special Focus Four-Year: Other Special Focus Institutions,Postbaccalaureate: Single program-Other,Exclusively graduate,Exclusively graduate/professional,164,98,66,0,0,0,164,0,0,164,41,29,12,0,0,0,0,0,0,0,0,0,DC98
455813,Pontifical John Paul II Institute for Studies on Marriage and Family, ,620 Michigan Ave NE - McGivney Hall,Washington,DC,20064-9997,-76.998606,38.933246,Private not-for-profit,Graduate degree or certificate offering,No,City: Large,Special Focus Four-Year: Faith-Related Institutions,Research Doctoral: Single program-Other,Exclusively graduate,Exclusively graduate/professional,74,44,30,13,10,3,74,0,0,74,14,3,11,1,0,1,4,1,3,2,1,1,DC98
455992,Vermont College of Fine Arts,VCFA,36 College St,Montpelier,VT,05602,-72.567616,44.25521,Private not-for-profit,Graduate degree or certificate offering,No,Town: Distant,Master's Colleges & Universities: Medium Programs,Postbaccalaureate: Arts & sciences-dominant,Exclusively graduate,Exclusively graduate/professional,477,139,338,29,4,25,477,477,0,0,134,29,105,11,1,10,0,0,0,0,0,0,VT00
456481,Polytechnic University of Puerto Rico-Miami, ,"8180 N.W. 36 St., Suite 401",Miami,FL,33166,-80.328482,25.80915,Private not-for-profit,Graduate degree or certificate offering,No,City: Small,Baccalaureate Colleges: Diverse Fields,"Postbaccalaureate: Business-dominant, with Arts & Sciences",Majority graduate,"Four-year, very small, primarily nonresidential",93,40,53,0,0,0,93,93,0,0,21,10,11,0,0,0,0,0,0,0,0,0,FL26
456490,Polytechnic University of Puerto Rico-Orlando,Polytechnic University of Puerto Rico-Orlando Campus,550 N Econlockhatchee Tr,Orlando,FL,32825,-81.253943,28.55158,Private not-for-profit,Graduate degree or certificate offering,No,Suburb: Large,Baccalaureate Colleges: Diverse Fields,"Postbaccalaureate: Other-dominant, with Arts & Sciences",High undergraduate,"Four-year, very small, primarily nonresidential",36,26,10,0,0,0,36,23,13,0,12,7,5,0,0,0,0,0,0,0,0,0,FL10
456542,Geisinger Commonwealth School of Medicine,GCSOM,525 Pine St,Scranton,PA,18509,-75.655478,41.413415,Private not-for-profit,Graduate degree or certificate offering,No,City: Small,Special Focus Four-Year: Medical Schools & Centers,"Postbaccalaureate: Other-dominant, with Arts & Sciences",Exclusively graduate,Exclusively graduate/professional,708,303,405,0,0,0,708,281,0,427,83,25,58,0,0,0,0,0,0,0,0,0,PA08
456621,Strayer University-West Virginia, ,135 Corporate Center Drive Suite 531,Scott Depot,WV,25560,-81.92619,38.454588,Private for-profit,Graduate degree or certificate offering,No,Suburb: Midsize,Special Focus Four-Year: Business & Management Schools,Postbaccalaureate: Single program-Business,Very high undergraduate,"Four-year, very small, primarily nonresidential",25,4,21,0,0,0,25,25,0,0,8,1,7,0,0,0,0,0,0,0,0,0,WV01
457086,Homestead Schools, ,23800 Hawthorne Blvd. Ste 200,Torrance,CA,90505,-118.35009,33.809096,Private not-for-profit,Graduate degree or certificate offering,No,City: Midsize,Special Focus Four-Year: Other Health Professions Schools,Not classified (Exclusively Undergraduate),Very high undergraduate,"Four-year, very small, primarily nonresidential",4,2,2,0,0,0,4,0,4,0,4,2,2,0,0,0,0,0,0,0,0,0,CA36
457226,Horizon University, ,7700 Indian Lake Road,Indianapolis,IN,46236-2622,-85.986809,39.894654,Private not-for-profit,Graduate degree or certificate offering,No,Suburb: Large,Special Focus Four-Year: Faith-Related Institutions,Not classified (Exclusively Undergraduate),Very high undergraduate,"Four-year, very small, primarily nonresidential",3,3,0,0,0,0,3,3,0,0,0,0,0,0,0,0,0,0,0,0,0,0,IN07
457271,Academy for Jewish Religion-California, ,574 Hilgard Avenue,Los Angeles,CA,90024,-118.438495,34.070281,Private not-for-profit,Graduate degree or certificate offering,No,City: Large,Special Focus Four-Year: Faith-Related Institutions,"Postbaccalaureate: Other-dominant, with Arts & Sciences",Exclusively graduate,Exclusively graduate/professional,70,24,46,0,0,0,70,0,0,70,10,4,6,0,0,0,0,0,0,0,0,0,CA36
457299,Angeles College, ,3440 Wilshire Blvd Ste 310,Los Angeles,CA,90010,-118.29903,34.061223,Private for-profit,Graduate degree or certificate offering,No,City: Large,Special Focus Four-Year: Other Health Professions Schools,Not classified (Exclusively Undergraduate),Very high undergraduate,"Four-year, very small, primarily nonresidential",5,1,4,5,1,4,5,0,0,5,0,0,0,0,0,0,0,0,0,0,0,0,CA34
457402,University of Fort Lauderdale, ,4131 NW 16th St,Lauderhill,FL,33313,-80.204938,26.147098,Private not-for-profit,Graduate degree or certificate offering,No,Suburb: Large,Special Focus Four-Year: Other Special Focus Institutions,"Postbaccalaureate: Other-dominant, with other professional programs",High undergraduate,"Four-year, very small, primarily nonresidential",15,7,8,1,0,1,15,7,5,3,2,0,2,0,0,0,0,0,0,0,0,0,FL20
457484,Pacific Rim Christian University, ,2223 Hoonee Pl.,Honolulu,HI,96819-2228,-157.888379,21.328198,Private not-for-profit,Graduate degree or certificate offering,No,City: Large,Baccalaureate Colleges: Diverse Fields,"Postbaccalaureate: Other-dominant, with Arts & Sciences",High undergraduate,"Four-year, very small, primarily nonresidential",33,20,13,3,1,2,33,11,18,4,9,5,4,0,0,0,0,0,0,0,0,0,HI01
457688,American Business and Technology University, ,1018 W St Maartens Dr,St Joseph,MO,64506,-94.819797,39.779095,Private for-profit,Graduate degree or certificate offering,No,City: Small,Baccalaureate Colleges: Diverse Fields,Postbaccalaureate: Single program-Business,Very high undergraduate,"Four-year, very small, primarily nonresidential",12,8,4,0,0,0,12,12,0,0,0,0,0,0,0,0,0,0,0,0,0,0,MO06
457697,City Vision University,"TechMission, Inc",1100 E 11th Street,Kansas City,MO,64106-3028,-94.569475,39.101164,Private not-for-profit,Graduate degree or certificate offering,No,City: Large,Baccalaureate Colleges: Diverse Fields,Postbaccalaureate: Single program-Business,High undergraduate,"Four-year, very small, primarily nonresidential",47,24,23,0,0,0,47,47,0,0,5,2,3,0,0,0,0,0,0,0,0,0,MO05
458210,West Coast University-Orange County, ,1477 S Manchester Ave,Anaheim,CA,92802,-117.911811,33.81104,Private for-profit,Graduate degree or certificate offering,No,City: Large,Special Focus Four-Year: Other Health Professions Schools,Postbaccalaureate: Single program-Other,High undergraduate,"Four-year, medium, primarily nonresidential",1908,347,1561,1,0,1,1908,1908,0,0,505,113,392,0,0,0,0,0,0,0,0,0,CA46
458885,Strayer University-Arkansas, ,10825 Financial Centre Pkwy Ste 400,Little Rock,AR,72211,-92.396031,34.74735,Private for-profit,Graduate degree or certificate offering,No,City: Midsize,Baccalaureate Colleges: Diverse Fields,"Postbaccalaureate: Business-dominant, with other professional programs",High undergraduate,"Four-year, very small, primarily nonresidential",95,18,77,0,0,0,95,95,0,0,18,3,15,0,0,0,0,0,0,0,0,0,AR02
458919,Strayer University-Georgia, ,"3355 Northeast Expwy, Ste 100",Atlanta,GA,30341,-84.275624,33.874236,Private for-profit,Graduate degree or certificate offering,No,Suburb: Large,Special Focus Four-Year: Business & Management Schools,"Postbaccalaureate: Business-dominant, with Arts & Sciences",High undergraduate,"Four-year, small, primarily nonresidential",1133,229,904,3,2,1,1133,1133,0,0,300,70,230,2,1,1,0,0,0,0,0,0,GA04
458955,Strayer University-Mississippi, ,100 East Capitol Street Suite 100,Jackson,MS,39201,-90.188097,32.300562,Private for-profit,Graduate degree or certificate offering,No,City: Midsize,Special Focus Four-Year: Business & Management Schools,"Postbaccalaureate: Business-dominant, with other professional programs",Very high undergraduate,"Four-year, very small, primarily nonresidential",53,9,44,0,0,0,53,53,0,0,12,2,10,0,0,0,0,0,0,0,0,0,MS02
458964,Strayer University-South Carolina, ,777 Lowndes Hill Road,Greenville,SC,29607,-82.357811,34.85654,Private for-profit,Graduate degree or certificate offering,No,City: Small,Special Focus Four-Year: Business & Management Schools,"Postbaccalaureate: Business-dominant, with Arts & Sciences",High undergraduate,"Four-year, small, primarily nonresidential",442,77,365,0,0,0,442,442,0,0,95,24,71,0,0,0,0,0,0,0,0,0,SC04
458973,Strayer University-Texas, ,2711 LBJ Freeway,Farmers Branch,TX,75234,-97.73985,30.371175,Private for-profit,Graduate degree or certificate offering,No,City: Large,Special Focus Four-Year: Business & Management Schools,"Postbaccalaureate: Business-dominant, with Arts & Sciences",High undergraduate,"Four-year, small, primarily nonresidential",417,98,319,4,2,2,417,417,0,0,95,20,75,1,0,1,0,0,0,0,0,0,TX37
459259,South University-Richmond, ,2151 Old Brick Rd,Glen Allen,VA,23060,-77.599967,37.64706,Private for-profit,Graduate degree or certificate offering,No,Suburb: Large,Special Focus Four-Year: Other Health Professions Schools,"Postbaccalaureate: Other-dominant, with Arts & Sciences",Majority undergraduate,"Four-year, very small, primarily nonresidential",192,33,159,0,0,0,192,18,17,157,48,11,37,0,0,0,0,0,0,0,0,0,VA01
459268,South University-Virginia Beach, ,"301 Bendix Rd, Ste 100",Virginia Beach,VA,23452,-76.124288,36.8336,Private for-profit,Graduate degree or certificate offering,No,City: Large,Baccalaureate Colleges: Diverse Fields,"Postbaccalaureate: Other-dominant, with Arts & Sciences",High undergraduate,"Four-year, very small, primarily nonresidential",123,22,101,0,0,0,123,24,22,77,30,3,27,0,0,0,0,0,0,0,0,0,VA02
459727,Touro University Worldwide,TUW,10601 Calle Lee  #179,Los Alamitos,CA,90720,-118.057754,33.808683,Private not-for-profit,Graduate degree or certificate offering,No,Suburb: Large,Master's Colleges & Universities: Larger Programs,Research Doctoral: Single program-Other,Majority graduate,"Four-year, small, primarily nonresidential",2270,579,1691,0,0,0,2270,2270,0,0,565,151,414,0,0,0,30,10,20,0,0,0,CA45
459736,Touro University California,TUC,1310 Club Drive,Vallejo,CA,94592,-122.263949,38.085479,Private not-for-profit,Graduate degree or certificate offering,No,City: Midsize,Special Focus Four-Year: Medical Schools & Centers,"Postbaccalaureate: Other-dominant, with other professional programs",Exclusively graduate,Exclusively graduate/professional,1412,532,880,0,0,0,1412,73,967,372,229,55,174,0,0,0,0,0,0,0,0,0,CA08
459745,The Chicago School of Professional Psychology at Washington DC, ,"901 15th St., NW",Washington,DC,20005,-77.033071,38.90163,Private not-for-profit,Graduate degree or certificate offering,No,City: Large,Special Focus Four-Year: Other Health Professions Schools,Research Doctoral: Professional-dominant,Exclusively graduate,Exclusively graduate/professional,823,127,696,26,3,23,823,1,233,589,92,11,81,3,0,3,6,4,2,0,0,0,DC98
459824,Touro University Nevada, ,874 American Pacific Drive,Henderson,NV,89014,-115.024012,36.043189,Private not-for-profit,Graduate degree or certificate offering,No,City: Large,Special Focus Four-Year: Medical Schools & Centers,"Postbaccalaureate: Other-dominant, with other professional programs",Majority graduate,"Four-year, small, primarily nonresidential",2058,786,1272,0,0,0,2058,777,1265,16,189,54,135,0,0,0,0,0,0,0,0,0,NV01
459842,Herzing University-Kenosha, ,5800 7th Avenue,Kenosha,WI,53140,-87.820105,42.582628,Private not-for-profit,Graduate degree or certificate offering,No,Suburb: Midsize,Special Focus Four-Year: Other Health Professions Schools,Postbaccalaureate: Single program-Business,Very high undergraduate,"Four-year, very small, primarily nonresidential",19,8,11,0,0,0,19,19,0,0,7,4,3,0,0,0,0,0,0,0,0,0,WI01
459851,Herzing University-Brookfield, ,15895 W Bluemound Rd,Brookfield,WI,53005,-88.110994,43.035738,Private not-for-profit,Graduate degree or certificate offering,No,Suburb: Large,Special Focus Four-Year: Other Health Professions Schools,Postbaccalaureate: Single program-Business,Very high undergraduate,"Four-year, very small, primarily nonresidential",12,3,9,0,0,0,12,12,0,0,5,1,4,0,0,0,0,0,0,0,0,0,WI05
459949,Texas A&M University-San Antonio,A&M-SA,One University Way,San Antonio,TX,78224,-98.52417,29.304762,Public,Graduate degree or certificate offering,No,Rural: Fringe,Master's Colleges & Universities: Larger Programs,"Postbaccalaureate: Business-dominant, with Arts & Sciences",Very high undergraduate,"Four-year, medium, primarily nonresidential",840,276,564,5,4,1,840,680,139,21,234,89,145,2,2,0,0,0,0,0,0,0,TX23
459994,Strayer University-Global Region, ,"1133 15th St NW, Suite 200",Washington,DC,20005,-77.034001,38.90485,Private for-profit,Graduate degree or certificate offering,No,City: Large,Special Focus Four-Year: Business & Management Schools,"Postbaccalaureate: Business-dominant, with Arts & Sciences",Majority undergraduate,"Four-year, medium, primarily nonresidential",4724,2101,2623,5,4,1,4724,4724,0,0,1254,560,694,2,2,0,0,0,0,0,0,0,DC98
460349,Johnson & Wales University-Online, ,8 Abbott Park Pl,Providence,RI,02903,-71.41277,41.819956,Private not-for-profit,Graduate degree or certificate offering,No,City: Midsize,Master's Colleges & Universities: Larger Programs,"Postbaccalaureate: Business-dominant, with Arts & Sciences",Majority undergraduate,"Four-year, small, primarily nonresidential",1116,310,806,12,3,9,1116,1116,0,0,303,84,219,1,1,0,0,0,0,0,0,0,RI02
460376,Fairfax University of America, ,4401 Village Drive,Fairfax,VA,22030-0000,-77.347751,38.84905,Private not-for-profit,Graduate degree or certificate offering,No,Suburb: Large,Baccalaureate Colleges: Diverse Fields,Postbaccalaureate: Comprehensive programs,Majority graduate,"Four-year, very small, primarily nonresidential",52,22,30,43,14,29,52,0,0,52,40,16,24,33,10,23,0,0,0,0,0,0,VA11
460738,American Sentinel College of Nursing and Health Sciences,Post University,800 Country Club Road,Waterbury,CT,06723-2540,-73.081497,41.535549,Private for-profit,Graduate degree or certificate offering,No,Suburb: Midsize,nan,nan,nan,nan,2359,252,2107,0,0,0,2359,2359,0,0,324,31,293,0,0,0,103,7,96,0,0,0,CT05
461023,National Paralegal College, ,717 E Maryland Ave,Phoenix,AZ,85014-1561,-112.064275,33.530663,Private for-profit,Graduate degree or certificate offering,No,City: Large,Special Focus Four-Year: Law Schools,Postbaccalaureate: Single program-Other,High undergraduate,"Four-year, very small, primarily nonresidential",114,20,94,0,0,0,114,114,0,0,27,5,22,0,0,0,0,0,0,0,0,0,AZ01
461032,Carolina College of Biblical Studies, ,817 South McPherson Church Road,Fayetteville,NC,28303-5157,-78.939514,35.05141,Private not-for-profit,Graduate degree or certificate offering,No,City: Midsize,Special Focus Four-Year: Faith-Related Institutions,Not classified (Exclusively Undergraduate),Very high undergraduate,"Four-year, very small, primarily nonresidential",30,19,11,0,0,0,30,8,7,15,0,0,0,0,0,0,0,0,0,0,0,0,NC07
461120,Omega Graduate School,American Centre for Religion and Society Studies,500 Oxford Drive,Dayton,TN,37321-6736,-85.053774,35.468142,Private not-for-profit,Graduate degree or certificate offering,No,Rural: Fringe,Master's Colleges & Universities: Small Programs,Research Doctoral: Single program-Other,Exclusively graduate,Exclusively graduate/professional,95,54,41,0,0,0,95,0,0,95,1,1,0,0,0,0,2,0,2,0,0,0,TN04
461139,Jung Tao School of Classical Chinese Medicine, ,207 Dale Adams Road,Sugar Grove,NC,28679-9657,-81.785303,36.263233,Private not-for-profit,Graduate degree or certificate offering,No,Rural: Distant,Special Focus Four-Year: Other Health Professions Schools,Postbaccalaureate: Single program-Other,Exclusively graduate,Exclusively graduate/professional,79,19,60,0,0,0,79,0,0,79,17,3,14,0,0,0,0,0,0,0,0,0,NC05
461148,New York Film Academy, ,3300 West Riverside Drive,Burbank,CA,91505,-118.335567,34.152076,Private for-profit,Graduate degree or certificate offering,No,City: Midsize,"Special Focus Four-Year: Arts, Music & Design Schools",Postbaccalaureate: Single program-Other,High undergraduate,"Four-year, small, primarily nonresidential",407,205,202,269,128,141,407,407,0,0,200,100,100,137,60,77,0,0,0,0,0,0,CA30
461281,Jose Maria Vargas University,"JMVU, Vargas University",10131 Pines Boulevard,Pembroke Pines,FL,33026,-80.281548,26.009656,Private for-profit,Graduate degree or certificate offering,No,Suburb: Large,Special Focus Four-Year: Other Special Focus Institutions,Postbaccalaureate: Single program-Business,High undergraduate,"Four-year, very small, primarily nonresidential",17,4,13,3,1,2,17,17,0,0,4,2,2,0,0,0,0,0,0,0,0,0,FL25
461485,Shepherds Theological Seminary, ,6051 Tryon Road,Cary,NC,27518-9316,-78.742623,35.744334,Private not-for-profit,Graduate degree or certificate offering,No,City: Midsize,Special Focus Four-Year: Faith-Related Institutions,Postbaccalaureate: Single program-Other,Exclusively graduate,Exclusively graduate/professional,169,134,35,4,4,0,169,84,24,61,39,31,8,3,3,0,0,0,0,0,0,0,NC13
461528,Manna University,Manna U,5117 Cliffdale Road,Fayetteville,NC,28314-2343,-78.961305,35.058616,Private not-for-profit,Graduate degree or certificate offering,No,City: Midsize,Baccalaureate Colleges: Diverse Fields,"Postbaccalaureate: Other-dominant, with Arts & Sciences",High undergraduate,"Four-year, very small, primarily nonresidential",72,49,23,7,6,1,72,63,8,1,11,5,6,1,0,1,0,0,0,0,0,0,NC09
461643,Bergin University of Canine Studies, ,10201 Old Redwood Hwy,Penngrove,CA,94951,-122.68099,38.302849,Private not-for-profit,Graduate degree or certificate offering,No,Suburb: Small,Baccalaureate Colleges: Diverse Fields,Postbaccalaureate: Single program-Other,Majority undergraduate,"Four-year, very small, primarily nonresidential",25,3,22,1,0,1,25,25,0,0,12,2,10,1,0,1,0,0,0,0,0,0,CA04
461795,North American University, ,11929 West Airport Blvd.,Stafford,TX,77477-0000,-95.588338,29.646303,Private not-for-profit,Graduate degree or certificate offering,No,Suburb: Large,Master's Colleges & Universities: Medium Programs,"Postbaccalaureate: Education-dominant, with Arts & Sciences",Majority undergraduate,"Four-year, very small, highly residential",682,393,289,318,179,139,682,682,0,0,207,121,86,116,75,41,0,0,0,0,0,0,TX09
461883,Millennia Atlantic University, ,"3801 NW 97TH Avenue, Suite 100",Doral,FL,33178-2369,-80.352717,25.808134,Private for-profit,Graduate degree or certificate offering,No,City: Small,Special Focus Four-Year: Business & Management Schools,Postbaccalaureate: Single program-Business,Majority graduate,"Four-year, very small, primarily nonresidential",140,65,75,134,61,73,140,0,0,140,55,27,28,54,27,27,0,0,0,0,0,0,FL26
462044,Institute for Doctoral Studies in the Visual Arts,IDSVA,795 Congress Street,Portland,ME,04102-0000,-70.272161,43.65405,Private not-for-profit,Graduate degree or certificate offering,No,City: Small,Master's Colleges & Universities: Small Programs,Research Doctoral: Single program-Other,Exclusively graduate,Exclusively graduate/professional,99,21,78,0,0,0,99,56,43,0,4,1,3,0,0,0,3,1,2,0,0,0,ME01
464226,Ottawa University-Surprise,OUAZ-Surprise,15950 N. Civic Center Plaza,Surprise,AZ,85374,-112.368233,33.628923,Private not-for-profit,Graduate degree or certificate offering,No,Suburb: Large,Baccalaureate Colleges: Diverse Fields,"Postbaccalaureate: Business-dominant, with other professional programs",Very high undergraduate,"Four-year, very small, highly residential",130,71,59,0,0,0,130,25,102,3,41,17,24,0,0,0,0,0,0,0,0,0,AZ09
474863,Los Angeles Pacific University, ,"300 N Lone Hill Avenue, #200",San Dimas,CA,91773-1741,-117.827484,34.110723,Private not-for-profit,Graduate degree or certificate offering,No,Suburb: Large,Master's Colleges & Universities: Medium Programs,"Postbaccalaureate: Other-dominant, with other professional programs",High undergraduate,"Four-year, small, primarily nonresidential",409,106,303,0,0,0,409,409,0,0,110,33,77,0,0,0,0,0,0,0,0,0,CA31
475033,Relay Graduate School of Education, ,"25 Broadway, 3rd Fl",New York,NY,10004,-74.013948,40.70563,Private not-for-profit,Graduate degree or certificate offering,No,City: Large,Special Focus Four-Year: Other Special Focus Institutions,Postbaccalaureate: Single program-Education,Majority graduate,Exclusively graduate/professional,5717,1437,4280,201,52,149,5717,5717,0,0,1713,396,1317,58,15,43,0,0,0,0,0,0,NY10
475121,South University-Savannah Online, ,709 Mall Blvd,Savannah,GA,31406,-81.105531,31.999481,Private for-profit,Graduate degree or certificate offering,No,City: Midsize,Doctoral/Professional Universities,Research Doctoral: Single program-Other,Majority undergraduate,"Four-year, medium, primarily nonresidential",3514,677,2837,12,0,12,3514,3514,0,0,803,152,651,3,0,3,4,1,3,0,0,0,GA01
475228,The Santa Barbara and Ventura Colleges of Law at Santa Barbara, ,20 E Victoria St,Santa Barbara,CA,93101,-119.70516,34.424542,Private not-for-profit,Graduate degree or certificate offering,No,City: Small,Special Focus Four-Year: Law Schools,Postbaccalaureate: Single program-Other,Exclusively graduate,Exclusively graduate/professional,86,35,51,0,0,0,86,0,37,49,0,0,0,0,0,0,0,0,0,0,0,0,CA24
475273,"Springfield College-Regional, Online, and Continuing Education", ,"Springfield College - Regional, Online, and Continuing Education",Springfield,MA,01109,-72.556647,42.1022,Private not-for-profit,Graduate degree or certificate offering,No,City: Midsize,Master's Colleges & Universities: Small Programs,"Postbaccalaureate: Business-dominant, with other professional programs",Majority undergraduate,"Four-year, very small, primarily nonresidential",241,61,180,2,1,1,241,91,141,9,72,17,55,1,0,1,0,0,0,0,0,0,MA01
475398,Catholic Distance University,CDU,300 S. George Street,Charles Town,WV,25414,-77.859242,39.287311,Private not-for-profit,Graduate degree or certificate offering,No,Town: Fringe,Special Focus Four-Year: Faith-Related Institutions,Postbaccalaureate: Single program-Other,Majority graduate,"Four-year, very small, primarily nonresidential",148,78,70,0,0,0,148,148,0,0,18,11,7,0,0,0,0,0,0,0,0,0,WV02
475495,Rocky Mountain University of Health Professions,RMUoHP,122 East 1700 South,Provo,UT,84606,-111.656188,40.211724,Private for-profit,Graduate degree or certificate offering,No,City: Midsize,Special Focus Four-Year: Other Health Professions Schools,Research Doctoral: Single program-Other,Exclusively graduate,Exclusively graduate/professional,1652,561,1091,0,0,0,1652,341,1311,0,93,32,61,0,0,0,24,12,12,0,0,0,UT03
475608,Criswell College, ,4010 Gaston Avenue,Dallas,TX,75246-1537,-96.77669,32.793513,Private not-for-profit,Graduate degree or certificate offering,No,City: Large,Baccalaureate Colleges: Diverse Fields,"Postbaccalaureate: Other-dominant, with Arts & Sciences",High undergraduate,"Four-year, very small, primarily nonresidential",55,35,20,4,3,1,55,14,17,24,9,6,3,0,0,0,0,0,0,0,0,0,TX30
476975,Colorado State University-Global Campus, ,585 Salida Way,Aurora,CO,80011-0000,-104.786666,39.724786,Public,Graduate degree or certificate offering,No,City: Large,Master's Colleges & Universities: Larger Programs,"Postbaccalaureate: Business-dominant, with Arts & Sciences",Majority undergraduate,"Four-year, medium, primarily nonresidential",6246,2337,3909,84,39,45,6246,6246,0,0,1473,505,968,8,6,2,0,0,0,0,0,0,CO06
477039,West Coast University-Dallas, ,8435 North Stemmons Freeway,Dallas,TX,75247-3900,-96.873805,32.82746,Private for-profit,Graduate degree or certificate offering,No,City: Large,Special Focus Four-Year: Other Health Professions Schools,Postbaccalaureate: Single program-Other,High undergraduate,"Four-year, small, primarily nonresidential",487,90,397,0,0,0,487,487,0,0,102,27,75,0,0,0,0,0,0,0,0,0,TX33
480073,South University-Austin, ,1220 West Louis Henna Boulevard,Round Rock,TX,78681-2300,-97.689972,30.479474,Private for-profit,Graduate degree or certificate offering,No,Rural: Fringe,Baccalaureate Colleges: Diverse Fields,"Postbaccalaureate: Business-dominant, with Arts & Sciences",Very high undergraduate,"Four-year, very small, primarily nonresidential",58,20,38,12,2,10,58,15,24,19,10,4,6,4,1,3,0,0,0,0,0,0,TX17
480198,Warner Pacific University Professional and Graduate Studies,Warner Pacific University PGS,2219 SE 68th Ave,Portland,OR,97215,-122.592498,45.506265,Private not-for-profit,Graduate degree or certificate offering,No,City: Large,Baccalaureate Colleges: Diverse Fields,"Postbaccalaureate: Other-dominant, with other professional programs",Majority undergraduate,"Four-year, very small, primarily nonresidential",262,119,143,0,0,0,262,11,0,251,49,15,34,0,0,0,0,0,0,0,0,0,OR03
480569,Florida Institute of Technology-Online, ,150 West University Blvd,Melbourne,FL,32901-6975,-80.624378,28.065754,Private not-for-profit,Graduate degree or certificate offering,No,City: Small,Master's Colleges & Universities: Larger Programs,"Postbaccalaureate: Business-dominant, with other professional programs",High undergraduate,"Four-year, small, primarily nonresidential",1036,532,504,26,18,8,1036,1036,0,0,308,158,150,5,5,0,0,0,0,0,0,0,FL08
480657,Rasmussen University-Kansas, ,620 SW Governor View,Topeka,KS,66606,-95.751719,39.056302,Private for-profit,Graduate degree or certificate offering,No,Rural: Fringe,Baccalaureate/Associate's Colleges: Mixed Baccalaureate/Associate's,Postbaccalaureate: Single program-Other,Very high undergraduate,"Four-year, very small, primarily nonresidential",9,0,9,0,0,0,9,9,0,0,2,0,2,0,0,0,0,0,0,0,0,0,KS02
480781,California Miramar University, ,"3550 Camino Del Rio North, Suite 208",San Diego,CA,92108,-117.11851,32.77942,Private for-profit,Graduate degree or certificate offering,No,City: Large,Special Focus Four-Year: Business & Management Schools,"Postbaccalaureate: Business-dominant, with Arts & Sciences",Majority undergraduate,"Four-year, very small, primarily nonresidential",116,76,40,84,58,26,116,23,93,0,17,11,6,13,8,5,2,1,1,2,1,1,CA51
480790,Rocky Vista University, ,8401 S Chambers Road,Parker,CO,80134,-104.815034,39.563516,Private for-profit,Graduate degree or certificate offering,No,Suburb: Large,Special Focus Four-Year: Medical Schools & Centers,"Postbaccalaureate: Other-dominant, with Arts & Sciences",Exclusively graduate,Exclusively graduate/professional,1356,767,589,1,0,1,1356,0,0,1356,81,37,44,0,0,0,0,0,0,0,0,0,CO04
480985,Midwives College of Utah, ,"1174 East Graystone Way, Suite #2",Salt Lake City,UT,84106,-111.857036,40.71089,Private not-for-profit,Graduate degree or certificate offering,No,City: Midsize,Special Focus Four-Year: Other Health Professions Schools,Postbaccalaureate: Single program-Other,Very high undergraduate,"Four-year, very small, primarily nonresidential",8,1,7,0,0,0,8,8,0,0,0,0,0,0,0,0,0,0,0,0,0,0,UT02
481030,Future Generations University, ,400 Road Less Traveled Rd,Franklin,WV,26807-0000,-79.405423,38.70907,Private not-for-profit,Graduate degree or certificate offering,No,Rural: Remote,Special Focus Four-Year: Other Special Focus Institutions,Postbaccalaureate: Single program-Other,Exclusively graduate,Exclusively graduate/professional,54,29,25,38,21,17,54,54,0,0,12,6,6,7,3,4,0,0,0,0,0,0,WV01
481058,Grace Mission University, ,1645 West Valencia Drive,Fullerton,CA,92833-3860,-117.958208,33.867663,Private not-for-profit,Graduate degree or certificate offering,No,Suburb: Large,Special Focus Four-Year: Faith-Related Institutions,Postbaccalaureate: Single program-Other,Majority undergraduate,"Four-year, very small, primarily nonresidential",215,114,101,160,86,74,215,211,0,4,12,6,6,7,4,3,0,0,0,0,0,0,CA46
481094,Sotheby's Institute of Art-NY, ,"570 Lexington Avenue, 6th Floor",New York,NY,10022-6717,-73.972232,40.756988,Private for-profit,Graduate degree or certificate offering,No,City: Large,"Special Focus Four-Year: Arts, Music & Design Schools",Postbaccalaureate: Single program-Other,Exclusively graduate,Exclusively graduate/professional,193,22,171,0,0,0,193,0,0,193,69,11,58,0,0,0,0,0,0,0,0,0,NY12
481401,Grace School of Theology, ,3705 College Park Dr Ste 140,Conroe,TX,77384-4894,-95.472493,30.205731,Private not-for-profit,Graduate degree or certificate offering,No,City: Midsize,Special Focus Four-Year: Faith-Related Institutions,Postbaccalaureate: Single program-Other,Majority graduate,"Four-year, very small, primarily nonresidential",620,423,197,7,6,1,620,510,110,0,60,37,23,0,0,0,0,0,0,0,0,0,TX02
481535,Sanford Burnham Prebys Medical Discovery Institute, ,10901 North Torrey Pines Road,La Jolla,CA,92037-1005,-117.241748,32.900056,Private not-for-profit,Graduate degree or certificate offering,No,City: Large,Special Focus Four-Year: Other Health Professions Schools,Research Doctoral: Single program-Other,Exclusively graduate,Exclusively graduate/professional,31,15,16,18,7,11,31,0,0,31,0,0,0,0,0,0,0,0,0,0,0,0,CA50
481720,South University-High Point,South University-High Point,3975 Premier Drive,High Point,NC,27265-8320,-79.963547,36.040441,Private for-profit,Graduate degree or certificate offering,No,City: Midsize,Special Focus Four-Year: Other Health Professions Schools,Postbaccalaureate: Single program-Other,High undergraduate,Exclusively graduate/professional,5,0,5,0,0,0,5,0,2,3,0,0,0,0,0,0,0,0,0,0,0,0,NC06
482149,Augusta University, ,1120 15th St,Augusta,GA,30912,-81.989071,33.47037,Public,Graduate degree or certificate offering,No,City: Midsize,Doctoral Universities: High Research Activity,Research Doctoral: STEM-dominant,Majority undergraduate,"Four-year, medium, primarily nonresidential",3627,1235,2392,64,35,29,3627,774,1732,1121,502,122,380,5,2,3,33,14,19,9,7,2,GA12
482158,Middle Georgia State University, ,100 University Parkway,Macon,GA,31206,-83.732058,32.808092,Public,Graduate degree or certificate offering,No,City: Midsize,Master's Colleges & Universities: Medium Programs,"Postbaccalaureate: Other-dominant, with Arts & Sciences",Very high undergraduate,"Four-year, medium, primarily residential",487,234,253,11,8,3,487,439,48,0,134,59,75,5,3,2,0,0,0,0,0,0,GA02
482228,Veritas Baptist College,VBC,"181 US 50 E., Suite 204",Greendale,IN,47025,-84.82617,39.145234,Private not-for-profit,Graduate degree or certificate offering,No,Rural: Fringe,Special Focus Four-Year: Faith-Related Institutions,Postbaccalaureate: Single program-Other,High undergraduate,"Four-year, very small, primarily nonresidential",72,51,21,0,0,0,72,72,0,0,12,10,2,0,0,0,0,0,0,0,0,0,IN09
482413,DeVry College of New York,DeVry College of New York-Midtown Manhattan  DeVry College of New York-Rego Park,"180 Madison Ave., Ste. 1200",New York,NY,10016,-73.983492,40.747747,Private for-profit,Graduate degree or certificate offering,No,City: Large,Special Focus Four-Year: Business & Management Schools,Postbaccalaureate: Single program-Business,High undergraduate,"Four-year, very small, primarily nonresidential",457,229,228,108,53,55,457,150,241,66,153,72,81,23,10,13,0,0,0,0,0,0,NY12
482422,DeVry University-Arizona,DeVry University-Phoenix  DeVry University-Glendale  DeVry University-Mesa,2149 W. Dunlap Ave.,Phoenix,AZ,85021,-112.104601,33.565758,Private for-profit,Graduate degree or certificate offering,No,City: Large,Baccalaureate Colleges: Diverse Fields,Postbaccalaureate: Single program-Business,High undergraduate,"Four-year, very small, primarily nonresidential",51,20,31,4,2,2,51,31,17,3,17,8,9,0,0,0,0,0,0,0,0,0,AZ08
482431,DeVry University-California,DeVry University-Colton  DeVry University-Folsom  DeVry University-Newark  DeVry University-Fresno  DeVry University-Long Beach  DeVry University-Ontario  DeVry University-San Diego  DeVry University-San Jose  DeVry University-Sherman Oaks,"2970 E Inland Empire Blvd, Ste 100",Ontario,CA,91764,-117.5876,34.068481,Private for-profit,Graduate degree or certificate offering,No,City: Midsize,Master's Colleges & Universities: Medium Programs,"Postbaccalaureate: Business-dominant, with other professional programs",High undergraduate,"Four-year, small, primarily nonresidential",401,217,184,77,32,45,401,141,217,43,134,69,65,24,12,12,0,0,0,0,0,0,CA35
482440,DeVry University-Colorado,DeVry University-Westminster,1870 W. 122nd Ave.,Westminster,CO,80234,-105.008901,39.91934,Private for-profit,Graduate degree or certificate offering,No,Suburb: Large,Special Focus Four-Year: Other Special Focus Institutions,Postbaccalaureate: Single program-Business,Very high undergraduate,"Four-year, very small, primarily nonresidential",3,1,2,0,0,0,3,2,1,0,1,0,1,0,0,0,0,0,0,0,0,0,CO08
482459,DeVry University-Florida,DeVry University-Jacksonville  DeVry University-Miramar  DeVry University-Orlando,"3350 SW 148th Ave, Ste. 110",Miramar,FL,33027,-80.345097,25.97687,Private for-profit,Graduate degree or certificate offering,No,Suburb: Large,Special Focus Four-Year: Business & Management Schools,Postbaccalaureate: Single program-Business,Very high undergraduate,"Four-year, very small, primarily nonresidential",115,49,66,12,3,9,115,83,28,4,38,17,21,5,0,5,0,0,0,0,0,0,FL25
482468,DeVry University-Georgia,DeVry University-Alpharetta  DeVry University-Atlanta Cobb/Galleria  DeVry University-Decatur  DeVry University-Gwinnett  DeVry University-Henry County,"1 West Court Square, Ste. 600",Decatur,GA,30030,-84.297316,33.775112,Private for-profit,Graduate degree or certificate offering,No,Suburb: Large,Special Focus Four-Year: Business & Management Schools,"Postbaccalaureate: Business-dominant, with other professional programs",Very high undergraduate,"Four-year, very small, primarily nonresidential",161,73,88,15,2,13,161,112,46,3,63,21,42,3,0,3,0,0,0,0,0,0,GA05
482477,DeVry University-Illinois,DeVry University-Addison  DeVry University-Chicago  DeVry University-Chicago Loop  DeVry University-Gurnee  DeVry University-Naperville  DeVry University-Tinley Park,1200 E Diehl Road,Naperville,IL,60563,-88.126334,41.799874,Private for-profit,Graduate degree or certificate offering,No,City: Midsize,Master's Colleges & Universities: Larger Programs,"Postbaccalaureate: Business-dominant, with other professional programs",High undergraduate,"Four-year, large, primarily nonresidential",5320,2077,3243,100,35,65,5320,4729,540,51,1520,583,937,36,14,22,0,0,0,0,0,0,IL11
482486,DeVry University-Indiana,DeVry University-Merrillville,8488 Georgia Street,Merrillville,IN,46410,-87.326866,41.464405,Private for-profit,Graduate degree or certificate offering,No,Suburb: Large,nan,nan,nan,nan,4,3,1,0,0,0,4,4,0,0,2,1,1,0,0,0,0,0,0,0,0,0,IN01
482538,DeVry University-Missouri,DeVry University-Kansas City,"1310 E 104th St, Ste 120",Kansas City,MO,64131,-94.575014,38.939506,Private for-profit,Graduate degree or certificate offering,No,City: Large,Special Focus Four-Year: Other Special Focus Institutions,"Postbaccalaureate: Business-dominant, with other professional programs",Very high undergraduate,"Four-year, very small, primarily nonresidential",6,4,2,0,0,0,6,3,3,0,1,1,0,0,0,0,0,0,0,0,0,0,MO05
482547,DeVry University-Nevada,DeVry University-Henderson,"2490 Paseo Verde Pkwy., Ste. 150",Henderson,NV,89074,-115.096601,36.020266,Private for-profit,Graduate degree or certificate offering,No,City: Large,Special Focus Four-Year: Business & Management Schools,Postbaccalaureate: Single program-Business,Very high undergraduate,"Four-year, very small, primarily nonresidential",7,5,2,0,0,0,7,3,3,1,5,4,1,0,0,0,0,0,0,0,0,0,NV01
482556,DeVry University-New Jersey,DeVry University-IselinDeVry University-Paramus,"517 Route 1 S, Ste 1000",Iselin,NJ,08830,-74.311372,40.557503,Private for-profit,Graduate degree or certificate offering,No,Suburb: Large,Baccalaureate Colleges: Diverse Fields,Postbaccalaureate: Single program-Business,Very high undergraduate,"Four-year, very small, primarily nonresidential",30,11,19,10,3,7,30,10,20,0,14,4,10,3,1,2,0,0,0,0,0,0,NJ06
482565,DeVry University-North Carolina,DeVry University-Charlotte  DeVry University-Raleigh,"2015 Ayrsley Town Blvd., Ste. 109",Charlotte,NC,28273,-80.931971,35.13766,Private for-profit,Graduate degree or certificate offering,No,City: Large,Special Focus Four-Year: Business & Management Schools,Postbaccalaureate: Single program-Business,Majority undergraduate,"Four-year, very small, primarily nonresidential",19,6,13,0,0,0,19,16,3,0,7,1,6,0,0,0,0,0,0,0,0,0,NC14
482574,DeVry University-Ohio,DeVry University-Seven HillsDeVry University-CincinnatiDeVry University-Columbus,"2 Easton Oval, Ste 210",Columbus,OH,43219,-82.906219,40.046679,Private for-profit,Graduate degree or certificate offering,No,City: Large,Baccalaureate Colleges: Diverse Fields,Postbaccalaureate: Single program-Business,Very high undergraduate,"Four-year, very small, primarily nonresidential",53,30,23,4,4,0,53,43,9,1,29,15,14,0,0,0,0,0,0,0,0,0,OH03
482608,DeVry University-Pennsylvania,DeVry University-Fort Washington  DeVry University-Philadelphia,"1015 Virginia Dr., Ste. 110",Ft. Washington,PA,19034,-75.183609,40.135214,Private for-profit,Graduate degree or certificate offering,No,Suburb: Large,Baccalaureate Colleges: Diverse Fields,Postbaccalaureate: Single program-Business,Very high undergraduate,"Four-year, very small, primarily nonresidential",130,42,88,0,0,0,130,124,5,1,36,15,21,0,0,0,0,0,0,0,0,0,PA04
482617,DeVry University-Tennessee,DeVry University-Nashville,"301 South Perimeter Part Dr., Ste. 100",Nashville,TN,37211,-86.697403,36.083795,Private for-profit,Graduate degree or certificate offering,No,City: Large,Special Focus Four-Year: Business & Management Schools,Postbaccalaureate: Single program-Business,High undergraduate,"Four-year, very small, primarily nonresidential",8,3,5,0,0,0,8,7,1,0,3,2,1,0,0,0,0,0,0,0,0,0,TN05
482635,DeVry University-Texas,DeVry University-Austin  DeVry University-Irving  DeVry University-San Antonio,"4800 Regent Blvd., Ste. 200",Irving,TX,75063,-97.012494,32.934524,Private for-profit,Graduate degree or certificate offering,No,City: Large,Special Focus Four-Year: Business & Management Schools,Postbaccalaureate: Single program-Business,High undergraduate,"Four-year, very small, primarily nonresidential",105,47,58,11,3,8,105,60,43,2,36,20,16,0,0,0,0,0,0,0,0,0,TX24
482653,DeVry University-Virginia,DeVry University-ArlingtonDeVry University-Chesapeake,"1400 Crystal Dr, Ste 120",Arlington,VA,22202,-77.049759,38.861096,Private for-profit,Graduate degree or certificate offering,No,City: Midsize,Special Focus Four-Year: Business & Management Schools,Postbaccalaureate: Single program-Business,Majority undergraduate,"Four-year, very small, primarily nonresidential",115,54,61,28,11,17,115,42,57,16,43,21,22,8,4,4,0,0,0,0,0,0,VA08
482680,University of North Georgia,UNG,82 College Circle,Dahlonega,GA,30597,-83.985694,34.530219,Public,Graduate degree or certificate offering,No,Town: Distant,Master's Colleges & Universities: Larger Programs,Research Doctoral: Single program-Education,Very high undergraduate,"Four-year, large, primarily nonresidential",942,267,675,15,4,11,942,538,339,65,203,66,137,0,0,0,11,3,8,1,0,1,GA09
482705,Northeastern University Professional Programs, ,360 Huntington Ave,Boston,MA,02115,-71.088782,42.339992,Private not-for-profit,Graduate degree or certificate offering,No,City: Large,Doctoral/Professional Universities,Postbaccalaureate: Comprehensive programs,Majority graduate,"Four-year, medium, primarily nonresidential",11400,4742,6658,5209,2430,2779,11400,4702,4330,2368,2623,1204,1419,1571,777,794,0,0,0,0,0,0,MA07
482936,Florida Polytechnic University,Florida Poly,4700 Research Way,Lakeland,FL,33805-8531,-81.845995,28.150149,Public,Graduate degree or certificate offering,No,Rural: Fringe,Baccalaureate Colleges: Diverse Fields,"Postbaccalaureate: Other-dominant, with Arts & Sciences",Very high undergraduate,"Four-year, small, highly residential",85,68,17,23,16,7,85,0,40,45,18,12,6,9,7,2,0,0,0,0,0,0,FL18
483036,Texas A&M University-Central Texas,A&M-Central Texas,1001 Leadership Place,Killeen,TX,76549,-97.775182,31.053407,Public,Graduate degree or certificate offering,No,Rural: Fringe,Master's Colleges & Universities: Medium Programs,Postbaccalaureate: Comprehensive programs,High undergraduate,"Four-year, small, primarily nonresidential",656,237,419,2,0,2,656,233,241,182,153,52,101,2,0,2,0,0,0,0,0,0,TX11
483124,Arizona State University Digital Immersion,ASU Skysong,1365 N Scottsdale Rd,Scottsdale,AZ,85257,-111.924487,33.463517,Public,Graduate degree or certificate offering,No,City: Midsize,Doctoral Universities: High Research Activity,Research Doctoral: Professional-dominant,High undergraduate,"Four-year, large, primarily nonresidential",20270,7193,13077,531,328,203,20270,20270,0,0,4903,1562,3341,60,41,19,87,18,69,0,0,0,AZ01
483595,Ana G. Mendez University,AGMU,5575 South Semoran Blvd. Suite #502,Orlando,FL,32822,-81.30843,28.482195,Private not-for-profit,Graduate degree or certificate offering,No,City: Large,Special Focus Four-Year: Other Special Focus Institutions,"Postbaccalaureate: Business-dominant, with other professional programs",Majority graduate,"Four-year, small, primarily nonresidential",1868,553,1315,0,0,0,1868,1868,0,0,120,34,86,0,0,0,0,0,0,0,0,0,FL09
483780,IGlobal University, ,8133 Leesburg Pike #230,Vienna,VA,22182-2734,-77.227315,38.915226,Private for-profit,Graduate degree or certificate offering,No,Suburb: Large,Master's Colleges & Universities: Medium Programs,"Postbaccalaureate: Other-dominant, with Arts & Sciences",Majority graduate,"Four-year, very small, primarily nonresidential",249,165,84,195,135,60,249,9,236,4,98,73,25,91,69,22,0,0,0,0,0,0,VA11
483975,Alabama College of Osteopathic Medicine,ACOM,445 Health Sciences Boulevard,Dothan,AL,36303-2251,-85.340805,31.206294,Private not-for-profit,Graduate degree or certificate offering,No,Rural: Fringe,Special Focus Four-Year: Medical Schools & Centers,Postbaccalaureate: Single program-Other,Exclusively graduate,Exclusively graduate/professional,717,356,361,0,0,0,717,0,0,717,0,0,0,0,0,0,0,0,0,0,0,0,AL02
484613,University of Phoenix-Arizona, ,4035 South Riverpoint Parkway,Phoenix,AZ,85040,-112.012761,33.41128,Private for-profit,Graduate degree or certificate offering,No,City: Large,Doctoral/Professional Universities,Research Doctoral: Professional-dominant,High undergraduate,"Four-year, large, primarily nonresidential",33178,8464,24714,164,77,87,33178,32915,30,233,6550,1729,4821,20,15,5,356,109,247,0,0,0,AZ03
484631,University of Phoenix-California, ,3110 East Guasti Road,Ontario,CA,91761,-117.58377,34.065748,Private for-profit,Graduate degree or certificate offering,No,City: Midsize,Master's Colleges & Universities: Larger Programs,"Postbaccalaureate: Business-dominant, with other professional programs",High undergraduate,"Four-year, medium, primarily nonresidential",942,429,513,1,0,1,942,55,49,838,395,206,189,0,0,0,0,0,0,0,0,0,CA35
484710,University of Phoenix-Nevada, ,3755 Breakthrough Way,Las Vegas,NV,89135,-115.322506,36.12164,Private for-profit,Graduate degree or certificate offering,No,Suburb: Large,Baccalaureate Colleges: Diverse Fields,"Postbaccalaureate: Business-dominant, with other professional programs",High undergraduate,"Four-year, very small, primarily nonresidential",23,14,9,0,0,0,23,3,6,14,13,9,4,0,0,0,0,0,0,0,0,0,NV03
484756,University of Phoenix-Texas, ,11451 Katy Freeway,Houston,TX,77079,-95.585258,29.7837,Private for-profit,Graduate degree or certificate offering,No,City: Large,Special Focus Four-Year: Business & Management Schools,Postbaccalaureate: Single program-Business,High undergraduate,"Four-year, very small, primarily nonresidential",54,33,21,0,0,0,54,14,16,24,35,20,15,0,0,0,0,0,0,0,0,0,TX38
484844,Minerva University,Minerva,"1145 Market Street, Floor 9",San Francisco,CA,94103,-122.413359,37.779526,Private not-for-profit,Graduate degree or certificate offering,No,City: Large,nan,nan,nan,nan,25,15,10,19,11,8,25,25,0,0,7,6,1,5,4,1,0,0,0,0,0,0,CA11
484862,University of West Los Angeles, ,9800 S. La Cienega Blvd.,Inglewood,CA,90301,-118.36957,33.947341,Private for-profit,Graduate degree or certificate offering,No,Suburb: Large,Special Focus Four-Year: Law Schools,"Postbaccalaureate: Other-dominant, with other professional programs",Majority graduate,Exclusively graduate/professional,240,110,130,1,1,0,240,0,0,240,5,1,4,0,0,0,0,0,0,0,0,0,CA43
484905,University of North Texas at Dallas,UNTD,7300 University Hills Drive,Dallas,TX,75241,-96.803446,32.659588,Public,Graduate degree or certificate offering,No,City: Large,Master's Colleges & Universities: Larger Programs,"Postbaccalaureate: Other-dominant, with other professional programs",High undergraduate,"Four-year, medium, primarily nonresidential",887,310,577,27,9,18,887,29,357,501,173,39,134,5,1,4,0,0,0,0,0,0,TX30
485403,High Tech High Graduate School of Education, ,2861 Womble Road,San Diego,CA,92106,-117.217661,32.732001,Private not-for-profit,Graduate degree or certificate offering,No,City: Large,Special Focus Four-Year: Other Special Focus Institutions,Postbaccalaureate: Single program-Education,Exclusively graduate,Exclusively graduate/professional,76,33,43,3,1,2,76,0,0,76,45,24,21,0,0,0,0,0,0,0,0,0,CA50
485546,California Intercontinental University, ,"2601 Main Street, Suite 250",Irvine,CA,92614,-117.840674,33.682223,Private for-profit,Graduate degree or certificate offering,No,City: Large,Doctoral/Professional Universities,Research Doctoral: Professional-dominant,Majority graduate,"Four-year, very small, primarily nonresidential",405,239,166,0,0,0,405,405,0,0,19,12,7,0,0,0,31,23,8,0,0,0,CA47
485768,Atlantis University, ,1442 Biscayne Boulevard,Miami,FL,33132,-80.18942,25.788978,Private for-profit,Graduate degree or certificate offering,No,City: Large,Master's Colleges & Universities: Medium Programs,"Postbaccalaureate: Business-dominant, with Arts & Sciences",Majority graduate,"Four-year, very small, primarily nonresidential",582,191,391,195,83,112,582,417,0,165,196,54,142,67,22,45,0,0,0,0,0,0,FL24
486053,Bethlehem College & Seminary, ,720 13th Avenue South,Minneapolis,MN,55415-1793,-93.255399,44.968872,Private not-for-profit,Graduate degree or certificate offering,No,City: Large,Special Focus Four-Year: Faith-Related Institutions,Postbaccalaureate: Single program-Other,Majority undergraduate,"Four-year, very small, primarily nonresidential",98,97,1,7,7,0,98,0,0,98,28,28,0,1,1,0,0,0,0,0,0,0,MN05
486080,Elmezzi Graduate School of Molecular Medicine, ,350 Community Drive,Manhasset,NY,11030-3816,-73.702257,40.775582,Private not-for-profit,Graduate degree or certificate offering,No,Suburb: Large,Special Focus Four-Year: Other Health Professions Schools,Research Doctoral: Single program-Other,Exclusively graduate,Exclusively graduate/professional,15,11,4,8,7,1,15,0,0,15,0,0,0,0,0,0,0,0,0,0,0,0,NY03
486239,San Ignacio University, ,3905 NW 107th ave Suite 301,Doral,FL,33178-2350,-80.367975,25.81067,Private for-profit,Graduate degree or certificate offering,No,City: Small,Special Focus Four-Year: Business & Management Schools,"Postbaccalaureate: Business-dominant, with other professional programs",Majority undergraduate,"Four-year, very small, primarily nonresidential",152,47,105,110,36,74,152,0,152,0,50,18,32,39,14,25,0,0,0,0,0,0,FL26
486284,Bethany Global University,"BGU, Bethany College of Missions, BCOM, Bethany",6820 Auto Club Road,Bloomington,MN,55438-2849,-93.371754,44.795501,Private not-for-profit,Graduate degree or certificate offering,No,City: Small,Special Focus Four-Year: Faith-Related Institutions,Postbaccalaureate: Single program-Other,Very high undergraduate,"Four-year, very small, highly residential",64,29,35,20,18,2,64,64,0,0,9,3,6,0,0,0,0,0,0,0,0,0,MN03
486433,Presidio Graduate School, ,"649 Mission Street, Suite 500",San Francisco,CA,94105,-122.400814,37.786891,Private not-for-profit,Graduate degree or certificate offering,No,City: Large,Special Focus Four-Year: Business & Management Schools,Postbaccalaureate: Single program-Other,Exclusively graduate,Exclusively graduate/professional,197,55,142,1,0,1,197,0,0,197,62,15,47,0,0,0,0,0,0,0,0,0,CA11
486460,Wright Graduate University for the Realization of Human Potential,Wright Graduate School for the Realization of Human Potential (d/b/a in Illinois),N7698 County Highway H,Elkhorn,WI,53121-2556,-88.591085,42.767178,Private not-for-profit,Graduate degree or certificate offering,No,Rural: Fringe,Special Focus Four-Year: Other Special Focus Institutions,Research Doctoral: Single program-Other,Exclusively graduate,Exclusively graduate/professional,41,7,34,0,0,0,41,41,0,0,12,2,10,0,0,0,0,0,0,0,0,0,WI01
486840,Kennesaw State University,KSU,1000 Chastain Rd,Kennesaw,GA,30144,-84.583052,34.038807,Public,Graduate degree or certificate offering,No,Suburb: Large,Doctoral Universities: High Research Activity,Research Doctoral: Professional-dominant,Very high undergraduate,"Four-year, large, primarily nonresidential",4816,1965,2851,325,160,165,4816,3352,1226,238,1161,464,697,93,35,58,38,13,25,3,1,2,GA11
486901,Milligan University,Milligan,1 Blowers Blvd.,Milligan,TN,37682,-82.29407,36.300147,Private not-for-profit,Graduate degree or certificate offering,No,Suburb: Midsize,Master's Colleges & Universities: Medium Programs,Research Doctoral: Professional-dominant,Majority undergraduate,"Four-year, small, highly residential",501,191,310,21,12,9,501,17,62,422,145,47,98,7,4,3,12,7,5,0,0,0,TN01
487010,The University of Tennessee Health Science Center,UTHSC,875 Monroe Avenue,Memphis,TN,38163,-90.033196,35.138847,Public,Graduate degree or certificate offering,No,City: Large,Special Focus Four-Year: Research Institutions,Research Doctoral: Professional-dominant,Majority graduate,"Four-year, medium, primarily nonresidential",3114,1212,1902,89,38,51,3114,269,2067,778,235,51,184,5,1,4,173,52,121,8,3,5,TN09
487153,The Chicago School of Professional Psychology at Xavier University of Louisiana, ,1 Drexel Drive,New Orleans,LA,70125-1056,-90.107924,29.96527,Private not-for-profit,Graduate degree or certificate offering,No,City: Large,nan,nan,nan,nan,45,11,34,0,0,0,45,0,0,45,0,0,0,0,0,0,0,0,0,0,0,0,LA02
487524,Husson University,Husson,1 College Circle,Bangor,ME,04401-2929,-68.791476,44.829002,Private not-for-profit,Graduate degree or certificate offering,No,City: Small,Doctoral/Professional Universities,"Postbaccalaureate: Business-dominant, with other professional programs",High undergraduate,"Four-year, small, primarily residential",935,305,630,13,8,5,935,553,64,318,202,66,136,2,2,0,0,0,0,0,0,0,ME02
487603,Northwest University-Center for Online and Extended Education, ,5520 108th Ave NE,Kirkland,WA,98033,-122.195774,47.657502,Private not-for-profit,Graduate degree or certificate offering,No,Suburb: Large,Baccalaureate Colleges: Diverse Fields,"Postbaccalaureate: Other-dominant, with Arts & Sciences",High undergraduate,"Four-year, very small, primarily nonresidential",192,67,125,5,4,1,192,176,6,10,51,17,34,0,0,0,0,0,0,0,0,0,WA01
487649,California Institute of Advanced Management,CIAM,"1000 S. Fremont Ave. Mailbox #45, Bldg A10, 4th Floor, Suite 10402",Alhambra,CA,91803,-118.15055,34.082467,Private not-for-profit,Graduate degree or certificate offering,No,Suburb: Large,Special Focus Four-Year: Business & Management Schools,Postbaccalaureate: Single program-Business,Exclusively graduate,Exclusively graduate/professional,300,85,215,283,80,203,300,300,0,0,32,10,22,28,8,20,0,0,0,0,0,0,CA28
487995,Alhambra Medical University,Fen Wu University of Alternative Medicine,2215 W. Mission Road,Alhambra,CA,91803,-118.148684,34.080181,Private for-profit,Graduate degree or certificate offering,No,Suburb: Large,Special Focus Four-Year: Other Health Professions Schools,Postbaccalaureate: Single program-Other,Majority graduate,Exclusively graduate/professional,138,48,90,16,7,9,138,138,0,0,20,6,14,5,1,4,0,0,0,0,0,0,CA28
488031,Abraham Lincoln University, ,"100 West Broadway, Suite 600",Glendale,CA,91210,-118.256726,34.146294,Private for-profit,Graduate degree or certificate offering,No,City: Midsize,Special Focus Four-Year: Law Schools,"Postbaccalaureate: Other-dominant, with other professional programs",Majority graduate,"Four-year, very small, primarily nonresidential",253,131,122,3,2,1,253,253,0,0,12,5,7,0,0,0,0,0,0,0,0,0,CA30
488068,Huntington University of Health Sciences, ,118 Legacy View Way,Knoxville,TN,37918-8230,-83.99327,36.027559,Private for-profit,Graduate degree or certificate offering,No,Suburb: Large,Baccalaureate/Associate's Colleges: Mixed Baccalaureate/Associate's,Postbaccalaureate: Single program-Other,High undergraduate,"Four-year, very small, primarily nonresidential",48,4,44,1,0,1,48,48,0,0,2,0,2,0,0,0,2,0,2,1,0,1,TN02
488387,Claremont Lincoln University, ,150 West First Street,Claremont,CA,91711-4744,-117.716117,34.094273,Private not-for-profit,Graduate degree or certificate offering,No,Suburb: Large,Special Focus Four-Year: Business & Management Schools,"Postbaccalaureate: Business-dominant, with other professional programs",Exclusively graduate,Exclusively graduate/professional,320,71,249,16,3,13,320,320,0,0,84,14,70,3,0,3,0,0,0,0,0,0,CA28
488448,Seattle Film Institute, ,3210 16th Avenue W,Seattle,WA,98119-1707,-122.377121,47.64894,Private for-profit,Graduate degree or certificate offering,No,City: Large,"Special Focus Four-Year: Arts, Music & Design Schools",Postbaccalaureate: Single program-Other,Majority undergraduate,"Four-year, very small, primarily nonresidential",46,28,18,2,1,1,46,0,0,46,18,13,5,2,1,1,0,0,0,0,0,0,WA07
488527,Arkansas Colleges of Health Education,"Arkansas College of Osteopathic Medicine, ARCOM",7000 Chad Colley Blvd.,Fort Smith,AR,72916-0366,-94.319084,35.317421,Private not-for-profit,Graduate degree or certificate offering,No,Rural: Fringe,Special Focus Four-Year: Medical Schools & Centers,Postbaccalaureate: Single program-Other,Exclusively graduate,Exclusively graduate/professional,714,353,361,13,7,6,714,0,0,714,38,14,24,0,0,0,0,0,0,0,0,0,AR03
488554,Burrell College of Osteopathic Medicine, ,3501 Arrowhead Drive,Las Cruces,NM,88001,-106.737787,32.278068,Private for-profit,Graduate degree or certificate offering,No,Suburb: Midsize,Special Focus Four-Year: Medical Schools & Centers,Postbaccalaureate: Single program-Other,Exclusively graduate,Exclusively graduate/professional,645,312,333,0,0,0,645,0,318,327,0,0,0,0,0,0,0,0,0,0,0,0,NM02
488572,California Health Sciences University,CHSU,120 North Clovis Avenue,Clovis,CA,93612,-119.701977,36.832466,Private for-profit,Graduate degree or certificate offering,No,Suburb: Large,Special Focus Four-Year: Other Health Professions Schools,Postbaccalaureate: Single program-Other,Exclusively graduate,Exclusively graduate/professional,244,117,127,0,0,0,244,0,0,244,0,0,0,0,0,0,0,0,0,0,0,0,CA20
488679,Indiana Wesleyan University-National & Global,IWU,1900 West 50th Street,Marion,IN,46953,-85.677641,40.510655,Private not-for-profit,Graduate degree or certificate offering,No,Rural: Fringe,Doctoral/Professional Universities,Research Doctoral: Single program-Other,Majority undergraduate,"Four-year, large, primarily nonresidential",5449,1690,3759,93,56,37,5449,4366,838,245,1500,398,1102,56,23,33,4,4,0,0,0,0,IN05
488776,John Patrick University of Health and Applied Sciences,John Patrick University of Health and Applied Sciences,"100 East Wayne Street, Suite 140",South Bend,IN,46601-2352,-86.24973,41.67338,Private for-profit,Graduate degree or certificate offering,No,City: Midsize,Special Focus Four-Year: Other Health Professions Schools,Postbaccalaureate: Single program-Other,Majority graduate,"Four-year, very small, primarily nonresidential",121,44,77,2,2,0,121,22,99,0,33,18,15,0,0,0,0,0,0,0,0,0,IN02
488785,University of Saint Katherine, ,1637 Capalina Road,San Marcos,CA,92069,-117.196552,33.151283,Private not-for-profit,Graduate degree or certificate offering,No,Suburb: Large,Baccalaureate Colleges: Diverse Fields,Not classified (Exclusively Undergraduate),Very high undergraduate,"Four-year, very small, primarily nonresidential",15,9,6,1,0,1,15,0,15,0,0,0,0,0,0,0,0,0,0,0,0,0,CA50
488800,Teachers College of San Joaquin, ,2721 Transworld Dr.,Stockton,CA,95206,-121.231507,37.908696,Public,Graduate degree or certificate offering,No,City: Large,Special Focus Four-Year: Other Special Focus Institutions,Postbaccalaureate: Single program-Education,High undergraduate,Exclusively graduate/professional,263,67,196,0,0,0,263,0,20,243,58,11,47,0,0,0,0,0,0,0,0,0,CA09
488846,University of the People, ,595 E Colorado Blvd Suite 623,Pasadena,CA,91101,-118.138047,34.146167,Private not-for-profit,Graduate degree or certificate offering,No,City: Midsize,Master's Colleges & Universities: Larger Programs,"Postbaccalaureate: Business-dominant, with other professional programs",Majority graduate,"Four-year, medium, primarily nonresidential",18614,10861,7753,0,0,0,18614,18614,0,0,690,424,266,0,0,0,0,0,0,0,0,0,CA28
488907,Wongu University of Oriental Medicine,Wongu University,8620 South Eastern Avenue,Las Vegas,NV,89123-2836,-115.117581,36.03274,Private not-for-profit,Graduate degree or certificate offering,No,City: Midsize,Special Focus Four-Year: Other Health Professions Schools,Postbaccalaureate: Single program-Other,Exclusively graduate,Exclusively graduate/professional,47,6,41,1,0,1,47,0,0,47,6,1,5,1,0,1,0,0,0,0,0,0,NV03
489335,Institute of Buddhist Studies, ,2140 Durant Avenue,Berkeley,CA,94704,-122.266105,37.866732,Private not-for-profit,Graduate degree or certificate offering,No,City: Midsize,nan,nan,nan,nan,36,21,15,0,0,0,36,3,15,18,3,2,1,0,0,0,0,0,0,0,0,0,CA12
489779,Purdue University Global, ,"2550 Northwestern Avenue, Suite 1100",West Lafayette,IN,47906,-86.928449,40.45655,Public,Graduate degree or certificate offering,No,City: Small,Doctoral/Professional Universities,"Postbaccalaureate: Other-dominant, with Arts & Sciences",Majority undergraduate,"Four-year, large, primarily nonresidential",15058,4102,10956,56,23,33,15058,15058,0,0,3253,886,2367,9,6,3,0,0,0,0,0,0,IN04
489858,West Coast University-Center for Graduate Studies, ,590 North Vermont Avenue,Los Angeles,CA,90004,-118.29131,34.081505,Private for-profit,Graduate degree or certificate offering,No,City: Large,Special Focus Four-Year: Other Health Professions Schools,Postbaccalaureate: Single program-Other,Exclusively graduate,Exclusively graduate/professional,684,214,470,0,0,0,684,0,0,684,60,5,55,0,0,0,0,0,0,0,0,0,CA30
489937,Carolina University, ,420 S. Broad St.,Winston-Salem,NC,27101,-80.250153,36.087962,Private not-for-profit,Graduate degree or certificate offering,No,City: Midsize,Master's Colleges & Universities: Small Programs,Research Doctoral: Humanities/social sciences-dominant,Majority undergraduate,"Four-year, very small, primarily residential",653,472,181,14,14,0,653,651,0,2,68,56,12,1,1,0,21,17,4,1,1,0,NC05
490045,Presbyterian Theological Seminary in America, ,15605 Carmenita Road,Santa Fe Springs,CA,90670-5611,-118.047065,33.88856,Private not-for-profit,Graduate degree or certificate offering,No,Suburb: Large,Special Focus Four-Year: Faith-Related Institutions,Postbaccalaureate: Single program-Other,Majority graduate,"Four-year, very small, primarily nonresidential",184,99,85,37,18,19,184,184,0,0,18,11,7,5,2,3,0,0,0,0,0,0,CA38
490063,Southern States University, ,"1094 Cuhady Place, #120",San Diego,CA,92110,-117.201297,32.767544,Private for-profit,Graduate degree or certificate offering,No,City: Large,Special Focus Four-Year: Business & Management Schools,"Postbaccalaureate: Business-dominant, with Arts & Sciences",Majority graduate,"Four-year, very small, primarily nonresidential",340,178,162,340,178,162,340,5,335,0,109,61,48,109,61,48,0,0,0,0,0,0,CA51
490081,America Evangelical University, ,1204 W 163rd St,Gardena,CA,90247-4432,-118.295931,33.883102,Private not-for-profit,Graduate degree or certificate offering,No,City: Small,Special Focus Four-Year: Faith-Related Institutions,Research Doctoral: Single program-Other,Majority graduate,"Four-year, very small, primarily nonresidential",103,54,49,89,45,44,103,103,0,0,13,7,6,12,7,5,0,0,0,0,0,0,CA43
490106,Virginia University of Integrative Medicine, ,9401 Mathy Drive Ste 100,Fairfax,VA,22031-5310,-77.269749,38.844541,Private not-for-profit,Graduate degree or certificate offering,No,Suburb: Large,Special Focus Four-Year: Other Health Professions Schools,Postbaccalaureate: Single program-Other,Exclusively graduate,Exclusively graduate/professional,524,226,298,42,22,20,524,0,0,524,58,24,34,1,1,0,24,11,13,0,0,0,VA11
490133,Westcliff University, ,"17877 Von Karman Ave, Suite 400",Irvine,CA,92614,-117.847973,33.685537,Private for-profit,Graduate degree or certificate offering,No,City: Large,Special Focus Four-Year: Business & Management Schools,Research Doctoral: Single program-Other,Majority graduate,"Four-year, medium, primarily nonresidential",3509,1795,1714,2388,1234,1154,3509,1444,1725,340,468,242,226,184,89,95,8,6,2,3,2,1,CA47
490230,Reformed University, ,1724 Atkinson Road,Lawrenceville,GA,30043-5604,-84.07814,33.971966,Private not-for-profit,Graduate degree or certificate offering,No,Suburb: Large,Special Focus Four-Year: Faith-Related Institutions,Not classified (Exclusively Undergraduate),Very high undergraduate,"Four-year, very small, primarily nonresidential",39,22,17,13,0,13,39,0,4,35,0,0,0,0,0,0,0,0,0,0,0,0,GA07
490373,Western Michigan University Homer Stryker M.D. School of Medicine,Western Michigan University School of Medicine,300 Portage Street,Kalamazoo,MI,49007,-85.57943,42.289571,Private not-for-profit,Graduate degree or certificate offering,No,City: Small,Special Focus Four-Year: Medical Schools & Centers,"Postbaccalaureate: Other-dominant, with Arts & Sciences",Exclusively graduate,Exclusively graduate/professional,342,171,171,0,0,0,342,0,342,0,5,1,4,0,0,0,0,0,0,0,0,0,MI04
490601,Kansas City University,KCU-Joplin,2901 St. John's Boulevard,Joplin,MO,64804-1598,-94.527028,37.057686,Private not-for-profit,Graduate degree or certificate offering,No,City: Small,nan,nan,nan,nan,629,350,279,43,22,21,629,0,0,629,4,2,2,0,0,0,0,0,0,0,0,0,MO07
490753,Maine Media College, ,70 Camden Street,Rockport,ME,04856-5952,-69.076508,44.193709,Private not-for-profit,Graduate degree or certificate offering,No,Rural: Fringe,"Special Focus Four-Year: Arts, Music & Design Schools",Postbaccalaureate: Single program-Other,Majority graduate,Exclusively graduate/professional,30,5,25,0,0,0,30,0,0,30,11,2,9,0,0,0,0,0,0,0,0,0,ME01
490805,Purdue University Northwest,Purdue Northwest | PNW,2200 169th Street,Hammond,IN,46323,-87.474236,41.584324,Public,Graduate degree or certificate offering,No,Suburb: Large,Master's Colleges & Universities: Larger Programs,"Postbaccalaureate: Business-dominant, with Arts & Sciences",Very high undergraduate,"Four-year, medium, primarily nonresidential",1067,339,728,196,114,82,1067,319,258,490,320,133,187,102,56,46,0,0,0,0,0,0,IN01
491190,The Chicago School of Professional Psychology at San Diego, ,401 W. A Street at 1 Columbia Place,San Diego,CA,92101-7903,-117.167054,32.718575,Private not-for-profit,Graduate degree or certificate offering,No,City: Large,Special Focus Four-Year: Other Health Professions Schools,"Postbaccalaureate: Other-dominant, with Arts & Sciences",Exclusively graduate,Exclusively graduate/professional,136,31,105,3,1,2,136,1,125,10,24,5,19,1,1,0,0,0,0,0,0,0,CA50
491808,Meridian University, ,47 Sixth Street,Petaluma,CA,94952-3092,-122.640029,38.230878,Private for-profit,Graduate degree or certificate offering,No,City: Small,Special Focus Four-Year: Other Health Professions Schools,Research Doctoral: Single program-Other,Exclusively graduate,Exclusively graduate/professional,161,30,131,0,0,0,161,161,0,0,15,2,13,0,0,0,0,0,0,0,0,0,CA02
492087,The Continents States University, ,618 E South St Suite 500,Orlando,FL,32801,-81.368734,28.538045,Private not-for-profit,Graduate degree or certificate offering,No,City: Large,nan,nan,nan,nan,3,3,0,0,0,0,3,3,0,0,3,3,0,0,0,0,0,0,0,0,0,0,FL10
492209,Reiss-Davis Graduate School, ,3200 Motor Ave.,Los Angeles,CA,90034,-118.41001,34.030844,Private not-for-profit,Graduate degree or certificate offering,No,City: Large,nan,nan,nan,nan,51,7,44,0,0,0,51,0,0,51,0,0,0,0,0,0,0,0,0,0,0,0,CA36
492306,Escondido Adult School, ,220 W Crest Street,Escondido,CA,92025,-117.088454,33.131225,Public,No graduate offering,No,Suburb: Large,nan,nan,nan,nan,116,19,97,0,0,0,116,0,0,116,0,0,0,0,0,0,0,0,0,0,0,0,CA48
492607,Chicago School of Professional Psychology at Dallas, ,2101 Waterview Parkway,Richardson,TX,75080-2208,-96.75721,32.979753,Private not-for-profit,Graduate degree or certificate offering,No,City: Midsize,Special Focus Four-Year: Other Health Professions Schools,Postbaccalaureate: Single program-Other,Exclusively graduate,Exclusively graduate/professional,103,19,84,0,0,0,103,1,101,1,10,2,8,0,0,0,0,0,0,0,0,0,TX32
492689,Texas Tech University Health Sciences Center-El Paso, ,5001 El Paso Drive,El Paso,TX,79905-2827,-106.43122,31.771891,Public,Graduate degree or certificate offering,No,City: Large,Special Focus Four-Year: Medical Schools & Centers,"Postbaccalaureate: Other-dominant, with Arts & Sciences",Majority graduate,"Four-year, very small, primarily nonresidential",491,238,253,0,0,0,491,5,1,485,29,14,15,0,0,0,0,0,0,0,0,0,TX16
492704,Ponce Health Sciences University-Centro Universitario de San Juan, ,"Calle Rosales, Esq San Antonio Parada 26 1/2",Santurce,PR,00914-8505,-66.059619,18.441175,Private for-profit,Graduate degree or certificate offering,No,City: Large,Special Focus Four-Year: Other Health Professions Schools,Postbaccalaureate: Single program-Other,Exclusively graduate,Exclusively graduate/professional,135,31,104,0,0,0,135,0,0,135,18,12,6,0,0,0,0,0,0,0,0,0,PR98
493363,Institute of Lutheran Theology,ILT,910 4th Street,Brookings,SD,57006,-96.789515,44.308861,Private not-for-profit,Graduate degree or certificate offering,No,Town: Remote,nan,nan,nan,nan,86,70,16,2,2,0,86,86,0,0,5,2,3,0,0,0,2,2,0,0,0,0,SD00
493512,San Diego Global Knowledge University, ,"1095 K Street, Suite B",San Diego,CA,92101-7446,-117.154966,32.708222,Private for-profit,Graduate degree or certificate offering,No,City: Large,Special Focus Four-Year: Business & Management Schools,Not classified (Exclusively Undergraduate),Very high undergraduate,"Four-year, very small, primarily nonresidential",6,4,2,0,0,0,6,6,0,0,1,0,1,0,0,0,0,0,0,0,0,0,CA50
493673,Puerto Rico School of Nurse Anesthetists, ,656 Ponce de Leon Ave Floor 1,Hato Rey,PR,00918-0000,-66.054156,18.411332,Private for-profit,Graduate degree or certificate offering,No,City: Large,Special Focus Four-Year: Other Health Professions Schools,Postbaccalaureate: Single program-Other,Exclusively graduate,Exclusively graduate/professional,135,51,84,0,0,0,135,0,135,0,27,11,16,0,0,0,0,0,0,0,0,0,PR98
493895,SANS Technology Institute, ,"11200 Rockville Pike, Suite 200",North Bethesda,MD,20852,-77.110758,39.040814,Private for-profit,Graduate degree or certificate offering,No,Suburb: Large,Special Focus Four-Year: Engineering and Other Technology-Related Schools,Postbaccalaureate: Single program-Other,Majority graduate,Exclusively graduate/professional,959,884,75,62,57,5,959,958,1,0,43,41,2,5,4,1,0,0,0,0,0,0,MD08
493947,Idaho College of Osteopathic Medicine,ICOM,1401 East Central Drive,Meridian,ID,83642,-116.376042,43.594515,Private for-profit,Graduate degree or certificate offering,No,Suburb: Large,nan,nan,nan,nan,478,302,176,0,0,0,478,0,0,478,0,0,0,0,0,0,0,0,0,0,0,0,ID01
494010,Ponce Health Sciences University-St Louis, ,710 North Tucker Street,St. Louis,MO,63101-1150,-90.195676,38.63271,Private for-profit,Graduate degree or certificate offering,No,City: Large,Special Focus Four-Year: Other Health Professions Schools,Postbaccalaureate: Single program-Other,Exclusively graduate,Exclusively graduate/professional,59,19,40,0,0,0,59,3,0,56,38,13,25,0,0,0,0,0,0,0,0,0,MO01
494551,Glasgow Caledonian New York College, ,64 Wooster Street,New York,NY,10012,-74.001699,40.723346,Private not-for-profit,Graduate degree or certificate offering,No,City: Large,Master's Colleges & Universities: Small Programs,Postbaccalaureate: Arts & sciences-dominant,Exclusively graduate,Exclusively graduate/professional,47,6,41,0,0,0,47,47,0,0,15,1,14,0,0,0,0,0,0,0,0,0,NY10
494597,Faith Theological Seminary and Christian College,"Faith Outreach Center, Inc.",7607 Sheldon Road,Tampa,FL,33615,-82.582376,28.018844,Private not-for-profit,Graduate degree or certificate offering,No,Suburb: Large,nan,nan,nan,nan,34,20,14,0,0,0,34,13,21,0,3,1,2,0,0,0,3,2,1,0,0,0,FL14
494603,Southwestern Baptist Theological Seminary, ,2001 W. Seminary Dr.,Fort Worth,TX,76115,-97.348233,32.681685,Private not-for-profit,Graduate degree or certificate offering,No,City: Large,nan,nan,nan,nan,3175,2471,704,47,39,8,3175,1747,589,839,482,371,111,2,1,1,71,61,10,5,3,2,TX33
494621,Lotus Professional College, ,8935 Patterson Avenue,Richmond,VA,23229,-77.576237,37.594751,Private for-profit,Graduate degree or certificate offering,No,Suburb: Large,nan,nan,nan,nan,8,1,7,1,0,1,8,0,8,0,0,0,0,0,0,0,0,0,0,0,0,0,VA01
494807,Ponce Health Sciences University-East, ,Urb Villa Flores Calle Acacia #1213,Ponce,PR,00731-0000,-66.589688,18.0083,Private for-profit,Graduate degree or certificate offering,No,City: Midsize,Special Focus Four-Year: Other Health Professions Schools,Research Doctoral: Single program-Other,Majority graduate,"Four-year, very small, primarily nonresidential",567,111,456,0,0,0,567,0,0,567,41,14,27,0,0,0,8,1,7,0,0,0,PR98
494940,California Arts University, ,4100 W. Commonwealth Ave. Suite 101,Fullerton,CA,92833,-117.980622,33.869778,Private not-for-profit,Graduate degree or certificate offering,No,Suburb: Large,"Special Focus Four-Year: Arts, Music & Design Schools",Postbaccalaureate: Single program-Other,Exclusively graduate,Exclusively graduate/professional,26,18,8,17,14,3,26,0,0,26,1,1,0,1,1,0,0,0,0,0,0,0,CA46
495192,Alder Graduate School of Education, ,2946 Broadway,Redwood City,CA,94062,-122.239258,37.486305,Private not-for-profit,Graduate degree or certificate offering,No,City: Small,nan,nan,nan,nan,457,97,360,0,0,0,457,0,457,0,172,33,139,0,0,0,0,0,0,0,0,0,CA15
495314,Hackensack Meridian School of Medicine, ,123 Metro Boulevard,Nutley,NJ,07110-1912,-74.155128,40.833902,Private not-for-profit,Graduate degree or certificate offering,No,Suburb: Large,nan,nan,nan,nan,273,147,126,0,0,0,273,0,0,273,0,0,0,0,0,0,0,0,0,0,0,0,NJ09
495767,The Pennsylvania State University,Penn State,201 Old Main,University Park,PA,16802-1503,-77.862848,40.7965,Public,Graduate degree or certificate offering,No,City: Small,Doctoral Universities: Very High Research Activity,"Research Doctoral: Comprehensive programs, with medical/veterinary school",High undergraduate,"Four-year, large, primarily residential",18916,9915,9001,3586,2120,1466,18916,10736,5937,2243,3683,1974,1709,555,321,234,645,336,309,283,174,109,PA15
496043,California University of Science and Medicine, ,1501 Violet Street,Colton,CA,92324-1603,-117.350487,34.077252,Private not-for-profit,Graduate degree or certificate offering,No,Suburb: Large,Special Focus Four-Year: Medical Schools & Centers,Postbaccalaureate: Single program-Other,Exclusively graduate,Exclusively graduate/professional,351,172,179,0,0,0,351,0,0,351,58,18,40,0,0,0,0,0,0,0,0,0,CA33
496469,Daybreak University, ,"1818 S. Western Ave. 2nd fI., #207",Los Angeles,CA,90006,-118.308745,34.041256,Private not-for-profit,Graduate degree or certificate offering,No,City: Large,nan,nan,nan,nan,145,14,131,110,11,99,145,0,145,0,25,3,22,25,3,22,0,0,0,0,0,0,CA37
496627,California Northstate University, ,9700 West Taron Drive,Elk Grove,CA,95757-3001,-121.481542,38.405942,Private for-profit,Graduate degree or certificate offering,No,Suburb: Large,nan,nan,nan,nan,1000,446,554,12,3,9,1000,0,0,1000,27,10,17,0,0,0,0,0,0,0,0,0,CA07
496706,Lakewood University, ,2231 North Taylor Road,Cleveland Heights,OH,44112-3044,-81.561292,41.53011,Private not-for-profit,Graduate degree or certificate offering,No,Suburb: Large,nan,nan,nan,nan,86,55,31,0,0,0,86,86,0,0,0,0,0,0,0,0,0,0,0,0,0,0,OH11
